dataset_id,size,number_of_classes,number_of_literals,number_of_entities,number_of_properties,number_of_connections,number_of_connected_vertices,average_literals_per_vertex,relevance
1,16369964,38908,77824,38908,218930,141106,31088,11.996,0.0
10002,332618,500,6781,500,7781,1000,501,13.562,0.0
10003,330804,500,7000,500,8000,1000,501,14.0,0.0
10004,324102,500,7000,500,8000,1000,501,14.0,0.0
10005,309351,500,6500,500,7500,1000,501,13.0,0.0
10006,402776,500,6873,500,7873,1000,501,13.746,1.0
10007,644965,500,12499,500,13499,1000,501,24.998,0.0
10008,98792,104,1232,104,1440,208,105,11.846,0.0
10009,846825,985,8728,985,10698,1970,987,8.861,0.0
10011,1055008,910,9460,910,11280,1820,912,10.396,0.0
10012,413318,500,6091,500,7091,1000,501,12.182,0.0
10013,296759,500,4500,500,5500,1000,501,9.0,0.0
10014,20140,24,168,24,216,48,25,7.0,0.0
10016,320204,500,4410,500,5410,1000,501,8.82,0.0
10017,822731,0,7477,0,7977,500,501,14.954,0.75
10018,1479827,500,29095,500,30095,1000,501,58.19,0.0
10020,641994,500,10500,500,11500,1000,501,21.0,0.0
10021,103666,165,1421,165,1751,330,166,8.612,0.0
10022,640993,500,8898,500,9898,1000,501,17.796,0.0
10024,914070,996,12470,996,14462,1992,998,12.52,0.0
10025,201250,500,2498,500,3498,1000,501,4.996,0.0
10026,5550,7,49,7,63,14,8,7.0,0.0
10028,404918,500,6000,500,7000,1000,501,12.0,0.0
10031,557255,0,11000,0,11500,500,501,22.0,0.0
10032,809293,1496,15470,1496,18462,2992,1499,10.341,0.0
10034,867949,956,15736,956,18148,2412,1458,10.808,0.0
10039,18997,50,250,50,350,100,51,5.0,0.0
10041,48953,0,690,0,713,23,24,30.0,0.0
10045,573666,0,8132,0,8632,500,501,16.264,0.0
10046,1019498,985,10720,985,12690,1970,987,10.883,0.0
10047,716861,970,8660,970,10600,1940,972,8.928,0.0
10048,1228378,500,22896,500,23896,1000,501,45.792,0.0
10049,59339,87,522,87,752,230,144,6.0,0.0
10050,1228416,500,22899,500,23899,1000,501,45.798,0.0
10051,15254,40,160,40,240,80,41,4.0,1.0
10052,507273,0,4500,0,5000,500,501,9.0,0.0
10053,90728,169,1352,169,1690,338,170,8.0,0.0
10054,439418,500,10890,500,11890,1000,501,21.78,0.0
10055,390784,140,6333,140,6613,280,141,45.236,0.0
10057,1228106,500,22891,500,23891,1000,501,45.782,0.0
1006,8756,0,78,0,91,13,14,6.0,0.0
10064,573700,0,8132,0,8632,500,501,16.264,0.0
10065,320581,0,3001,0,3501,500,501,6.002,1.0
10066,270263,500,3500,500,4500,1000,501,7.0,0.0
10067,449642,0,3499,0,3999,500,501,6.998,0.0
10068,456885,500,8500,500,9500,1000,501,17.0,0.0
10070,200445,423,2621,423,3467,846,425,6.196,0.0
10071,802141,970,10670,970,12610,1940,972,11.0,0.0
10072,1228460,500,22900,500,23900,1000,501,45.8,0.0
10073,1561680,500,8504,500,9504,1000,501,17.008,0.0
1008,418445,0,8500,0,9000,500,501,17.0,0.0
10085,820258,985,8724,985,10694,1970,987,8.857,0.0
10086,1426930,0,19747,0,20247,500,501,39.494,0.0
10087,973092,0,13316,0,13816,500,501,26.632,0.0
10088,3437749,0,40930,0,41430,500,501,81.86,0.0
10089,164245,278,1911,278,2467,556,279,6.874,0.0
1009,434306,0,9000,0,9500,500,501,18.0,0.0
10090,268019,500,4000,500,5000,1000,501,8.0,0.0
10091,8250,20,80,20,120,40,21,4.0,0.5
10092,1223616,500,22812,500,23812,1000,501,45.624,0.0
10093,279807,965,1334,965,3333,1999,1003,3.9879999999999995,1.0
10094,823316,915,9490,915,11320,1830,917,10.372,0.0
10095,1152954,920,12016,920,13856,1840,922,13.061,0.0
10096,1060838,985,10724,985,12694,1970,987,10.887,0.0
10098,253565,0,2723,0,3216,493,494,5.523,0.0
10099,10245966,75,599,75,749,150,76,7.987,0.0
1010,57605,0,1120,0,1190,70,71,16.0,0.0
10100,804437,0,14047,0,14341,294,295,47.779,0.0
10103,1819235,500,18506,500,19506,1000,501,37.012,0.0
10104,1068787,500,19234,500,20234,1000,501,38.468,0.0
10106,212928,0,3000,0,3500,500,501,6.0,0.0
10107,668403,0,11000,0,11500,500,501,22.0,0.0
10108,476909,500,7328,500,8328,1000,501,14.656,0.0
10109,4161615,500,5000,500,6000,1000,501,10.0,0.0
10110,460073,500,3998,500,4998,1000,501,7.996,0.0
10111,113203,156,1768,156,2080,312,157,11.333,0.0
10112,262305,0,3000,0,3500,500,501,6.0,0.0
10118,887942,924,11966,924,13814,1848,926,12.95,0.0
1012,666122,500,14433,500,15433,1000,502,28.866,0.5
10121,196313,0,2804,0,3024,220,221,12.745,0.0
10123,513150,500,6500,500,7500,1000,501,13.0,0.0
10124,345610,500,4000,500,5000,1000,501,8.0,0.0
10125,3245186,0,36995,0,38319,1324,1325,83.699,0.5
10127,57393,73,797,73,943,146,74,10.918,0.0
10128,498232,500,9575,500,10575,1000,501,19.15,1.0
10130,325773,0,3601,0,4101,500,501,7.202,0.0
10131,253830,500,2471,500,3471,1000,501,4.942,0.0
10132,403986,500,5946,500,6946,1000,501,11.892,0.0
10133,69543,0,1022,0,1098,76,77,13.447,0.0
10134,475895,500,7662,500,8662,1000,501,15.324,0.0
10138,1427346,500,23415,500,24415,1000,501,46.83,0.0
10139,5489765,500,9988,500,10988,1000,501,19.976,0.0
10140,270365,0,3500,0,4000,500,501,7.0,0.0
10141,2495039,500,17410,500,18410,1000,501,34.82,0.0
10142,9981524,45,359,45,449,90,46,7.978,0.0
10143,271273,0,2470,0,2970,500,501,4.94,0.0
10146,2249679,0,11945,0,12445,500,501,23.89,0.0
10147,320949,500,4499,500,5499,1000,502,8.998,0.0
10148,644049,0,8500,0,9000,500,501,17.0,0.0
10149,470520,0,6000,0,6500,500,501,12.0,0.0
10151,768846,500,11123,500,12123,1000,502,22.246,0.0
10152,25958,21,257,21,299,42,23,12.238,0.0
10153,74982,185,734,185,1104,370,187,3.968,0.0
10154,301360,500,3000,500,4000,1000,502,6.0,0.0
10155,1374105,985,10710,985,12680,1970,987,10.873,0.0
10157,310283,500,3975,500,4975,1000,502,7.95,0.0
10158,90847,228,1345,228,1801,456,229,5.899,0.0
10160,569443,500,8996,500,9996,1000,502,17.992,0.0
10161,1919774,500,31464,500,32464,1000,502,62.928,0.0
10162,2595563,500,39316,500,40316,1000,502,78.632,0.0
10163,398407,500,6034,500,7034,1000,501,12.068,0.0
10164,586610,461,8266,461,9688,1422,963,8.601,0.0
10165,788367,985,10730,985,12700,1970,987,10.893,1.0
10166,387743,500,5871,500,6871,1000,501,11.742,0.0
10167,225895,500,2499,500,3499,1000,501,4.998,0.0
10169,724360,0,11214,0,11714,500,501,22.428,0.0
10173,259458,500,3472,500,4472,1000,501,6.944,0.0
10174,644055,500,11938,500,12938,1000,501,23.876,0.0
10175,340549,0,5432,0,5932,500,501,10.864,0.0
10177,97970,0,1202,0,1409,207,208,5.807,0.0
10178,160908,315,1900,315,2530,630,316,6.032,0.0
10179,281921,500,4099,500,5099,1000,501,8.198,0.0
10180,739358,0,3000,0,3500,500,501,6.0,0.5
10181,263688,0,3000,0,3500,500,501,6.0,0.5
10182,219703,500,2495,500,3495,1000,501,4.99,0.0
10184,468472,0,8008,0,8508,500,501,16.016,0.0
10185,368873,0,5000,0,5500,500,501,10.0,0.0
10186,274006,366,3926,366,4658,732,367,10.727,0.0
10187,367652,500,4000,500,5000,1000,501,8.0,0.5
10188,191121,0,2000,0,2500,500,501,4.0,0.0
10189,394738,500,5873,500,6873,1000,501,11.746,0.0
10190,6806,0,70,0,85,15,16,4.667,0.0
10191,230272,0,2294,0,2794,500,501,4.588,0.0
10192,381887,0,2500,0,3000,500,501,5.0,0.0
10193,272533,0,3000,0,3500,500,501,6.0,0.0
10195,218155,500,2990,500,3990,1000,501,5.98,0.0
10196,401043,0,7127,0,7627,500,501,14.254,0.0
10197,227153,0,2227,0,2727,500,501,4.454,0.0
10198,172078,0,2734,0,3007,273,274,10.015,0.0
10201,170595,500,1500,500,2500,1000,501,3.0,0.0
10202,635110,0,8007,0,8507,500,501,16.014,0.0
10203,841789,0,11000,0,11500,500,501,22.0,0.0
10204,17366,43,129,43,215,86,44,3.0,0.0
10205,118511,191,1143,191,1525,382,192,5.984,0.0
10206,287115,500,2764,500,3764,1000,501,5.528,0.0
10207,456719,0,5500,0,6000,500,501,11.0,0.0
10209,275632,0,2882,0,3382,500,501,5.764,0.0
10211,566767,500,10983,500,11983,1000,501,21.966,0.5
10212,256207,0,3000,0,3500,500,501,6.0,0.0
10213,622117,0,10097,0,10597,500,501,20.194,0.0
10215,52004,0,804,0,882,78,79,10.308,0.5
10216,516816,0,7500,0,8000,500,501,15.0,0.0
10217,240261,0,2490,0,2990,500,501,4.98,0.0
10218,266236,0,2999,0,3499,500,501,5.998,0.0
10219,15994,0,254,0,282,28,29,9.071,0.0
1022,789073,0,12500,0,13000,500,501,25.0,0.5
10220,677983,0,10887,0,11310,423,424,25.738,0.0
10221,1148852,0,20811,0,21311,500,501,41.622,0.0
10222,202060,500,2045,500,3045,1000,501,4.09,0.0
10223,556252,0,7610,0,8110,500,501,15.22,0.0
10225,220708,500,2503,500,3503,1000,501,5.006,0.0
10226,206638,500,2267,500,3267,1000,501,4.534,0.0
10227,636866,0,6370,0,6870,500,501,12.74,0.0
10228,567037,0,9499,0,9999,500,501,18.998,0.0
10229,650184,0,9810,0,10310,500,501,19.62,0.0
10230,1055336,0,18342,0,18842,500,501,36.684,0.0
10232,610197,500,11461,500,12461,1000,501,22.922,0.0
10233,260262,0,2998,0,3498,500,501,5.996,0.0
10234,368454,0,5000,0,5500,500,501,10.0,0.0
10236,565698,500,9848,500,10848,1000,501,19.696,0.0
10237,337739,0,5500,0,6000,500,501,11.0,0.5
10238,20890,0,320,0,360,40,41,8.0,0.0
10239,239609,0,2500,0,3000,500,501,5.0,0.5
1024,787885,0,12500,0,13000,500,501,25.0,0.0
10240,123793,286,1430,286,2002,572,287,5.0,0.0
10241,912106,0,13923,0,14423,500,501,27.846,0.0
10243,493966,500,7884,500,8884,1000,501,15.768,0.0
10244,609491,500,10592,500,11592,1000,501,21.184,1.0
10245,278669,500,3000,500,4000,1000,501,6.0,0.0
10246,68943,105,945,105,1155,210,106,9.0,0.0
10247,509318,0,7538,0,8538,1000,845,15.076,0.0
10248,370659,500,6553,500,7553,1000,501,13.106,0.0
10250,153221,80,2160,80,2320,160,81,27.0,0.0
10252,258093,500,3500,500,4500,1000,501,7.0,0.5
10254,405679,500,5500,500,6500,1000,501,11.0,0.0
10255,254119,500,4000,500,5000,1000,501,8.0,0.0
10256,2099499,500,26208,500,27208,1000,501,52.416,0.5
10257,578844,500,7500,500,8500,1000,501,15.0,0.0
10258,53148,66,686,66,818,132,67,10.394,0.0
10259,2733926,500,33249,500,34249,1000,501,66.498,0.5
10260,426148,500,7000,500,8000,1000,501,14.0,0.0
10261,472180,500,8719,500,9719,1000,501,17.438,0.0
10266,450675,500,8021,500,9021,1000,501,16.042,0.5
10267,362831,500,4452,500,5452,1000,501,8.904,0.0
10268,896043,500,18349,500,19349,1000,501,36.698,0.0
10270,733794,500,12280,500,13280,1000,501,24.56,0.0
10275,71328,147,659,147,953,294,148,4.483,0.8333333333333334
10276,941035,500,15147,500,16147,1000,501,30.294,0.0
10277,422779,500,6000,500,7000,1000,501,12.0,0.0
10278,394987,0,5523,0,6523,1000,1000,11.046,0.0
10279,251871,500,4000,500,5000,1000,501,8.0,0.0
1028,8795,0,63,0,84,21,22,3.0,0.0
10280,192203,126,2016,126,2268,252,127,16.0,0.5833333333333334
10281,297277,500,4000,500,5000,1000,502,8.0,0.0
10282,130119,183,2152,183,2518,366,184,11.76,0.0
10283,458696,301,6622,301,7224,602,302,22.0,0.0
10285,2341829,500,23500,500,24500,1000,501,47.0,0.5
10286,648645,500,8840,500,9840,1000,501,17.68,0.0
10287,596185,500,7500,500,8500,1000,501,15.0,0.0
10288,255128,500,4000,500,5000,1000,501,8.0,0.0
10289,361896,500,6000,500,7000,1000,501,12.0,0.0
10290,576578,500,9000,500,10000,1000,501,18.0,0.0
10292,144630,231,1848,231,2310,462,232,8.0,0.0
10293,401888,500,5703,500,6703,1000,501,11.406,0.0
10294,332064,500,5000,500,6000,1000,501,10.0,0.0
10295,285725,500,3000,500,4000,1000,501,6.0,0.0
10296,824115,500,11267,500,12267,1000,501,22.534,0.0
10297,243010,0,3500,0,4000,500,501,7.0,0.0
10298,2728577,500,30706,500,31706,1000,501,61.412,0.0
10299,95490,68,1218,68,1354,136,69,17.912,0.0
10300,350790,500,6484,500,7484,1000,501,12.968,0.0
1031,3226,3,15,3,21,6,4,5.0,0.0
10317,1055664,985,10726,985,12696,1970,987,10.889,0.0
10318,1412456,985,10730,985,12700,1970,987,10.893,0.0
10319,90847,228,1345,228,1801,456,229,5.899,0.0
1032,10647,12,180,12,204,24,13,15.0,0.0
10320,1287136,985,8710,985,10680,1970,987,8.843,0.0
10322,10953,35,69,35,139,70,36,1.971,0.0
10323,6847,18,54,18,90,36,19,3.0,0.0
10324,32804,61,305,61,427,122,62,5.0,0.0
10326,706613,0,13989,0,14489,500,501,27.978,0.0
10327,938,0,3,0,4,1,2,3.0,0.5
10328,5293,7,56,7,70,14,8,8.0,0.0
1033,155562,44,2573,44,2661,88,45,58.477,0.0
10330,5300,7,56,7,70,14,8,8.0,0.0
10331,450954,0,5874,0,6374,500,501,11.748,0.0
10332,4609,6,48,6,60,12,7,8.0,0.0
10333,23431,37,280,37,354,74,38,7.568,0.0
10334,2166,0,20,0,21,1,2,20.0,0.0
10335,242792,0,3500,0,4000,500,501,7.0,0.0
10336,199700,500,2000,500,3000,1000,501,4.0,0.0
10338,22730,0,305,0,342,37,38,8.243,0.0
10339,260094,0,2998,0,3498,500,501,5.996,0.5
10342,67320,0,1078,0,1176,98,99,11.0,0.0
10344,4555,12,36,12,60,24,13,3.0,0.0
10347,43738,0,417,0,459,42,43,9.929,0.0
10348,489731,500,4000,500,5000,1000,501,8.0,0.8333333333333334
10349,11102,0,90,0,120,30,31,3.0,0.5
1035,414892,0,8500,0,9000,500,501,17.0,0.5
10350,7088,0,66,0,78,12,13,5.5,0.0
10352,185079,319,2552,319,3190,638,320,8.0,0.0
10354,160884,187,2804,187,3178,374,188,14.995,0.0
10355,12439,32,96,32,160,64,33,3.0,0.0
10356,39388,49,588,49,686,98,50,12.0,0.0
10357,281212,0,3995,0,4495,500,501,7.99,0.75
10358,287607,500,3779,500,4779,1000,501,7.558,0.0
10359,261876,0,3500,0,4000,500,501,7.0,0.0
10362,157297,0,2345,0,2680,335,336,7.0,0.0
10363,42099,0,365,0,458,93,94,3.925,0.5
10364,18733,0,202,0,228,26,27,7.769,0.0
10365,1524847,500,39486,500,40986,1500,1002,39.486,0.0
10366,4303,0,37,0,49,12,13,3.083,0.0
10367,240135,0,3500,0,4000,500,501,7.0,0.0
10368,73799,0,1261,0,1358,97,98,13.0,1.0
10371,3207,0,36,0,40,4,5,9.0,0.0
10372,372819,500,5500,500,6500,1000,501,11.0,0.0
10373,506269,500,7462,500,8462,1000,501,14.924,0.0
10374,20227,58,174,58,290,116,59,3.0,0.0
10375,4091,0,30,0,40,10,11,3.0,0.0
10377,2126,1,19,1,21,2,2,19.0,0.0
10378,5094,0,48,0,60,12,13,4.0,0.0
10379,2320,0,18,0,21,3,4,6.0,0.0
1038,2212,5,15,5,25,10,6,3.0,0.0
10380,9313,0,108,0,126,18,19,6.0,0.0
10381,4930,10,40,10,60,20,11,4.0,0.0
10382,31074,0,630,0,645,15,16,42.0,0.0
10383,46878,0,544,0,637,93,94,5.849,0.0
10384,14532,37,111,37,185,74,38,3.0,0.0
10387,239732,0,3500,0,4000,500,501,7.0,0.0
10388,12478,18,242,18,278,36,19,13.444,0.0
10389,5415,0,53,0,60,7,8,7.571,0.0
10390,375463,500,5500,500,6500,1000,501,11.0,0.0
10391,941293,500,14210,500,15210,1000,501,28.42,0.0
10394,261853,0,3500,0,4000,500,501,7.0,0.0
10395,12643,19,288,19,326,38,20,15.158,0.0
10397,105132,0,1129,0,1224,95,96,11.884,0.0
10398,299390,149,3278,149,3576,298,151,22.0,0.0
1040,11870,12,204,12,228,24,13,17.0,0.0
10406,797121,500,10004,500,11004,1000,502,20.008,0.5
10407,364174,500,5009,500,6009,1000,502,10.018,0.0
10408,329377,149,4768,149,5066,298,151,32.0,0.5
1041,15859,12,78,12,105,27,16,6.5,0.0
10419,469731,500,8494,500,9494,1000,501,16.988,0.0
10420,616935,0,3000,0,3500,500,501,6.0,0.0
10421,608892,0,10231,0,10731,500,501,20.462,0.0
10422,575814,500,7850,500,8850,1000,501,15.7,0.0
10423,418835,500,8000,500,9000,1000,501,16.0,0.0
10424,1818996,0,29154,0,29654,500,501,58.308,0.0
10425,861863,0,16171,0,16671,500,501,32.342,0.0
10426,694270,0,12293,0,12793,500,501,24.586,0.0
10427,686153,500,8500,500,9500,1000,501,17.0,0.0
10428,143897,0,1625,0,1950,325,326,5.0,0.0
10429,344028,60,5580,60,5700,120,61,93.0,0.0
10430,382400,0,6500,0,7000,500,501,13.0,0.0
10431,480302,500,7552,500,8552,1000,501,15.104,0.0
10432,331644,0,3605,0,4105,500,501,7.21,0.0
10433,539786,0,7320,0,7820,500,501,14.64,0.0
10434,337863,0,6636,0,7136,500,501,13.272,0.0
10435,880540,0,15384,0,15884,500,501,30.768,0.0
10437,643755,0,12455,0,12955,500,501,24.91,0.0
10438,217672,500,2469,500,3469,1000,502,4.938,0.0
10439,150612,348,1682,348,2378,696,350,4.833,0.0
1044,350857,0,5000,0,5500,500,501,10.0,0.0
10440,223536,500,2500,500,3500,1000,502,5.0,0.0
10441,31506,78,390,78,546,156,79,5.0,0.0
10442,224091,500,2500,500,3500,1000,502,5.0,0.0
10444,715080,999,10433,999,12431,1998,1002,10.443,0.0
10445,761870,971,9163,971,11605,2442,1474,9.437,0.0
10446,95241,217,1058,217,1492,434,219,4.876,0.0
10448,204062,500,2500,500,3500,1000,502,5.0,0.0
10449,418668,500,7000,500,8000,1000,501,14.0,1.0
10450,525291,500,9820,500,10820,1000,501,19.64,1.0
10451,423425,500,7000,500,8000,1000,501,14.0,1.0
10452,680779,500,9703,500,10703,1000,501,19.406,0.75
10453,141662,147,1308,147,1602,294,148,8.898,0.0
10454,447089,500,7507,500,8507,1000,501,15.014,1.0
10455,370467,500,4529,500,5529,1000,501,9.058,0.0
10457,295614,500,4864,500,5864,1000,501,9.728,0.0
10465,328410,500,3600,500,4600,1000,501,7.2,0.0
10466,355588,0,4500,0,5000,500,501,9.0,0.0
10467,247107,500,2500,500,3500,1000,501,5.0,0.0
10468,423223,500,6508,500,7508,1000,501,13.016,0.0
1047,74366,110,880,110,1100,220,111,8.0,0.0
10474,346043,457,3916,457,4830,914,458,8.569,0.0
10475,1414105,500,32402,500,33402,1000,501,64.804,0.0
10476,1422821,500,31959,500,32959,1000,501,63.918,0.0
10477,304014,500,3500,500,4500,1000,501,7.0,0.0
10478,520949,500,8253,500,9253,1000,501,16.506,0.0
10480,1033808,500,24625,500,25625,1000,501,49.25,0.0
10481,392917,500,6500,500,7500,1000,501,13.0,0.0
10482,2195041,500,4000,500,5000,1000,501,8.0,0.0
10483,631343,0,10500,0,11000,500,501,21.0,0.0
10484,400857,500,4956,500,5956,1000,501,9.912,0.0
10486,5009,10,40,10,60,20,11,4.0,0.0
10487,13046,31,93,31,155,62,32,3.0,0.0
10488,3612,0,40,0,48,8,9,5.0,0.0
10490,5335,7,56,7,70,14,8,8.0,0.0
10491,11608,0,108,0,144,36,37,3.0,0.0
10492,412117,500,6000,500,7000,1000,501,12.0,0.0
10493,2239,0,15,0,20,5,6,3.0,0.0
10494,35117,48,631,48,727,96,49,13.146,0.0
10495,7123,16,63,16,95,32,17,3.938,0.0
10496,4930,0,46,0,52,6,7,7.667,0.5
10497,439410,500,6418,500,7418,1000,501,12.836,0.0
10498,16006,0,153,0,204,51,52,3.0,1.0
10499,15996,30,150,30,210,60,31,5.0,0.0
10500,30370,44,358,44,446,88,45,8.136,1.0
10501,262540,0,3500,0,4000,500,501,7.0,0.0
10503,270689,500,3805,500,4805,1000,501,7.61,1.0
10504,957694,500,11827,500,13327,1500,1001,23.654,0.0
10505,58434,70,487,70,627,140,71,6.957,0.0
10506,378833,0,3756,0,4756,1000,957,7.512,0.0
10507,283349,500,3996,500,4996,1000,501,7.992,0.5
10508,5331,7,56,7,70,14,8,8.0,0.0
10509,120069,33,1555,33,1621,66,34,47.121,0.0
1051,16978,5,269,5,279,10,6,53.8,0.0
10510,783700,500,6500,500,7986,1486,952,13.0,0.0
10511,6912,0,67,0,77,10,11,6.7,0.0
10512,9691,35,43,35,113,70,36,1.229,0.0
10513,22942,0,271,0,304,33,34,8.212,0.0
10514,1539568,0,12436,0,12863,427,428,29.124,0.0
10515,2803,0,20,0,25,5,6,4.0,0.0
10518,406614,0,6857,0,7357,500,501,13.714,0.0
10519,7571,0,72,0,84,12,13,6.0,0.0
10520,4149,0,42,0,49,7,8,6.0,0.0
10522,23095,4,20,4,28,8,5,5.0,0.0
10523,20116,47,141,47,235,94,48,3.0,0.0
10524,2674,5,20,5,30,10,6,4.0,0.0
10526,358164,500,4480,500,5480,1000,501,8.96,0.0
10527,248953,500,2497,500,3497,1000,501,4.994,0.5
10528,3418,0,30,0,34,4,5,7.5,0.0
10530,309418,500,6102,500,7102,1000,501,12.204,0.0
10532,2793,0,20,0,25,5,6,4.0,0.0
10533,33004,63,441,63,567,126,64,7.0,0.0
10534,4128,0,37,0,45,8,9,4.625,0.0
10536,581048,0,7240,0,8240,1000,839,14.48,0.0
10538,40393,0,440,0,495,55,56,8.0,0.0
10539,5125,7,53,7,67,14,8,7.571,0.0
10543,11278,0,116,0,132,16,17,7.25,0.0
10544,2814,0,24,0,32,8,9,3.0,0.5
10545,292823,0,3500,0,4000,500,501,7.0,0.0
10546,277311,500,3965,500,4965,1000,501,7.93,0.75
10547,10805,19,95,19,133,38,20,5.0,0.0
10548,280975,0,3995,0,4495,500,501,7.99,0.75
10549,436166,500,5573,500,6573,1000,501,11.146,0.0
1055,3374,0,28,0,35,7,8,4.0,0.0
10551,5301,7,56,7,70,14,8,8.0,0.0
10552,177267,245,735,245,1225,490,246,3.0,0.0
10553,228092,308,1180,308,1796,616,309,3.831,0.5
10554,582469,896,7348,896,9640,2292,1398,5.264,0.0
10555,473416,500,4000,500,5000,1000,501,8.0,1.0
10556,780106,0,13000,0,13500,500,501,26.0,0.0
10557,19909,26,203,26,255,52,27,7.808,0.0
10559,7577,0,84,0,98,14,15,6.0,0.0
1056,270044,121,2205,121,2447,242,122,18.223,0.5
10560,296456,0,3500,0,4000,500,501,7.0,0.5
10561,264402,500,3000,500,4000,1000,501,6.0,0.0
10563,5309,7,56,7,70,14,8,8.0,0.0
10564,4626,7,39,7,53,14,8,5.571,0.0
10565,290851,0,3924,0,4424,500,501,7.848,0.0
10567,101031,209,1045,209,1463,418,210,5.0,0.0
10568,20503,61,183,61,305,122,62,3.0,0.0
10570,2023,0,12,0,16,4,5,3.0,0.0
10571,3420607,500,58083,500,59083,1000,501,116.166,0.0
10572,28051,63,252,63,378,126,64,4.0,0.0
10574,389593,0,6500,0,7000,500,501,13.0,0.0
10575,8604,8,164,8,180,16,9,20.5,0.0
10576,29427,0,249,0,332,83,84,3.0,0.5
10577,18488,0,172,0,194,22,23,7.818,0.0
10578,339116,0,4500,0,5000,500,501,9.0,0.0
10580,8901,12,173,12,197,24,13,14.417,0.5
10581,17027,17,478,17,512,34,18,28.118,0.0
10582,9120,28,84,28,140,56,29,3.0,0.0
10583,16596,0,228,0,266,38,39,6.0,0.0
10584,261998,0,3500,0,4000,500,501,7.0,0.0
10585,291573,0,3500,0,4000,500,501,7.0,0.5
10586,336570,0,4500,0,5000,500,501,9.0,0.0
10587,246738,500,3000,500,4000,1000,501,6.0,0.0
10588,256551,500,3000,500,4000,1000,501,6.0,0.0
10589,17006,0,206,0,231,25,26,8.24,0.5
10590,240147,0,3500,0,4000,500,501,7.0,0.0
10591,300297,0,3049,0,4049,1000,960,6.098,0.0
10592,2121,0,19,0,20,1,2,19.0,0.0
10593,599109,500,18000,500,19000,1000,501,36.0,0.0
10594,364458,0,6118,0,6618,500,501,12.236,0.0
10596,675184,0,8922,0,9922,1000,1001,17.844,1.0
10597,9378,35,41,35,111,70,36,1.171,0.0
10598,10728,0,124,0,149,25,26,4.96,0.5
10599,38338,0,360,0,452,92,93,3.913,0.5
1060,1423930,0,28500,0,29000,500,501,57.0,0.0
10600,480238,0,6828,0,7328,500,501,13.656,0.0
10601,94521,139,695,139,973,278,140,5.0,0.0
10602,3891,8,48,8,64,16,9,6.0,0.0
10603,53420,174,522,174,870,348,175,3.0,0.0
10604,582492,500,7969,500,8969,1000,501,15.938,0.0
10605,3812,8,48,8,64,16,9,6.0,0.0
10606,465098,0,5000,0,5500,500,501,10.0,0.0
10607,3969,5,40,5,50,10,6,8.0,0.0
10608,1526,1,10,1,12,2,2,10.0,0.0
10610,241167,500,3000,500,4000,1000,501,6.0,0.0
10611,8415,15,105,15,135,30,16,7.0,0.0
10612,661861,165,4707,165,5037,330,166,28.527,0.0
10613,12615,32,96,32,160,64,33,3.0,0.0
10614,279852,0,3989,0,4489,500,501,7.978,0.75
10615,69788,84,747,84,915,168,85,8.893,0.0
10617,6708,6,96,6,108,12,8,16.0,0.0
10619,54561,121,605,121,847,242,123,5.0,0.0
1062,74363,110,880,110,1100,220,111,8.0,0.0
10620,127115,165,1320,165,1815,495,330,8.0,0.0
10621,11835,20,120,20,160,40,22,6.0,0.5
10624,1890840,500,31974,500,32974,1000,501,63.948,0.0
10627,1876485,0,31774,0,32274,500,501,63.548,0.0
10628,3307485,0,58812,0,59312,500,501,117.624,0.0
1063,9814,4,27,4,37,10,7,6.75,0.0
10630,3312878,500,59000,500,60000,1000,501,118.0,0.0
10633,673474,500,11233,500,12233,1000,501,22.466,0.0
10634,3308162,500,58812,500,59812,1000,501,117.624,0.0
10636,292012,500,4500,500,5500,1000,501,9.0,0.0
10638,205613,157,1934,157,2248,314,158,12.318,0.0
10639,242036,500,2500,500,3500,1000,501,5.0,0.0
10640,1151748,500,5994,500,6994,1000,501,11.988,0.0
10641,85442,192,1344,192,1728,384,193,7.0,0.0
10642,300673,263,2905,263,3694,789,527,11.046,0.0
10649,228454,500,3000,500,4000,1000,501,6.0,0.0
1065,325646,500,4723,500,5723,1000,501,9.446,0.0
10650,238592,500,3000,500,4000,1000,501,6.0,0.0
10652,309867,500,4000,500,5000,1000,501,8.0,0.0
10653,392989,500,2986,500,3986,1000,501,5.972,0.0
10654,1049,1,6,1,8,2,3,6.0,0.0
10655,2341967,103,927,103,1133,206,105,9.0,0.0
10656,805744,500,8000,500,9000,1000,502,16.0,0.0
10657,487001,0,3779,0,4779,1000,1001,7.558,0.5
1066,452279,500,7024,500,8024,1000,501,14.048,0.0
10662,195226,500,2500,500,3500,1000,501,5.0,0.0
10664,1937553,0,371,0,424,53,54,7.0,0.0
10665,408490,0,105,0,120,15,16,7.0,0.0
10666,317332,500,4000,500,5000,1000,501,8.0,0.0
10667,4307974,0,2492,0,2848,356,357,7.0,0.0
1067,80804,96,1404,96,1596,192,97,14.625,0.0
10671,302051,0,168,0,192,24,25,7.0,0.0
10672,265437,0,4073,0,4573,500,501,8.146,0.0
10673,399624,0,6984,0,7484,500,501,13.968,0.0
10674,517598,0,7000,0,7500,500,501,14.0,0.0
10675,367022,500,4000,500,5000,1000,501,8.0,0.0
10676,268393,0,3357,0,3857,500,501,6.714,0.0
10678,3749546,500,5961,500,6961,1000,501,11.922,0.0
10679,974727,500,13119,500,14119,1000,501,26.238,0.0
10681,184800,0,2125,0,2550,425,426,5.0,0.0
10682,21289,54,216,54,324,108,55,4.0,0.0
10683,209348,0,2545,0,3045,500,501,5.09,0.0
10684,432868,93,5486,93,5672,186,94,58.989,0.0
10685,213516,0,1500,0,2500,1000,881,3.0,0.0
10687,317201,500,3518,500,4518,1000,501,7.036,0.0
10689,483348,0,8439,0,8939,500,501,16.878,0.0
10690,32480,83,415,83,581,166,84,5.0,0.0
10691,73966,124,865,124,1113,248,125,6.976,0.0
10693,231882,0,3023,0,3523,500,501,6.046,0.0
10694,281596,500,4500,500,5500,1000,501,9.0,0.0
10695,19984,48,192,48,288,96,49,4.0,0.0
10696,326371,500,3875,500,4875,1000,501,7.75,0.0
10697,310779,500,4351,500,5351,1000,501,8.702,0.0
10698,176075,0,1807,0,2307,500,501,3.614,0.0
10699,1005139,500,23148,500,24148,1000,501,46.296,0.0
10700,204246,496,1984,496,2976,992,497,4.0,0.0
10701,602020,0,9497,0,9997,500,501,18.994,0.0
10702,188968,0,2125,0,2550,425,426,5.0,0.0
10704,378805,0,6596,0,7096,500,501,13.192,0.0
10705,32125,83,415,83,581,166,84,5.0,0.0
10706,344687,500,4000,500,5000,1000,501,8.0,0.0
10707,342683,500,4001,500,5001,1000,501,8.002,0.0
10708,67863,0,748,0,823,75,76,9.973,0.0
10709,4612724,0,11945,0,12445,500,501,23.89,0.0
10711,409115,192,9280,192,9664,384,193,48.333,0.0
10713,262699,0,4091,0,4591,500,501,8.182,0.0
10714,32121,83,415,83,581,166,84,5.0,0.0
10716,401521,500,5000,500,6000,1000,501,10.0,0.0
10718,560594,500,6999,500,7999,1000,501,13.998,0.0
1072,844113,500,13643,500,14643,1000,501,27.286,0.0
10720,970960,500,22323,500,23323,1000,501,44.646,0.0
10722,106543,0,1260,0,1512,252,253,5.0,0.0
10725,430127,0,7882,0,8382,500,501,15.764,0.0
10726,862614,0,6967,0,7467,500,501,13.934,0.0
10727,820322,500,10073,500,11073,1000,501,20.146,0.0
10728,606462,500,11199,500,12199,1000,501,22.398,0.0
10729,186001,0,2229,0,2729,500,501,4.458,0.0
1073,10870,16,128,16,160,32,17,8.0,0.0
10730,720253,500,7500,500,8500,1000,501,15.0,0.0
10731,32143,83,415,83,581,166,84,5.0,0.0
10732,343710,500,4500,500,5500,1000,501,9.0,0.0
10733,307093,0,5513,0,6013,500,501,11.026,0.0
10734,232432,208,2912,208,3328,416,209,14.0,0.0
10735,43935,108,432,108,648,216,109,4.0,0.0
10736,96559,250,1000,250,1500,500,251,4.0,0.0
10737,28152,29,348,29,406,58,30,12.0,0.0
10738,281894,0,4052,0,4552,500,501,8.104,0.0
10739,179362,0,1500,0,2000,500,501,3.0,0.0
1074,413143,0,8500,0,9000,500,501,17.0,0.0
10740,253223,500,3000,500,4000,1000,501,6.0,0.0
10741,78472,160,910,160,1230,320,161,5.688,0.0
10742,181558,0,1500,0,2000,500,501,3.0,0.0
10743,274107,0,4000,0,4500,500,501,8.0,0.0
10745,322775,500,3979,500,4979,1000,501,7.958,0.0
10746,273084,500,3523,500,4523,1000,501,7.046,1.0
10747,151461,0,1458,0,1701,243,244,6.0,0.0
10748,656588,0,8302,0,8802,500,501,16.604,0.0
10750,3850,8,32,8,48,16,9,4.0,0.0
10751,253554,500,4000,500,5000,1000,501,8.0,0.0
10752,252376,0,3906,0,4406,500,501,7.812,0.0
10753,435575,0,7553,0,8053,500,501,15.106,0.0
10754,539735,0,8505,0,9005,500,501,17.01,0.0
10755,219007,0,2000,0,2500,500,501,4.0,0.0
10757,49851,90,807,90,987,180,91,8.967,0.0
10758,258220,500,3000,500,4000,1000,501,6.0,0.0
10759,327319,0,5141,0,5641,500,501,10.282,0.0
10760,415413,0,6000,0,6500,500,501,12.0,0.0
10763,189353,375,2250,375,3000,750,376,6.0,0.0
10764,686286,500,11725,500,12725,1000,501,23.45,0.0
10765,206545,0,3000,0,3500,500,501,6.0,0.0
10766,70609,0,500,0,750,250,251,4.0,0.0
10767,731336,0,11500,0,12000,500,501,23.0,0.0
10768,199746,0,1957,0,2457,500,501,3.914,0.5
10770,242379,0,2489,0,2989,500,501,4.978,0.5
10771,259532,0,3478,0,3978,500,501,6.956,0.0
10773,151755,300,1800,300,2400,600,301,6.0,0.0
10775,882707,0,14877,0,15377,500,501,29.754,0.0
10776,7881,6,132,6,144,12,7,22.0,0.0
10777,168885,85,1268,85,1438,170,86,14.918,0.0
10778,529924,500,6236,500,7236,1000,501,12.472,0.0
10779,1069440,500,24803,500,25803,1000,501,49.606,0.0
10780,213113,0,2500,0,3000,500,501,5.0,0.0
10782,220601,0,3000,0,3500,500,501,6.0,0.0
10783,458849,500,10000,500,11000,1000,501,20.0,0.0
10784,84224,0,918,0,1071,153,154,6.0,0.0
10785,504594,0,6776,0,7276,500,501,13.552,1.0
10786,411734,0,5496,0,5996,500,501,10.992,0.0
10787,257044,500,3000,500,4000,1000,501,6.0,0.0
10788,88907,0,991,0,1239,248,249,3.996,0.0
10789,404309,0,7330,0,7830,500,501,14.66,0.0
10790,462076,0,8030,0,8530,500,501,16.06,0.0
10791,278510,500,3500,500,4500,1000,502,7.0,0.0
10792,222165,500,2500,500,3500,1000,502,5.0,0.0
10793,915112,0,13000,0,13500,500,501,26.0,0.0
10794,615270,500,11918,500,12918,1000,501,23.836,0.0
10795,195819,500,2500,500,3500,1000,502,5.0,0.0
10797,52968,56,895,56,1007,112,58,15.982,0.0
10798,210504,500,2500,500,3500,1000,502,5.0,0.0
10800,715080,999,10433,999,12431,1998,1002,10.443,0.0
10801,2869,4,33,4,41,8,6,8.25,0.0
10802,438858,500,7445,500,8445,1000,502,14.89,0.5
10803,761870,971,9163,971,11605,2442,1474,9.437,0.0
10804,225136,500,2500,500,3500,1000,502,5.0,0.0
10805,333464,596,4595,596,5787,1192,598,7.71,0.0
10806,256517,500,3500,500,4500,1000,502,7.0,0.0
10807,439303,0,5943,0,6443,500,501,11.886,0.0
10808,137499,113,1704,113,1930,226,115,15.08,0.5
10809,273021,0,2761,0,3261,500,501,5.522,0.5
10818,492837,500,7500,500,8500,1000,501,15.0,0.0
1082,20974,19,123,19,170,47,29,6.474,0.5
10828,478148,500,9000,500,10000,1000,501,18.0,0.0
10829,277840,500,5500,500,6500,1000,501,11.0,0.0
10830,371048,500,10000,500,11000,1000,501,20.0,0.0
10834,348269,500,5000,500,6000,1000,501,10.0,0.0
10842,630943,500,10069,500,11069,1000,502,20.138,0.0
10844,518536,464,5912,464,7310,1398,508,12.741,0.0
10846,368748,500,5046,500,6046,1000,502,10.092,0.0
10848,91490,0,1053,0,1134,81,82,13.0,0.0
10850,436632,500,9000,500,10000,1000,502,18.0,0.0
10853,629848,0,11230,0,11730,500,501,22.46,0.0
10857,26342,39,310,39,388,78,41,7.949,0.0
10859,34021,74,296,74,444,148,76,4.0,0.0
10860,147211,250,1829,250,2329,500,252,7.316,0.0
10861,7574,0,119,0,130,11,12,10.818,1.0
10862,279264,500,3000,500,4000,1000,502,6.0,0.0
10864,190207,500,2023,500,3023,1000,502,4.046,0.0
10865,288592,433,3459,433,4325,866,435,7.988,0.0
10866,27821,29,430,29,488,58,31,14.828,0.5
10871,685334,0,12003,0,12503,500,501,24.006,0.0
10872,373868,0,5497,0,5997,500,501,10.994,0.0
10874,295847,0,4000,0,4500,500,501,8.0,0.0
10875,64711,137,548,137,822,274,139,4.0,0.0
10877,614965,0,10000,0,10500,500,501,20.0,0.0
10878,872267,0,12180,0,13180,1000,535,24.36,0.0
10879,600794,500,7210,500,8710,1500,558,14.42,0.0
10880,175244,176,2044,176,2396,352,178,11.614,0.0
10881,7591,16,80,16,112,32,18,5.0,0.0
10882,554355,500,6499,500,7499,1000,502,12.998,0.0
10883,215833,178,2519,178,3053,534,253,14.152,0.0
10884,414047,500,6337,500,7337,1000,502,12.674,0.0
10887,924360,0,12500,0,13000,500,501,25.0,0.0
10889,949638,0,7988,0,8488,500,501,15.976,0.0
10892,435390,500,5000,500,6000,1000,502,10.0,0.0
10895,4272,6,36,6,48,12,8,6.0,0.0
10897,334597,500,6001,500,7001,1000,502,12.002,0.0
10898,315197,250,4251,250,5001,750,369,17.004,0.0
10899,556052,500,10000,500,11000,1000,502,20.0,0.0
10900,215507,0,2500,0,3000,500,501,5.0,0.0
10901,711863,500,6176,500,7676,1500,1002,12.352,0.0
10903,577437,500,9622,500,10622,1000,502,19.244,0.0
10905,419808,0,4801,0,5801,1000,696,9.602,0.0
10906,244388,0,3910,0,4410,500,501,7.82,0.0
10907,19218,0,272,0,306,34,35,8.0,0.0
10908,385658,0,6596,0,7096,500,501,13.192,0.0
1091,7762,0,84,0,96,12,13,7.0,0.0
10912,46423,35,210,35,510,300,207,6.0,0.0
10913,1627,2,16,2,20,4,4,8.0,0.0
10914,1571,1,13,1,15,2,3,13.0,0.0
10916,435197,500,7608,500,8608,1000,501,15.216,0.0
10917,796231,500,10807,500,12307,1500,980,21.614,0.0
10918,400009,500,6092,500,7092,1000,502,12.184,0.0
10919,900308,500,13929,500,15429,1500,1002,27.858,0.0
10924,87309,153,1071,153,1377,306,155,7.0,0.0
10926,260587,158,3002,158,3318,316,160,19.0,0.0
10929,3719,9,26,9,44,18,11,2.889,0.0
10931,615130,500,9498,500,10498,1000,502,18.996,0.0
10932,829397,500,13876,500,14876,1000,502,27.752,0.0
10934,11405,0,108,0,144,36,37,3.0,0.0
10935,397141,0,6148,0,6648,500,501,12.296,0.0
10937,92843,133,1476,133,1742,266,135,11.098,0.0
10938,8115,10,77,10,107,30,19,7.7,0.0
10939,6623,13,77,13,103,26,15,5.923,0.0
10941,339343,500,5416,500,6416,1000,502,10.832,0.0
10942,339437,500,5418,500,6418,1000,502,10.836,0.0
10943,830895,500,16392,500,17392,1000,502,32.784,0.0
10944,114596,234,1223,234,1691,468,236,5.226,0.8333333333333334
10945,301104,500,3981,500,4981,1000,502,7.962,0.0
10946,228661,0,3007,0,3507,500,501,6.014,0.0
10947,884919,500,15571,500,16571,1000,502,31.142,0.0
10948,324128,500,4495,500,5495,1000,502,8.99,0.5
10949,24191,24,312,24,360,48,26,13.0,1.0
10950,60641,47,782,47,876,94,49,16.638,0.0
10951,326736,0,4500,0,5000,500,501,9.0,0.5
10953,8761,19,127,19,165,38,21,6.684,0.0
10954,303489,500,3500,500,4500,1000,502,7.0,0.0
10955,407507,0,5000,0,5500,500,501,10.0,0.0
10958,1037607,500,15964,500,16964,1000,501,31.928,0.0
10960,439108,0,5899,0,6399,500,501,11.798,0.0
10962,313293,500,5604,500,6604,1000,501,11.208,0.0
10963,315807,0,4859,0,5359,500,501,9.718,0.0
10964,268935,0,3697,0,4197,500,501,7.394,0.0
10965,467710,500,5740,500,6740,1000,501,11.48,0.0
10967,330870,0,3000,0,3500,500,501,6.0,0.0
1097,417416,0,8500,0,9000,500,501,17.0,0.0
10970,167943,320,1279,320,1919,640,321,3.997,0.0
10971,61400,63,819,63,945,126,64,13.0,0.0
10972,483537,0,7231,0,7731,500,501,14.462,0.0
10973,41589,101,404,101,606,202,102,4.0,0.5
10974,4256,4,32,4,40,8,5,8.0,0.0
10975,52530,0,789,0,886,97,98,8.134,0.0
10977,340800,500,4991,500,5991,1000,501,9.982,0.0
10980,34419,101,303,101,505,202,102,3.0,0.5
10981,114607,101,1414,101,1616,202,102,14.0,0.0
10982,76065,101,1024,101,1226,202,102,10.139,0.0
10983,104542,187,1295,187,1669,374,188,6.925,0.0
10985,82291,85,1020,85,1190,170,86,12.0,0.0
10986,122433,197,1579,197,1973,394,198,8.015,0.0
10988,583680,500,8500,500,9500,1000,501,17.0,0.0
10989,780106,0,13000,0,13500,500,501,26.0,0.0
10993,104754,0,1357,0,1495,138,139,9.833,0.5
10995,34426,101,303,101,505,202,102,3.0,0.0
10997,69723,0,891,0,990,99,100,9.0,0.0
10998,1242563,985,10712,985,12682,1970,987,10.875,0.0
10999,541477,500,9870,500,10870,1000,501,19.74,0.0
1100,856581,500,13926,500,14926,1000,501,27.852,0.0
11000,365926,500,5500,500,6500,1000,501,11.0,0.0
11001,556061,500,8854,500,9854,1000,501,17.708,0.0
11002,213276,500,2000,500,3000,1000,501,4.0,0.0
11005,660507,500,11499,500,12499,1000,501,22.998,0.0
11006,281062,500,2431,500,3431,1000,501,4.862,0.0
11008,866768,500,13509,500,14509,1000,501,27.018,0.0
11009,233876,500,2915,500,3915,1000,501,5.83,0.0
11012,113061,9,72,9,90,18,10,8.0,0.0
11013,279978,500,3000,500,4000,1000,501,6.0,0.0
11015,150567,132,2308,132,2572,264,134,17.485,0.0
11016,831245,1000,14477,1000,16477,2000,1002,14.477,0.0
11018,473750,500,6500,500,7500,1000,501,13.0,0.0
11019,136998,108,1207,108,1423,216,109,11.176,0.0
11020,303453,500,4808,500,5808,1000,501,9.616,0.0
11029,240925,500,3000,500,4000,1000,501,6.0,0.0
11031,43411,40,336,40,416,80,41,8.4,0.0
11037,636364,500,9488,500,10488,1000,501,18.976,0.0
11040,419112,500,2772,500,3772,1000,501,5.544,0.0
11041,448671,500,7658,500,8658,1000,501,15.316,1.0
11042,3072261,20,160,20,200,40,21,8.0,0.0
11043,346788,0,6467,0,6967,500,501,12.934,0.0
11044,505802,0,8075,0,8575,500,501,16.15,0.5
11045,607846,0,9936,0,10436,500,501,19.872,0.0
11047,11191,21,150,21,192,42,22,7.143,0.0
11048,12630694,232,2088,232,2552,464,233,9.0,0.0
1105,571942,500,8878,500,9878,1000,501,17.756,0.0
11050,469619,0,7397,0,7897,500,501,14.794,1.0
11051,21181,0,280,0,290,10,11,28.0,0.0
11052,30025,31,372,31,434,62,32,12.0,0.0
11053,1262665,500,13048,500,14048,1000,501,26.096,0.0
11054,2588366,59,898,59,1016,118,60,15.22,0.0
11055,233449,500,3500,500,4500,1000,501,7.0,0.0
11056,249166,500,4000,500,5000,1000,501,8.0,0.0
11057,569472,0,8201,0,8701,500,501,16.402,0.0
11058,450736,537,7790,537,8864,1074,539,14.507,0.0
11059,274732,0,3337,0,3837,500,501,6.674,0.0
11060,739265,0,10872,0,11372,500,501,21.744,0.5
11061,429546,0,6500,0,7000,500,501,13.0,0.0
11062,1763158,500,30601,500,31601,1000,501,61.202,0.0
11063,1009524,0,15882,0,16382,500,501,31.764,0.0
11064,83099,36,529,36,601,72,37,14.694,0.0
11065,567343,500,8953,500,9953,1000,501,17.906,0.0
11066,75455,0,990,0,1100,110,111,9.0,0.0
11067,423831,500,5455,500,6455,1000,502,10.91,0.0
11068,176131,500,1500,500,2500,1000,502,3.0,0.0
11069,28134,74,296,74,444,148,76,4.0,1.0
11070,557713,500,8860,500,9860,1000,502,17.72,0.0
11071,234075,0,3500,0,4000,500,501,7.0,0.0
11073,265609,500,2500,500,3500,1000,502,5.0,0.0
11074,559350,500,7684,500,8684,1000,502,15.368,0.0
11075,330975,0,5464,0,5964,500,501,10.928,0.0
11077,469532,500,6984,500,7984,1000,502,13.968,0.0
11080,232161,0,3604,0,3810,206,207,17.495,1.0
11081,347493,0,4468,0,4968,500,501,8.936,0.5
11084,252236,500,2754,500,3754,1000,501,5.508,0.0
11085,251441,368,2574,368,3648,1074,556,6.995,0.0
11098,470113,500,6872,500,7872,1000,501,13.744,0.0
11100,800250,1000,13358,1000,15358,2000,1002,13.358,0.0
11101,596101,1000,10004,1000,12012,2008,1008,10.004,0.0
11102,224130,500,3000,500,4000,1000,501,6.0,0.0
11104,644302,500,9652,500,10652,1000,501,19.304,0.0
11105,70320,46,776,46,868,92,47,16.87,0.0
11106,1489019,71,331,71,473,142,72,4.662,0.5
11108,797540,500,13000,500,14000,1000,501,26.0,0.0
11110,302425,500,5039,500,6039,1000,501,10.078,0.0
11112,222948,500,2000,500,3000,1000,501,4.0,0.0
11113,227410,500,2980,500,3980,1000,501,5.96,0.0
11114,939146,500,17859,500,18859,1000,501,35.718,0.0
11115,61168,88,790,88,966,176,89,8.977,0.0
11119,293193,500,3500,500,4500,1000,501,7.0,0.0
11120,361927,0,6476,0,6976,500,501,12.952,0.0
11122,402137,500,5762,500,6762,1000,501,11.524,0.0
11123,459745,0,8341,0,8841,500,501,16.682,0.75
11124,630215,0,9878,0,10378,500,501,19.756,0.0
11126,278714,500,3000,500,4000,1000,501,6.0,0.0
11127,305113,500,2875,500,3875,1000,501,5.75,0.0
11128,387419,0,5081,0,5581,500,501,10.162,0.0
11129,462648,500,6084,500,7084,1000,501,12.168,0.0
1113,428014,500,7070,500,8070,1000,501,14.14,0.0
11131,585833,500,9801,500,10801,1000,501,19.602,0.5
11132,402929,0,6834,0,7236,402,403,17.0,0.0
11133,1163670,500,18030,500,19030,1000,501,36.06,0.0
11134,13348,0,144,0,160,16,17,9.0,0.0
11135,524416,500,7763,500,8763,1000,501,15.526,0.6666666666666666
11137,366859,500,5799,500,6799,1000,501,11.598,0.0
11138,19510,0,225,0,250,25,26,9.0,0.0
11139,491962,0,7822,0,8322,500,501,15.644,0.0
11140,343546,0,4500,0,5000,500,501,9.0,0.5
11141,2967831,7,56,7,70,14,8,8.0,0.0
11142,361656,0,5500,0,6000,500,501,11.0,0.0
11143,1123527,500,13793,500,14793,1000,501,27.586,0.5
11144,459399,500,7906,500,8906,1000,501,15.812,0.0
11145,396742,0,6000,0,6500,500,501,12.0,0.6666666666666666
11146,677949,0,13906,0,14406,500,501,27.812,0.5
11148,285799,0,3500,0,4000,500,501,7.0,0.0
11150,589099,0,7593,0,8093,500,501,15.186,0.0
11151,72700,62,1105,62,1229,124,63,17.823,0.0
11155,340128,0,5283,0,5783,500,501,10.566,1.0
11158,695144,0,12234,0,12734,500,501,24.468,0.5
11159,316850,500,3998,500,4998,1000,501,7.996,0.0
1116,469487,0,9000,0,9500,500,501,18.0,0.0
11161,684166,498,8007,498,9501,1494,997,16.078,0.0
11165,887500,0,10036,0,10536,500,501,20.072,0.0
11166,433820,0,6730,0,7212,482,483,13.963,0.0
11168,433518,0,7961,0,8461,500,501,15.922,0.0
1117,22942,0,210,0,240,30,31,7.0,0.0
11171,780106,0,13000,0,13500,500,501,26.0,0.0
11173,719913,500,13212,500,14212,1000,501,26.424,0.0
11175,951063,909,11954,909,13772,1818,911,13.151,0.0
11176,1911170,903,11918,903,13724,1806,905,13.198,0.0
11177,293293,500,4499,500,5499,1000,501,8.998,0.0
11178,943508,921,11964,921,13806,1842,923,12.99,0.0
11179,715636,910,9460,910,11280,1820,912,10.396,0.0
1118,146956,298,1926,298,2522,596,299,6.463,0.0
11180,24156,53,159,53,265,106,54,3.0,0.0
11183,263662,500,3000,500,4000,1000,501,6.0,0.0
11185,285168,500,4500,500,5500,1000,501,9.0,0.0
11186,562563,139,1628,139,1906,278,140,11.712,0.0
11188,231220,270,2160,270,2700,540,271,8.0,0.0
11190,442420,500,6500,500,7500,1000,501,13.0,0.0
11192,7137,9,90,9,108,18,10,10.0,0.0
11193,663876,500,9084,500,10084,1000,501,18.168,0.5
11194,295964,500,4000,500,5000,1000,501,8.0,0.0
11195,348457,500,5000,500,6000,1000,501,10.0,1.0
11200,20050,0,290,0,319,29,30,10.0,0.5
11203,1964941,0,26038,0,26472,434,435,59.995,0.0
11204,261117,0,3500,0,4000,500,501,7.0,0.0
11205,512217,0,8352,0,8852,500,501,16.704,0.0
11206,288455,500,3000,500,4000,1000,501,6.0,0.0
11208,66454,80,1440,80,1600,160,81,18.0,0.0
11209,456641,500,7976,500,8976,1000,501,15.952,0.0
11210,411000,0,5731,0,6231,500,501,11.462,0.0
11211,907892,500,14906,500,15906,1000,501,29.812,0.0
11212,220815,500,2000,500,3000,1000,501,4.0,0.0
11213,117793,260,1299,260,1819,520,261,4.996,0.0
11214,638421,500,3794,500,5294,1500,984,7.588,0.5
11215,556561,500,8801,500,9801,1000,501,17.602,0.0
11216,613920,0,9960,0,10460,500,501,19.92,0.0
11219,471832,500,7386,500,8386,1000,501,14.772,0.0
11220,776910,0,14311,0,14811,500,501,28.622,0.0
11221,390227,500,6165,500,7165,1000,501,12.33,0.0
11222,47014,101,416,101,618,202,102,4.119,0.0
11223,323364,0,5001,0,5501,500,501,10.002,0.0
11224,804835,0,17281,0,17781,500,501,34.562,0.0
11225,829457,0,3675,0,3780,105,106,35.0,1.0
11228,334059,500,3499,500,4499,1000,502,6.998,0.5
11229,669466,985,8640,985,11110,2470,1488,8.772,0.0
1123,9044,18,83,18,119,36,19,4.611,0.0
11230,250664,500,1500,500,3000,1500,999,3.0,0.0
11231,292385,500,3500,500,4500,1000,502,7.0,0.0
11232,27740,74,296,74,444,148,76,4.0,0.0
11233,434815,0,5498,0,5998,500,501,10.996,0.0
11234,730108,1000,10888,1000,12888,2000,1003,10.888,0.75
11235,5881,7,105,7,119,14,9,15.0,0.0
11236,715080,999,10433,999,12431,1998,1002,10.443,0.0
11237,261888,500,4000,500,5000,1000,502,8.0,0.0
11239,953308,0,15172,0,15672,500,501,30.344,0.0
11240,462294,0,4087,0,5587,1500,1501,8.174,0.5
11241,434869,0,7670,0,8170,500,501,15.34,0.0
11242,406199,500,6000,500,7000,1000,501,12.0,0.0
11244,771238,500,11393,500,12393,1000,501,22.786,0.0
11251,668058,500,10615,500,11615,1000,501,21.23,0.5
11253,289160,500,3759,500,4759,1000,501,7.518,0.0
11255,249561,328,2956,328,3612,656,330,9.012,0.0
11256,441659,500,7422,500,8422,1000,501,14.844,0.0
11257,728843,500,13000,500,14000,1000,501,26.0,0.0
11258,56118,16,356,16,388,32,17,22.25,0.5
1126,57699,19,133,19,172,39,21,7.0,1.0
11262,260135,500,3500,500,4500,1000,501,7.0,0.0
11265,6032,11,44,11,66,22,12,4.0,0.0
11270,30947,10,49,10,69,20,11,4.9,0.0
11271,354652,500,5819,500,6819,1000,501,11.638,0.5
11272,9449,20,80,20,120,40,21,4.0,0.0
11273,781481,500,13000,500,14000,1000,501,26.0,0.0
11274,46695,114,512,114,740,228,115,4.491,0.0
11275,145486,147,1737,147,2031,294,148,11.816,0.5
11278,23498,35,314,35,384,70,36,8.971,0.0
11280,405146,500,7228,500,8228,1000,501,14.456,0.0
11283,365512,0,5141,0,5641,500,501,10.282,0.0
11290,266207,500,2702,500,3702,1000,501,5.404,0.0
11291,174268,292,1675,292,2259,584,293,5.736,0.0
11293,279966,0,3411,0,3790,379,380,9.0,0.0
11294,320082,500,4000,500,5000,1000,501,8.0,0.0
11295,563351,0,8913,0,9413,500,501,17.826,0.0
11296,789927,0,10474,0,10974,500,501,20.948,0.0
11297,993068,0,14162,0,14662,500,501,28.324,0.0
11298,628524,0,4211,0,4711,500,501,8.422,0.0
11301,271797,0,3500,0,4000,500,501,7.0,0.0
11302,474159,0,3478,0,3978,500,501,6.956,0.0
11303,413016,0,6990,0,7490,500,501,13.98,0.0
11304,1333458,0,24602,0,25102,500,501,49.204,0.0
11305,405850,500,5500,500,6500,1000,501,11.0,0.5
11307,29479,0,378,0,420,42,43,9.0,0.0
11309,698812,0,11998,0,12498,500,501,23.996,0.0
11310,510207,0,7983,0,8983,1000,1001,15.966,0.0
11311,548385,0,7893,0,8393,500,501,15.786,0.0
11312,397562,500,3737,500,4737,1000,501,7.474,0.0
11314,269834,0,3574,0,4074,500,501,7.148,0.0
11316,244806,500,4000,500,5000,1000,501,8.0,0.0
11319,244374,500,3000,500,4000,1000,502,6.0,0.0
11323,648639,500,11818,500,12818,1000,502,23.636,0.0
11324,104187,105,1336,105,1546,210,106,12.724,0.0
11326,211587,500,2000,500,3000,1000,501,4.0,0.0
11327,413614,500,4990,500,5990,1000,502,9.98,0.0
11328,63208,0,828,0,966,138,139,6.0,0.0
11330,478730,0,6629,0,7050,421,422,15.746,0.0
11331,259890,0,3517,0,4017,500,501,7.034,0.0
11333,252777,0,3049,0,3549,500,501,6.098,0.5
11338,376256,500,4002,500,5502,1500,1001,8.004,0.0
11339,191143,500,2500,500,3500,1000,501,5.0,0.0
1134,14424,0,100,0,150,50,51,4.0,0.0
11340,8074,0,130,0,140,10,11,13.0,0.0
11341,242533,500,3457,500,4457,1000,501,6.914,0.0
11342,767802,500,13868,500,14868,1000,501,27.736,0.5
11343,697254,500,12872,500,13872,1000,501,25.744,0.0
11344,185429,500,2000,500,3000,1000,501,4.0,0.0
11348,474730,500,7153,500,8153,1000,501,14.306,0.0
11349,14306,38,114,38,190,76,39,3.0,0.0
11350,582113,500,5523,500,6523,1000,501,11.046,0.0
11351,302139,500,4486,500,5486,1000,501,8.972,0.0
11352,59866,53,318,53,424,106,54,6.0,0.0
11353,380116,500,4322,500,5322,1000,501,8.644,0.0
11354,533511,500,8762,500,9762,1000,501,17.524,0.0
11356,2568582,240,7901,240,8381,480,241,32.921,0.0
11357,2414926,500,2000,500,3000,1000,501,4.0,0.0
1136,190793,500,2000,500,3000,1000,502,4.0,0.0
11361,481256,500,6135,500,7135,1000,501,12.27,0.0
11366,664570,500,11500,500,12500,1000,501,23.0,0.5
11369,697724,1000,10406,1000,12906,2500,1502,10.406,0.0
11370,383403,791,6176,791,7758,1582,793,7.808,0.0
11371,1096736,500,19030,500,20030,1000,501,38.06,1.0
11372,1264616,0,15064,0,15727,663,664,30.128,0.0
11374,2072682,0,30000,0,30500,500,501,60.0,0.0
11375,293222,0,3500,0,4000,500,501,7.0,0.0
11376,282017,0,3174,0,3674,500,501,6.348,0.0
11377,329079,0,5639,0,6139,500,501,11.278,1.0
11379,565764,0,8208,0,8708,500,501,16.416,0.0
11380,328608,500,2810,500,3810,1000,501,5.62,0.0
11383,316172,0,4919,0,5419,500,501,9.838,0.5
11384,610057,0,11378,0,11878,500,501,22.756,0.0
11386,406857,500,5608,500,6608,1000,501,11.216,0.0
11387,270592,0,3500,0,4000,500,501,7.0,0.0
1139,272847,500,2965,500,3965,1000,502,5.93,0.0
11390,691633,0,10372,0,10872,500,501,20.744,0.0
11391,432490,0,6925,0,7425,500,501,13.85,0.0
11392,479710,500,7754,500,8754,1000,501,15.508,0.0
11394,563539,500,10527,500,11527,1000,501,21.054,0.0
11395,397137,500,5500,500,6500,1000,501,11.0,0.0
11396,180388,0,2184,0,2548,364,365,6.0,0.0
11398,542928,0,9024,0,9524,500,501,18.048,0.0
11399,2199,0,10,0,15,5,6,2.0,0.0
11400,1646825,0,33896,0,34396,500,501,67.792,0.0
11403,514768,0,5328,0,5828,500,501,10.656,0.0
11405,586508,0,3434,0,3934,500,501,6.868,0.0
11406,342029,500,4500,500,5500,1000,501,9.0,0.0
11407,1984,2,30,2,34,4,4,15.0,1.0
11408,417732,500,6011,500,7011,1000,502,12.022,0.0
11409,27618,74,296,74,444,148,76,4.0,0.5
1141,1059827,500,17831,500,18831,1000,501,35.662,0.0
11410,820842,0,12738,0,13238,500,501,25.476,0.0
11412,215091,186,2368,186,2924,556,320,12.731,0.0
11413,761870,971,9163,971,11605,2442,1474,9.437,0.0
11414,5786,7,105,7,119,14,9,15.0,1.0
11416,660179,1000,8932,1000,11432,2500,1503,8.932,0.0
11418,465274,500,5087,500,6587,1500,964,10.174,1.0
1142,29883,7,492,7,506,14,8,70.286,0.0
11420,514933,0,7306,0,7747,441,442,16.567,0.0
11423,31529,62,372,62,496,124,63,6.0,0.0
11425,493043,500,6832,500,7832,1000,501,13.664,0.0
11426,445443,0,4500,0,5000,500,501,9.0,0.0
11427,607883,0,11076,0,11576,500,501,22.152,1.0
11429,490900,500,5376,500,6865,1489,990,10.752,0.0
1143,1701,1,18,1,20,2,2,18.0,0.0
11430,14932,28,196,28,252,56,29,7.0,0.0
11432,269947,500,3997,500,4997,1000,501,7.994,0.0
11433,80783,126,1008,126,1260,252,127,8.0,0.0
11435,775344,500,12670,500,13670,1000,501,25.34,0.0
11436,284055,500,4195,500,5195,1000,501,8.39,0.0
11438,729077,500,13000,500,14000,1000,501,26.0,0.0
11440,404427,500,6814,500,7814,1000,501,13.628,0.5
11441,308620,500,4903,500,5903,1000,501,9.806,0.0
11442,543042,500,7997,500,8997,1000,501,15.994,0.0
11443,1015230,500,5055,500,6055,1000,501,10.11,0.0
11444,506933,500,2022,500,3022,1000,501,4.044,0.0
11445,8577,16,80,16,112,32,17,5.0,0.0
11446,947401,500,11471,500,12471,1000,501,22.942,0.0
11447,405495,500,4966,500,5966,1000,501,9.932,0.0
11448,688248,500,11500,500,12500,1000,501,23.0,0.0
11450,858827,1000,14054,1000,16054,2000,1002,14.054,0.0
11451,198967,500,2500,500,3500,1000,501,5.0,0.0
11452,242294,376,3008,376,3760,752,377,8.0,0.0
11453,380261,500,5782,500,6782,1000,501,11.564,0.0
11455,897966,1000,16276,1000,18276,2000,1002,16.276,0.0
11456,876951,1000,13225,1000,15225,2000,1002,13.225,0.0
11459,366343,327,4205,327,4859,654,328,12.859,0.0
11460,43759,61,732,61,854,122,62,12.0,0.0
11463,283345,500,4000,500,5000,1000,501,8.0,0.0
11464,485602,0,6768,0,7268,500,501,13.536,0.75
11466,564856,500,8374,500,9374,1000,501,16.748,0.0
11467,386465,0,5000,0,5500,500,501,10.0,0.0
11468,419581,500,5000,500,6000,1000,501,10.0,0.0
11469,282862,0,3616,0,4116,500,501,7.232,0.0
11471,146908,0,2150,0,2283,133,134,16.165,0.5
11473,581793,0,8651,0,9151,500,501,17.302,0.0
11474,477321,500,8083,500,9083,1000,501,16.166,0.0
11475,834819,0,15626,0,16126,500,501,31.252,0.0
11477,518047,0,8993,0,9493,500,501,17.986,0.0
11479,361116,500,2978,500,3978,1000,501,5.956,0.0
1148,213915,500,2236,500,3236,1000,501,4.472,0.0
11480,2912,4,36,4,44,8,5,9.0,0.0
11482,1329531,0,18169,0,18669,500,501,36.338,0.0
11483,495747,500,7352,500,8352,1000,501,14.704,0.0
11484,3676084,0,13890,0,14390,500,501,27.78,0.5
11485,2619760,0,41431,0,41931,500,501,82.862,0.0
11486,462634,0,7522,0,8022,500,501,15.044,0.0
11487,2132879,0,31405,0,31905,500,501,62.81,0.0
11488,686676,500,7000,500,8000,1000,501,14.0,0.0
11489,8968,0,110,0,120,10,11,11.0,0.0
1149,113043,0,2240,0,2380,140,141,16.0,0.0
11491,28029,30,358,30,418,60,31,11.933,0.0
11492,492904,0,7500,0,8000,500,501,15.0,0.0
11494,443871,500,6018,500,7018,1000,501,12.036,0.0
11495,1065525,0,19469,0,19969,500,501,38.938,0.0
11496,459406,500,7164,500,8164,1000,501,14.328,0.5
11497,509294,500,6500,500,7500,1000,501,13.0,0.0
11499,18377,0,231,0,252,21,22,11.0,0.0
11501,300918,0,3698,0,4198,500,501,7.396,0.0
11503,472565,500,8403,500,9403,1000,501,16.806,0.0
11504,328577,500,4000,500,5000,1000,501,8.0,0.0
11505,577338,500,8578,500,9578,1000,501,17.156,0.0
11506,400367,0,6998,0,7498,500,501,13.996,0.0
11507,207618,0,2535,0,3035,500,501,5.07,0.0
11508,26678,30,270,30,330,60,31,9.0,0.0
11509,926276,0,16057,0,16557,500,501,32.114,0.0
1151,56938,0,1120,0,1190,70,71,16.0,0.0
11510,606098,0,4452,0,4952,500,501,8.904,0.0
11514,400359,0,7999,0,8499,500,501,15.998,0.0
11515,619407,500,12387,500,13387,1000,501,24.774,0.5
11516,603635,500,11969,500,12969,1000,501,23.938,0.5
11517,1072288,500,19208,500,20208,1000,501,38.416,0.0
1152,615598,0,13440,0,13632,192,193,70.0,0.0
11529,694706,500,6592,500,7592,1000,501,13.184,0.0
1153,771546,0,12000,0,12500,500,501,24.0,0.0
11530,681978,500,11500,500,12500,1000,501,23.0,0.0
11532,283604,500,4380,500,5380,1000,501,8.76,0.5
11534,896481,500,8417,500,9721,1304,806,16.834,1.0
11535,325759,500,4779,500,5779,1000,501,9.558,0.0
11536,509489,1000,7967,1000,9967,2000,1002,7.967,0.0
11537,625984,500,10000,500,11000,1000,501,20.0,0.0
11538,352513,227,2845,227,3526,681,455,12.533,0.0
11540,641184,500,12716,500,13716,1000,501,25.432,0.0
11541,464424,500,8992,500,9992,1000,501,17.984,0.0
11542,398765,0,7129,0,7629,500,501,14.258,0.0
11543,1822827,0,29480,0,29980,500,501,58.96,0.0
11544,357872,500,4495,500,5495,1000,501,8.99,0.0
11546,400909,0,5500,0,6000,500,501,11.0,0.0
11547,489982,500,4998,500,5998,1000,501,9.996,0.0
11548,418830,394,3047,394,3835,788,395,7.734,0.0
11551,1044918,0,14368,0,14868,500,501,28.736,0.0
11552,578010,0,9179,0,9679,500,501,18.358,0.0
11553,25498,26,312,26,364,52,27,12.0,0.0
11554,386811,500,4295,500,5295,1000,501,8.59,0.0
11555,66107,106,1134,106,1346,212,107,10.698,0.0
11556,379809,0,9138,0,9638,500,501,18.276,0.5
11557,275712,500,4500,500,5500,1000,501,9.0,0.0
11559,238885,0,3500,0,4000,500,501,7.0,0.0
11560,441679,0,7273,0,7773,500,501,14.546,0.0
11562,436548,500,6500,500,7500,1000,501,13.0,0.5
11563,1066277,0,16360,0,16860,500,501,32.72,0.0
11564,334131,500,4406,500,5406,1000,501,8.812,0.0
11565,457245,0,4158,0,4660,502,503,8.316,0.5
11567,2079329,0,37363,0,37863,500,501,74.726,0.0
11568,846778,0,14357,0,14857,500,501,28.714,0.0
11569,938331,0,13746,0,14246,500,501,27.492,0.0
11570,2205416,500,34000,500,35000,1000,501,68.0,0.0
11571,497584,500,7358,500,8358,1000,501,14.716,0.0
11572,288363,500,3375,500,4375,1000,501,6.75,0.0
11573,1179417,0,8152,0,9176,1024,1021,16.304,0.0
11574,222095,0,2500,0,3000,500,501,5.0,0.0
11575,245138,0,3190,0,3480,290,291,11.0,0.5
11576,527316,0,5514,0,6014,500,501,11.028,0.0
11577,41172,0,450,0,525,75,76,6.0,0.5
11578,6705,8,85,8,101,16,9,10.625,0.0
11579,551669,0,9510,0,10010,500,501,19.02,0.0
11580,352064026,648465,4969837,6125943,5223658,253820,253820,20.580167047513985,0.0
11582,567081,320,6285,320,7548,1263,854,19.641,0.0
11585,380269,0,4635,0,5135,500,501,9.27,0.0
11586,327519,0,4890,0,5390,500,501,9.78,0.0
11587,413396,472,5663,472,6607,944,473,11.998,0.0
11588,261890,0,3956,0,4365,409,410,9.672,0.0
11590,958865,500,13596,500,15096,1500,581,27.192,0.0
11591,547218,500,10055,500,11055,1000,501,20.11,0.0
11592,110523,0,1291,0,1429,138,139,9.355,0.0
11607,303145,273,3058,273,3604,546,274,11.201,0.0
11608,401599,350,4550,350,5250,700,351,13.0,0.0
11612,384976,500,6014,500,7014,1000,501,12.028,1.0
11613,2241122,500,4170,500,5170,1000,501,8.34,0.0
11614,3840294,500,4000,500,5000,1000,501,8.0,0.0
11615,814683,497,12827,497,13821,994,498,25.809,0.0
11616,513786,500,7500,500,8500,1000,501,15.0,0.0
11617,633847,500,9136,500,10136,1000,501,18.272,0.0
11619,36776,53,477,53,583,106,54,9.0,0.0
11620,1073646,491,6999,491,7981,982,492,14.255,0.0
11623,84882,90,810,90,1080,270,181,9.0,0.0
11624,2725930,310,3481,310,4101,620,311,11.229,0.0
11628,1398,1,11,1,13,2,2,11.0,0.5
11629,409179,500,4991,500,5991,1000,501,9.982,0.0
11630,417755,500,5913,500,6913,1000,501,11.826,0.0
11636,1324423,0,19885,0,20385,500,501,39.77,1.0
11637,364764,0,6449,0,6949,500,501,12.898,0.0
11638,104330,125,938,125,1313,375,200,7.504,0.0
11639,623815,0,10552,0,11052,500,501,21.104,1.0
11640,451756,500,3000,500,4000,1000,501,6.0,0.0
11641,301691,500,2768,500,3768,1000,501,5.536,0.0
11643,289173,500,4999,500,5999,1000,501,9.998,0.5
11647,337270,500,4806,500,5806,1000,501,9.612,0.0
11648,114558,0,1464,0,1624,160,161,9.15,0.0
11649,523444,0,7799,0,8299,500,501,15.598,0.0
11652,290248,500,3500,500,4500,1000,501,7.0,0.0
11653,1211592,0,22182,0,22682,500,501,44.364,0.0
11654,293844,0,4000,0,4500,500,501,8.0,0.5
11656,1503424,500,24126,500,25126,1000,501,48.252,0.0
11657,1807623,0,33672,0,34172,500,501,67.344,0.0
11658,12454,30,120,30,180,60,31,4.0,0.0
11659,449435,500,7104,500,8104,1000,501,14.208,0.0
1166,5212,9,60,9,78,18,10,6.667,0.0
11660,415667,500,5500,500,6500,1000,501,11.0,0.0
11661,762918,0,14407,0,14907,500,501,28.814,0.0
11662,899844,500,7818,500,8818,1000,501,15.636,0.0
11663,32417,31,403,31,465,62,32,13.0,0.0
11664,368512,0,3549,0,4049,500,501,7.098,0.0
11665,548597,500,9000,500,10000,1000,501,18.0,0.0
11667,397652,500,5500,500,6500,1000,501,11.0,0.0
11668,359698,500,4968,500,5968,1000,501,9.936,0.0
1167,770593,0,12500,0,13000,500,501,25.0,0.0
11670,373048,500,5385,500,6385,1000,502,10.77,0.5
11671,257443,500,3000,500,4000,1000,501,6.0,0.0
11672,69067,155,917,155,1227,310,156,5.916,0.0
11673,428896,500,7499,500,8499,1000,502,14.998,0.5
11675,443251,500,5895,500,6895,1000,502,11.79,0.0
11676,233554,500,3500,500,4500,1000,501,7.0,0.0
11677,347112,500,5944,500,6944,1000,501,11.888,0.0
11680,758361,500,10860,500,11860,1000,501,21.72,0.0
11681,278591,0,3494,0,3994,500,501,6.988,0.0
11682,93651,45,1575,45,1665,90,46,35.0,0.0
11683,315947,0,4601,0,5101,500,501,9.202,0.0
11687,452294,500,7002,500,8002,1000,501,14.004,0.0
11691,461841,0,8455,0,8955,500,501,16.91,0.0
11694,977269,500,15006,500,16006,1000,501,30.012,0.5
11695,566641,999,9488,999,11486,1998,1001,9.497,0.0
11696,5163,11,44,11,66,22,12,4.0,0.0
11697,190332,500,1986,500,2986,1000,501,3.972,0.0
11698,91932,10,39,10,59,20,11,3.9,1.0
11699,1228902,117,468,117,702,234,118,4.0,0.0
11700,309184,500,4641,500,5641,1000,501,9.282,0.0
11703,732591,1000,11362,1000,13362,2000,1002,11.362,0.0
11704,435042,500,4051,500,5189,1138,639,8.102,0.0
11705,150129,273,1365,273,1911,546,274,5.0,0.0
11706,353064,500,4500,500,5500,1000,501,9.0,0.0
11707,5873,4,12,4,20,8,5,3.0,0.0
11708,1411001,500,13802,500,14802,1000,501,27.604,0.0
11710,142562,269,1614,269,2152,538,270,6.0,0.0
11711,227929,369,2952,369,3690,738,370,8.0,0.0
11712,5230,11,44,11,66,22,12,4.0,0.0
11713,107068,339,1017,339,1695,678,340,3.0,0.0
11714,740923,500,11018,500,12018,1000,501,22.036,0.0
11716,142422,120,2087,120,2327,240,121,17.392,0.0
11718,356077,0,6302,0,6802,500,501,12.604,0.8333333333333334
11720,3201284,0,49000,0,49500,500,501,98.0,0.0
11722,452823,0,7500,0,8000,500,501,15.0,0.0
11723,333430,500,4000,500,5000,1000,501,8.0,0.0
11725,418908,0,5727,0,6227,500,501,11.454,0.0
11727,5065,0,48,0,60,12,13,4.0,0.0
11728,533128,0,9797,0,10297,500,501,19.594,0.0
11729,344741,0,4609,0,5109,500,501,9.218,0.0
11730,13921,0,165,0,180,15,16,11.0,0.0
11731,309478,0,4000,0,4500,500,501,8.0,0.0
11732,444650,500,6000,500,7000,1000,501,12.0,0.0
11733,284181,0,3348,0,3848,500,501,6.696,0.5
11734,571476,0,8359,0,8859,500,501,16.718,0.0
11735,620737,500,8926,500,10426,1500,1001,17.852,0.5
11736,534101,0,9089,0,9589,500,501,18.178,0.0
11737,865132,958,12827,958,14743,1916,960,13.389,0.75
11738,245467,500,4000,500,5000,1000,501,8.0,0.0
11739,362546,500,4327,500,5327,1000,501,8.654,0.0
1174,70788,121,484,121,848,364,243,4.0,0.5
11740,339351,0,4500,0,5000,500,501,9.0,0.0
11741,347556,500,4500,500,5500,1000,501,9.0,0.0
11742,231812,500,2500,500,3500,1000,501,5.0,0.0
11743,574738,500,6283,500,7283,1000,501,12.566,0.0
11745,2566100,59,472,59,590,118,60,8.0,0.0
11746,399440,0,5911,0,6411,500,501,11.822,0.0
11747,323039,500,4000,500,5000,1000,501,8.0,0.0
11748,667422,0,12232,0,12732,500,501,24.464,0.0
11749,597981,0,7500,0,8000,500,501,15.0,0.5
1175,2396,4,12,4,24,12,9,3.0,0.0
11750,444993,0,6886,0,7386,500,501,13.772,0.0
11751,885155,0,13408,0,13908,500,501,26.816,0.0
11752,408970,0,6758,0,7258,500,501,13.516,0.0
11754,421821,0,5500,0,6000,500,501,11.0,0.0
11756,530691,500,9893,500,10893,1000,501,19.786,0.0
11759,325226,500,3461,500,4461,1000,501,6.922,0.0
11760,358597,0,5639,0,6139,500,501,11.278,0.0
11765,230106,0,2658,0,3158,500,501,5.316,0.0
11767,83730,0,1346,0,1429,83,84,16.217,0.0
11768,465545,0,4000,0,4500,500,501,8.0,0.0
11769,105799,103,1227,103,1433,206,104,11.913,0.0
11770,2840,0,25,0,30,5,6,5.0,0.0
11771,558473,500,10338,500,11338,1000,501,20.676,0.0
11772,137137,123,2530,123,2776,246,124,20.569,0.0
11773,259055,0,3000,0,3500,500,501,6.0,0.0
11785,10840,0,138,0,144,6,7,23.0,0.0
11787,524025,0,6218,0,6469,251,252,24.773,0.75
11788,974452,500,13139,500,14139,1000,502,26.278,0.6666666666666666
1179,1863,0,15,0,18,3,4,5.0,0.0
11790,996323,500,13500,500,14500,1000,501,27.0,0.0
11791,196009,0,2030,0,2044,14,15,145.0,1.0
11792,1137394,500,16494,500,17494,1000,501,32.988,0.0
11793,7643242,0,62206,0,62544,338,339,184.041,0.0
11794,42045,19,589,19,627,38,20,31.0,1.0
11796,220477,0,2839,0,3006,167,168,17.0,0.0
11797,1487370,500,18248,500,19248,1000,501,36.496,0.0
11798,110418,0,1425,0,1500,75,76,19.0,0.0
1180,441955,500,6913,500,7913,1000,501,13.826,0.0
11800,1568176,500,22672,500,23672,1000,501,45.344,0.0
11801,802006,0,12148,0,12648,500,501,24.296,0.0
11804,1434616,488,19381,488,20357,976,489,39.715,0.0
11807,862688,0,10908,0,11408,500,501,21.816,1.0
11808,251984,210,3570,210,3990,420,211,17.0,0.75
11809,1053608,0,20918,0,21418,500,501,41.836,0.0
11810,369790,0,3828,0,3875,47,48,81.447,1.0
11812,219957,0,3060,0,3213,153,154,20.0,0.0
11813,1117619,500,16434,500,17434,1000,501,32.868,0.0
11814,604915,0,8300,0,8800,500,501,16.6,1.0
11815,602499,0,8500,0,9000,500,501,17.0,0.75
11816,111319,58,1388,58,1504,116,59,23.931,0.0
11817,631675,0,9282,0,9639,357,358,26.0,0.0
11818,546095,0,5500,0,6000,500,501,11.0,0.75
11819,1212339,0,12361,0,12678,317,318,38.994,0.0
11820,194407,65,1755,65,1885,130,66,27.0,1.0
11821,1242442,0,16898,0,17398,500,501,33.796,0.0
11822,1156084,0,18170,0,18670,500,501,36.34,0.5
11825,515894,0,6336,0,6576,240,241,26.4,0.0
11826,49311,0,572,0,594,22,23,26.0,0.0
11829,3560663,500,43200,500,44200,1000,501,86.4,0.0
11830,1151267,446,16502,446,17394,892,447,37.0,0.0
11833,43356,0,560,0,580,20,21,28.0,0.75
11836,3491248,0,37625,0,38125,500,501,75.25,0.0
11837,342769,0,3640,0,3673,33,34,110.303,0.5
11838,634237,157,7547,157,7861,314,158,48.07,0.0
11842,406316,0,8129,0,8629,500,501,16.258,0.0
11844,619214,500,10303,500,11303,1000,501,20.606,0.0
11845,45387,88,619,88,795,176,89,7.034,0.0
11846,398569,500,5971,500,6971,1000,501,11.942,0.0
11847,45387,88,619,88,795,176,89,7.034,0.0
11848,293813,500,4079,500,5079,1000,501,8.158,1.0
11849,789684,500,10052,500,11052,1000,501,20.104,0.5
11850,293813,500,4079,500,5079,1000,501,8.158,1.0
11851,912162,985,8726,985,10696,1970,987,8.859,0.0
11852,1637197,500,22871,500,23871,1000,501,45.742,0.0
11854,1637197,500,22871,500,23871,1000,501,45.742,0.0
11855,398569,500,5971,500,6971,1000,501,11.942,0.0
11856,780733,985,10722,985,12692,1970,987,10.885,0.0
11858,492837,500,7500,500,8500,1000,501,15.0,0.0
11859,98645,174,1392,174,1740,348,175,8.0,0.0
1186,36737,41,278,41,394,116,75,6.78,0.8333333333333334
11860,278028,500,4139,500,5139,1000,501,8.278,0.0
11861,278028,500,4139,500,5139,1000,501,8.278,0.0
11862,402641,500,5500,500,6500,1000,501,11.0,0.0
11863,738777,500,10623,500,11623,1000,501,21.246,0.0
11864,223672,226,3841,226,4293,452,227,16.996,0.0
11865,80992,129,1161,129,1419,258,130,9.0,0.0
11868,673474,500,11233,500,12233,1000,501,22.466,0.0
11871,1876485,0,31774,0,32274,500,501,63.548,0.0
11872,3307485,0,58812,0,59312,500,501,117.624,0.0
11873,1890840,500,31974,500,32974,1000,501,63.948,0.0
11875,3308162,500,58812,500,59812,1000,501,117.624,0.0
11878,3312878,500,59000,500,60000,1000,501,118.0,0.0
11879,14637,28,192,28,248,56,29,6.857,0.0
11880,401286,500,7000,500,8000,1000,501,14.0,0.0
11881,515061,500,8000,500,9000,1000,501,16.0,0.0
11882,423662,500,6052,500,7052,1000,501,12.104,0.0
11883,399402,500,6052,500,7052,1000,501,12.104,0.0
11885,89992,182,1274,182,1638,364,183,7.0,0.0
11886,410701,500,6481,500,7481,1000,501,12.962,0.0
11887,446828,0,4692,0,5692,1000,1001,9.384,0.0
11889,307549,0,4928,0,5428,500,501,9.856,0.0
11890,132702,407,814,407,1628,814,408,2.0,0.0
11893,324072,500,4500,500,5500,1000,501,9.0,0.0
11894,1134134,500,20007,500,21007,1000,501,40.014,1.0
11895,807822,500,14539,500,15539,1000,501,29.078,0.0
11896,441837,500,5000,500,6500,1500,541,10.0,0.0
11899,309907,0,5000,0,5500,500,501,10.0,0.0
11908,443245,500,4955,500,5955,1000,501,9.91,0.0
11911,586770,500,12499,500,13499,1000,501,24.998,0.0
11912,515946,500,7112,500,8112,1000,501,14.224,0.0
11913,928054,0,13500,0,14000,500,501,27.0,0.0
11914,308742,500,4500,500,5500,1000,501,9.0,0.0
11915,36744,68,408,68,544,136,69,6.0,0.0
11917,273359,500,3000,500,4000,1000,501,6.0,0.0
11918,280442,500,4000,500,5000,1000,501,8.0,0.0
11919,896042,500,18349,500,19349,1000,501,36.698,0.0
11920,12681,30,120,30,180,60,31,4.0,0.0
11921,481392,500,7500,500,8500,1000,501,15.0,0.0
11922,5838,13,65,13,91,26,14,5.0,0.0
11923,383780,500,6500,500,7500,1000,501,13.0,1.0
11924,825272,500,12909,500,13909,1000,501,25.818,0.75
11925,357090,500,6500,500,7500,1000,501,13.0,0.0
11926,401276,500,7000,500,8000,1000,501,14.0,0.0
11927,70612,84,822,84,990,168,85,9.786,0.0
11928,447112,500,7000,500,8000,1000,501,14.0,0.0
11929,598174,500,9000,500,10000,1000,501,18.0,0.0
11930,483595,500,6979,500,7979,1000,501,13.958,0.0
11931,308765,381,3494,381,4630,1136,726,9.171,0.0
11932,295357,500,4500,500,5500,1000,501,9.0,0.5
11934,427057,0,6224,0,6724,500,501,12.448,0.0
11935,463255,500,7000,500,8000,1000,501,14.0,0.0
11936,791674,500,14539,500,15539,1000,501,29.078,0.0
11939,255941,500,3496,500,4496,1000,501,6.992,0.0
11940,461045,0,5500,0,6500,1000,578,11.0,0.5
11941,287408,500,3928,500,4928,1000,501,7.856,0.0
11942,294028,500,3997,500,4997,1000,501,7.994,0.0
11943,208128,500,2500,500,3500,1000,501,5.0,1.0
11944,207780,500,2500,500,3500,1000,501,5.0,1.0
11947,297872,0,4413,0,4913,500,501,8.826,0.0
11950,1210981,500,16519,500,17519,1000,501,33.038,0.0
11951,252901,0,3000,0,3500,500,501,6.0,0.0
11953,234963,0,3500,0,4000,500,501,7.0,0.0
11955,308494,0,6000,0,6500,500,501,12.0,0.0
11956,220410,110,2340,110,2560,220,111,21.273,0.0
11957,98645,174,1392,174,1740,348,175,8.0,0.0
11958,654401,500,9500,500,10500,1000,501,19.0,0.0
11959,270380,500,3500,500,4500,1000,501,7.0,0.0
1196,4544,5,33,5,43,10,6,6.6,0.5
11960,191991,382,2199,382,2963,764,383,5.757,0.5
11962,172509,0,2590,0,2707,117,118,22.137,1.0
11963,193027,500,2000,500,3000,1000,501,4.0,0.0
11964,240766,500,3500,500,4500,1000,501,7.0,0.0
11966,402688,500,5514,500,6514,1000,501,11.028,0.0
11967,362125,500,4000,500,5000,1000,501,8.0,0.0
11968,656821,500,7000,500,8000,1000,501,14.0,0.0
11971,6786641,500,130619,500,131619,1000,501,261.238,0.0
11972,63601,71,994,71,1136,142,72,14.0,0.0
11973,75470,122,1098,122,1342,244,123,9.0,0.0
11974,55514,95,760,95,950,190,96,8.0,0.0
11975,241964,500,2988,500,3988,1000,501,5.976,0.0
11976,214396,500,3000,500,4000,1000,501,6.0,0.0
11978,181463,500,2000,500,3000,1000,501,4.0,0.0
11979,213797,500,3000,500,4000,1000,501,6.0,0.0
11980,256443,500,3499,500,4499,1000,501,6.998,0.0
11981,138222,154,1540,154,1848,308,155,10.0,1.0
11984,177738,500,2000,500,3000,1000,501,4.0,0.0
11985,271573,500,4500,500,5500,1000,501,9.0,0.0
11986,281471,500,4500,500,5500,1000,501,9.0,0.0
11988,529027,0,9041,0,9541,500,501,18.082,0.75
11989,1052211,500,13505,500,14505,1000,501,27.01,0.0
11991,384580,500,5987,500,6987,1000,501,11.974,1.0
11992,818837,500,11161,500,12161,1000,501,22.322,0.0
11994,287362,500,5428,500,6428,1000,501,10.856,1.0
11995,489625,500,7413,500,8413,1000,501,14.826,0.0
11996,631839,500,14000,500,15000,1000,501,28.0,0.0
11997,63339,95,950,95,1140,190,96,10.0,0.0
11998,182299,500,1998,500,2998,1000,501,3.996,0.0
11999,373946,500,6500,500,7500,1000,501,13.0,0.0
12000,3265590,500,80000,500,81000,1000,501,160.0,0.0
12001,270012,500,3500,500,4500,1000,501,7.0,0.0
12002,624272,500,14000,500,15000,1000,501,28.0,0.0
12003,275789,500,4500,500,5500,1000,501,9.0,0.5
12004,210664,500,3000,500,4000,1000,501,6.0,0.0
12005,181913,500,2000,500,3000,1000,501,4.0,0.0
12006,383367,500,6500,500,7500,1000,501,13.0,0.0
12007,182733,500,2000,500,3000,1000,501,4.0,0.0
12008,282864,500,3494,500,4494,1000,501,6.988,0.0
12009,182806,500,2000,500,3000,1000,501,4.0,0.0
12010,182488,500,2000,500,3000,1000,501,4.0,0.0
12011,245060,500,2500,500,3500,1000,501,5.0,0.0
12012,1099919,0,17573,0,18073,500,501,35.146,0.0
12013,192288,500,2000,500,3000,1000,501,4.0,0.0
12018,232454,0,3000,0,3500,500,501,6.0,0.0
1202,311944,0,4000,0,4500,500,501,8.0,0.0
12020,426072,500,6543,500,7543,1000,501,13.086,0.0
12021,603263,500,9948,500,10948,1000,501,19.896,0.0
12022,369043,500,6500,500,7500,1000,501,13.0,0.0
12023,71317,117,1053,117,1287,234,118,9.0,0.0
12024,223175,500,2998,500,3998,1000,501,5.996,0.0
12025,47755,84,672,84,840,168,85,8.0,0.0
1203,168687,500,1629,500,2629,1000,501,3.258,0.0
12031,265446,500,3000,500,4000,1000,501,6.0,0.0
12033,23649,0,294,0,330,36,37,11.76,1.0
12034,625998,500,14000,500,15000,1000,501,28.0,0.0
12035,35275,25,500,25,550,50,26,20.0,0.0
12038,374086,500,5434,500,6434,1000,501,10.868,0.0
12039,30667,41,328,41,410,82,42,8.0,0.0
12040,194583,500,2000,500,3000,1000,501,4.0,0.0
12041,197075,500,1500,500,2500,1000,501,3.0,0.0
12042,181575,0,1500,0,2000,500,501,3.0,0.0
12043,284045,500,3855,500,4855,1000,501,7.71,0.0
12044,279922,500,4000,500,5000,1000,501,8.0,0.0
12045,334351,500,5063,500,6063,1000,501,10.126,0.0
12047,212514,500,2500,500,3500,1000,501,5.0,0.0
12049,201865,500,2000,500,3000,1000,501,4.0,0.0
12052,206403,500,2496,500,3496,1000,501,4.992,0.0
12055,158474,199,1785,199,2183,398,200,8.97,0.0
12056,365532,500,5991,500,6991,1000,501,11.982,0.0
12057,695424,500,13421,500,14421,1000,501,26.842,0.0
12058,216539,142,2390,142,2674,284,143,16.831,0.0
12059,325253,500,5000,500,6000,1000,501,10.0,0.0
1206,309841,489,2445,489,3423,978,490,5.0,0.0
12060,189604,500,2500,500,3500,1000,501,5.0,0.0
12062,626688,582,11671,582,12835,1164,584,20.053,0.0
12063,363766,500,6000,500,7000,1000,501,12.0,0.5
12065,201627,123,2952,123,3198,246,124,24.0,0.0
12066,83371,125,1125,125,1375,250,126,9.0,0.0
12067,290715,500,4000,500,5000,1000,501,8.0,0.0
12075,63462,170,680,170,1020,340,171,4.0,0.75
12076,328562,500,3571,500,4571,1000,501,7.142,0.0
12077,16027,43,172,43,258,86,44,4.0,0.0
12078,936000,500,12351,500,14759,2408,1909,24.702,0.5
12080,1060213,500,17498,500,18498,1000,501,34.996,0.0
12081,658006,500,10765,500,11765,1000,502,21.53,0.5
12082,755524,500,12046,500,13546,1500,773,24.092,0.5
12083,1043072,500,14425,500,15925,1500,779,28.85,0.0
12084,310750,0,5388,0,5888,500,501,10.776,0.0
12085,404474,500,5028,500,6028,1000,501,10.056,0.0
12086,828818,500,13998,500,14998,1000,501,27.996,0.0
12087,793429,500,13486,500,14486,1000,501,26.972,0.0
12088,605460,500,10496,500,11496,1000,501,20.992,0.0
12089,403463,500,5000,500,6000,1000,501,10.0,0.0
1209,179760,265,2650,265,3180,530,266,10.0,0.0
12090,798851,500,12546,500,14046,1500,614,25.092,1.0
12092,605481,500,9838,500,11749,1911,1413,19.676,0.5
12093,675220,500,10164,500,11164,1000,501,20.328,0.0
12094,205118,0,2000,0,2500,500,501,4.0,0.0
12095,69460,60,808,60,1044,236,176,13.467,0.0
12096,816348,500,14500,500,15500,1000,501,29.0,0.0
12098,597801,500,10462,500,11462,1000,501,20.924,0.0
12099,127550,271,1625,271,2167,542,272,5.996,0.0
12100,233649,500,3000,500,4000,1000,501,6.0,0.0
12102,370914,500,5000,500,6000,1000,501,10.0,0.0
12103,326797,500,5000,500,6000,1000,501,10.0,0.0
12104,529140,500,8912,500,9912,1000,501,17.824,0.5
12105,133192,239,1505,239,1983,478,240,6.297,0.75
12106,379630,500,6000,500,7000,1000,501,12.0,0.0
12107,273985,392,3923,392,4707,784,393,10.008,0.0
12110,270959,500,3920,500,4920,1000,501,7.84,0.0
12111,256353,0,2500,0,3000,500,501,5.0,0.0
12112,200190,500,2000,500,3000,1000,501,4.0,0.0
12117,439957,500,5098,500,6098,1000,501,10.196,0.5
12118,198120,290,2900,290,3480,580,291,10.0,0.0
12120,789478,0,11891,0,12391,500,501,23.782,0.0
12121,185779,500,1986,500,2986,1000,501,3.972,0.0
12126,381736,0,6021,0,6521,500,501,12.042,0.0
12127,362489,500,4382,500,5382,1000,501,8.764,0.0
12128,300588,500,4000,500,5000,1000,501,8.0,1.0
12129,216322,99,2175,99,2373,198,100,21.97,0.75
12130,228784,500,2653,500,3653,1000,501,5.306,0.0
12131,817035,500,14500,500,15500,1000,501,29.0,0.0
12132,537387,500,7394,500,8894,1500,1002,14.788,0.0
12133,909003,500,14257,500,15757,1500,1001,28.514,0.0
12134,180280,0,2000,0,2500,500,501,4.0,0.0
12135,790202,500,13486,500,14486,1000,501,26.972,0.0
12136,4501,13,39,13,65,26,14,3.0,0.0
12137,416460,500,5500,500,6500,1000,501,11.0,0.0
12138,403205,500,5500,500,6500,1000,501,11.0,0.0
12139,386473,500,5000,500,6000,1000,501,10.0,0.0
12140,72080,123,1476,123,1722,246,124,12.0,0.0
12144,52612,127,762,127,1016,254,128,6.0,0.0
12146,349613,500,5997,500,6997,1000,501,11.994,0.0
12147,194724,500,2000,500,3000,1000,501,4.0,0.0
12148,202693,500,2500,500,3500,1000,501,5.0,0.5
1215,69978,71,852,71,994,142,72,12.0,0.0
12150,405995,500,5492,500,6492,1000,501,10.984,0.0
12151,516299,500,8500,500,9500,1000,501,17.0,0.0
12153,15513,40,160,40,240,80,41,4.0,0.0
12156,32682,54,424,54,532,108,55,7.852,0.0
12157,250901,500,4000,500,5000,1000,501,8.0,0.0
1216,68851,70,803,70,943,140,71,11.471,0.0
12160,79468,155,926,155,1236,310,156,5.974,0.5
12163,46164,78,624,78,780,156,79,8.0,0.0
12164,447290,500,6428,500,7428,1000,501,12.856,0.0
12165,498549,500,5929,500,7429,1500,671,11.858,0.5
12166,711229,911,9466,911,11288,1822,913,10.391,0.0
12167,1394565,925,11976,925,13826,1850,927,12.947,0.0
12168,618433,500,9945,500,10945,1000,501,19.89,0.0
12169,457358,500,6738,500,7738,1000,501,13.476,0.0
1217,67650,69,788,69,926,138,70,11.42,0.0
12170,1617771,1025,10984,1025,13034,2050,1027,10.716,0.0
12171,465150,500,6101,500,7101,1000,501,12.202,0.0
12172,489940,500,6227,500,7227,1000,501,12.454,0.0
12175,214764,500,3000,500,4000,1000,501,6.0,0.5
12176,344542,0,5500,0,6000,500,501,11.0,0.0
12177,54046,150,600,150,900,300,151,4.0,0.0
12179,362879,500,6000,500,7000,1000,501,12.0,0.0
1218,59443,57,683,57,797,114,58,11.982,0.0
12181,250951,476,1904,476,3332,1428,953,4.0,0.0
12183,692534,500,12549,500,13549,1000,501,25.098,0.75
12184,25908,66,264,66,396,132,67,4.0,0.0
12185,460925,500,4604,500,5604,1000,501,9.208,0.0
12186,161400,169,2025,169,2363,338,170,11.982,0.0
12187,5206963,500,34010,500,35010,1000,501,68.02,0.0
12188,634141,500,10120,500,11120,1000,501,20.24,0.75
12190,87352,37,771,37,845,74,38,20.838,0.0
12191,896042,500,18349,500,19349,1000,501,36.698,0.0
12192,818461,500,14500,500,15500,1000,501,29.0,0.0
12193,1062507,500,17495,500,18495,1000,501,34.99,0.0
12195,645016,0,8480,0,8980,500,501,16.96,0.625
12196,319487,0,4442,0,4942,500,501,8.884,0.0
12197,576558,0,9896,0,10396,500,501,19.792,0.0
12198,270811,0,2493,0,2993,500,501,4.986,0.0
12199,780353,500,13488,500,14488,1000,501,26.976,0.0
12200,892426,500,15000,500,16000,1000,501,30.0,0.0
12201,1226591,500,22882,500,23882,1000,501,45.764,0.0
12202,40047,85,216,85,471,255,170,2.541,0.0
12203,340594,440,4174,440,5377,1203,765,9.486,0.0
12204,517517,288,2294,288,2870,576,289,7.965,0.0
12205,358441,0,2500,0,3500,1000,990,5.0,0.0
12206,73433,63,1069,63,1195,126,64,16.968,0.5
12207,896508,500,10173,500,11840,1667,821,20.346,0.0
12208,1706449,500,8628,500,9628,1000,501,17.256,0.0
12209,844447,985,10726,985,12696,1970,987,10.889,0.0
1221,6269,0,48,0,60,12,13,4.0,0.0
12210,753452,970,8664,970,10604,1940,972,8.932,0.0
12211,437979,500,6563,500,7563,1000,501,13.126,0.0
12212,441081,500,6276,500,7276,1000,501,12.552,0.0
12213,299064,500,4500,500,5500,1000,501,9.0,0.0
12214,394003,500,5944,500,6944,1000,501,11.888,0.0
12215,453662,500,6399,500,7399,1000,501,12.798,0.0
12216,17701,29,261,29,319,58,30,9.0,0.0
12217,768751,398,15968,398,17264,1296,900,17.782,0.0
12218,641984,500,6624,500,7624,1000,501,13.248,0.0
12219,781144,500,12987,500,13987,1000,501,25.974,0.0
1222,8532,8,53,8,71,18,11,6.625,0.0
12220,531726,0,7643,0,8143,500,501,15.286,0.0
12223,274512,292,4816,292,5400,584,293,16.493,0.0
12226,812220,500,13308,500,14808,1500,657,26.616,0.0
12227,716661,500,10788,500,12288,1500,599,21.576,0.0
12228,882661,500,9234,500,10734,1500,1002,18.468,1.0
12229,620293,500,7111,500,8611,1500,1002,14.222,0.0
12230,385249,152,5333,152,5637,304,153,35.086,0.0
12231,1182637,500,20585,500,21585,1000,501,41.17,0.0
12232,805032,500,15000,500,16000,1000,501,30.0,0.0
12233,402889,500,5000,500,6000,1000,501,10.0,0.0
12234,445711,500,6000,500,7000,1000,501,12.0,0.0
12235,788369,500,13480,500,14480,1000,501,26.96,0.0
12236,7760,20,80,20,120,40,21,4.0,0.5
12237,748980,500,10840,500,12340,1500,610,21.68,0.5
12238,573472,500,8300,500,9800,1500,721,16.6,0.0
12239,1212247,500,19800,500,20800,1000,501,39.6,0.0
1224,465309,500,7500,500,8500,1000,501,15.0,0.0
12240,1053052,500,17498,500,18498,1000,501,34.996,0.0
12241,1053058,500,17498,500,18498,1000,501,34.996,0.0
12242,911105,500,16000,500,17000,1000,501,32.0,0.0
12243,908166,500,16000,500,17000,1000,501,32.0,0.0
12244,907271,500,16000,500,17000,1000,501,32.0,0.0
12245,198261,500,2000,500,3000,1000,501,4.0,0.0
12247,299197,500,4494,500,5494,1000,501,8.988,0.0
12248,413238,500,5500,500,6500,1000,501,11.0,0.0
12250,647113,0,10112,0,10612,500,501,20.224,0.0
12251,657931,500,12482,500,13482,1000,501,24.964,0.0
12252,564178,500,9722,500,10722,1000,501,19.444,0.0
12253,496747,0,8856,0,9356,500,501,17.712,0.0
12254,275174,500,2999,500,3999,1000,501,5.998,0.0
12255,753944,500,14346,500,15346,1000,502,28.692,0.0
12256,749079,500,14423,500,15423,1000,502,28.846,0.0
12257,670652,0,6240,0,7240,1000,625,12.48,0.0
12258,795828,500,14452,500,15452,1000,501,28.904,0.0
12259,227049,500,2500,500,3500,1000,501,5.0,0.75
12260,804985,500,14000,500,15000,1000,501,28.0,0.0
12261,889468,500,15000,500,16000,1000,501,30.0,0.0
12262,636395,500,12617,500,13617,1000,501,25.234,0.75
12263,105835,148,1480,148,1776,296,149,10.0,0.0
12264,371415,0,5901,0,6401,500,501,11.802,0.0
12265,365218,500,4392,500,5392,1000,501,8.784,0.0
12266,270742,500,3999,500,4999,1000,501,7.998,0.0
12267,1348850,500,17578,500,18578,1000,501,35.156,0.6666666666666666
12268,316683,0,4500,0,5000,500,501,9.0,0.0
12269,1137220,479,8830,479,9788,958,480,18.434,0.8333333333333334
12270,816565,500,14000,500,15000,1000,501,28.0,0.0
12271,1187911,500,22232,500,23232,1000,501,44.464,0.0
12272,250590,500,3625,500,4625,1000,501,7.25,0.0
12273,901744,0,18289,0,18789,500,501,36.578,0.75
12274,261144,325,4875,325,5525,650,326,15.0,0.0
12277,420910,500,7000,500,8000,1000,501,14.0,0.0
12278,407595,500,5500,500,6500,1000,501,11.0,0.0
12285,701056,500,10735,500,12235,1500,671,21.47,0.5
12286,505339,500,7002,500,8002,1000,501,14.004,0.0
12287,636972,500,8930,500,9930,1000,501,17.86,0.0
12288,406651,0,6030,0,6530,500,501,12.06,1.0
12289,952229,500,13652,500,14652,1000,501,27.304,0.0
12290,36019,74,370,74,518,148,75,5.0,0.0
12291,873736,500,15000,500,16000,1000,501,30.0,0.0
12292,229423,500,3000,500,4000,1000,501,6.0,0.0
12293,634236,500,11228,500,12228,1000,501,22.456,0.0
12294,232976,144,1793,144,2081,288,145,12.451,0.0
12295,398119,500,5751,500,6751,1000,501,11.502,0.0
12296,1032,1,5,1,7,2,2,5.0,0.0
12297,33839,0,71,0,83,12,13,5.917,0.0
12298,821895,500,14000,500,15000,1000,501,28.0,0.0
12299,347665,500,5500,500,6500,1000,501,11.0,0.5
1230,29959,0,408,0,476,68,69,6.0,0.0
12300,207120,0,935,0,985,50,51,18.7,0.0
12301,128583,181,1448,181,1810,362,183,8.0,0.0
12302,830613,500,14339,500,15339,1000,501,28.678,0.5
12303,1153295,500,18430,500,19930,1500,940,36.86,1.0
12308,585417,500,10214,500,11214,1000,501,20.428,0.0
12309,430885,500,7525,500,8525,1000,501,15.05,0.0
12310,834101,500,7909,500,10409,2500,953,15.818,0.0
12312,825616,500,14000,500,15000,1000,501,28.0,0.0
12313,178123,500,2000,500,3000,1000,501,4.0,0.0
12314,624028,500,10963,500,11963,1000,501,21.926,0.0
12315,613588,500,10759,500,11759,1000,501,21.518,0.0
12316,424357,500,5500,500,6500,1000,501,11.0,0.0
12317,522241,500,6027,500,7527,1500,509,12.054,0.0
12318,388544,500,5000,500,6000,1000,501,10.0,0.0
12319,427823,0,4068,0,6102,2034,983,8.136,0.0
12320,575767,0,6977,0,7477,500,501,13.954,0.0
12321,290515,0,2495,0,2995,500,501,4.99,0.0
12322,801485,500,14000,500,15000,1000,501,28.0,0.0
12323,809678,500,14000,500,15000,1000,501,28.0,0.0
12324,886468,500,14990,500,15990,1000,501,29.98,0.0
12325,397282,500,5500,500,6500,1000,501,11.0,0.0
12326,16259,14,280,14,308,28,15,20.0,0.0
12327,402044,500,5500,500,6500,1000,501,11.0,0.0
12328,489940,500,6227,500,7227,1000,501,12.454,0.0
1233,296529,0,5950,0,6300,350,351,17.0,0.0
12330,470049,500,7353,500,8353,1000,501,14.706,0.0
12331,556061,500,8854,500,9854,1000,501,17.708,0.0
12332,213276,500,2000,500,3000,1000,501,4.0,0.0
12333,481032,500,7284,500,8284,1000,501,14.568,0.0
12335,17701,29,261,29,319,58,30,9.0,0.0
12337,437979,500,6563,500,7563,1000,501,13.126,0.0
12338,830613,500,14339,500,15339,1000,501,28.678,0.5
12339,541846,500,7678,500,8678,1000,501,15.356,0.0
1234,294720,0,5950,0,6300,350,351,17.0,0.0
12340,418621,0,6194,0,6694,500,501,12.388,0.0
12341,456325,500,7357,500,8357,1000,501,14.714,0.0
12342,457358,500,6738,500,7738,1000,501,13.476,0.0
12343,465150,500,6101,500,7101,1000,501,12.202,0.0
12344,348394,500,5000,500,6000,1000,501,10.0,0.0
12345,751499,500,10500,500,11500,1000,501,21.0,0.0
12346,453662,500,6399,500,7399,1000,501,12.798,0.0
12347,299064,500,4500,500,5500,1000,501,9.0,0.0
12349,451857,500,7357,500,8357,1000,501,14.714,0.0
1235,597964,500,9277,500,10277,1000,501,18.554,0.0
12350,469767,500,7708,500,8708,1000,501,15.416,0.6666666666666666
12351,441081,500,6276,500,7276,1000,501,12.552,0.0
12352,201982,500,2500,500,3500,1000,501,5.0,0.0
12353,618433,500,9945,500,10945,1000,501,19.89,0.0
12354,334351,500,5063,500,6063,1000,501,10.126,0.0
12356,208588,500,2999,500,3999,1000,501,5.998,0.0
12357,197114,500,1996,500,2996,1000,501,3.992,0.0
12359,24881,23,414,23,460,46,24,18.0,0.0
1236,447238,500,6000,500,7000,1000,501,12.0,0.0
12360,58000,123,738,123,984,246,124,6.0,0.0
12361,842838,500,16615,500,17615,1000,501,33.23,0.0
12362,269360,500,3500,500,4500,1000,501,7.0,0.0
12364,581911,500,7000,500,8000,1000,501,14.0,0.0
12365,173350,500,1500,500,2500,1000,501,3.0,0.0
12367,210238,500,3000,500,4000,1000,501,6.0,0.0
12369,451736,500,3997,500,4997,1000,501,7.994,0.0
1237,1946958,500,33544,500,34544,1000,501,67.088,0.0
12370,760482,0,8527,0,9027,500,501,17.054,0.0
12372,451781,500,6274,500,7274,1000,501,12.548,0.0
12373,258158,500,4000,500,5000,1000,501,8.0,0.0
12374,293293,500,4499,500,5499,1000,501,8.998,0.0
12375,71422,111,969,111,1191,222,112,8.73,0.0
12376,79054,161,966,161,1288,322,163,6.0,0.0
1238,447537,500,6000,500,7000,1000,501,12.0,0.0
1239,507241,500,6712,500,7712,1000,501,13.424,0.0
12394,839922,500,12500,500,13500,1000,501,25.0,0.0
12395,520798,500,8186,500,9186,1000,501,16.372,0.0
12396,242918,500,2500,500,3500,1000,501,5.0,0.0
12397,243064,500,2500,500,3500,1000,501,5.0,0.0
12398,660473,442,2831,442,4157,1326,883,6.405,0.0
12399,728677,500,8500,500,9500,1000,502,17.0,0.0
1240,431381,500,6000,500,7000,1000,501,12.0,0.0
12400,607525,500,14000,500,15000,1000,501,28.0,0.0
12401,592883,500,14000,500,15000,1000,501,28.0,0.0
12402,404508,0,7000,0,7500,500,501,14.0,0.0
12403,426554,500,6774,500,7774,1000,501,13.548,0.0
12405,260784,500,4000,500,5000,1000,501,8.0,0.0
12406,378881,500,4500,500,5500,1000,501,9.0,1.0
12408,192007,500,2000,500,3000,1000,501,4.0,0.0
12409,212959,500,2500,500,3500,1000,501,5.0,0.0
1241,523051,500,8000,500,9000,1000,501,16.0,0.0
12412,242918,500,2500,500,3500,1000,501,5.0,0.0
12415,1142931,927,11988,927,13842,1854,929,12.932,0.0
12416,520798,500,8186,500,9186,1000,501,16.372,0.0
12417,713599,970,8658,970,10598,1940,972,8.926,0.0
12418,71093950,52,416,52,520,104,54,8.0,0.0
12419,1891,4,12,4,20,8,6,3.0,0.0
1242,9202,7,133,7,147,14,8,19.0,0.0
12420,2578,5,20,5,30,10,7,4.0,0.0
12429,243064,500,2500,500,3500,1000,501,5.0,0.0
1243,1257398,500,21502,500,22502,1000,501,43.004,0.0
1244,750158,500,12655,500,13655,1000,501,25.31,0.0
1245,93704,96,1684,96,1876,192,97,17.542,0.0
12450,1089896,970,10666,970,12606,1940,972,10.996,0.0
12453,839922,500,12500,500,13500,1000,501,25.0,0.0
1246,10941,16,128,16,160,32,17,8.0,0.0
1247,506483,500,8790,500,9790,1000,501,17.58,0.0
1248,152417,168,2480,168,2816,336,169,14.762,0.0
1249,9195,7,133,7,147,14,8,19.0,0.0
12491,389240,500,6822,500,7822,1000,501,13.644,0.0
12492,892673,985,8710,985,10680,1970,987,8.843,0.0
12493,1139616,926,12000,926,13852,1852,928,12.959,0.0
12494,657022,985,8724,985,10694,1970,987,8.857,1.0
12495,1074788,927,11589,927,13443,1854,929,12.502,1.0
12497,519955,500,7686,500,8686,1000,501,15.372,0.0
1250,564434,500,7500,500,8500,1000,501,15.0,0.0
12502,215586,0,3090,0,3399,309,310,10.0,1.0
12503,365641,0,5496,0,5996,500,501,10.992,0.5
12504,20447,0,270,0,300,30,31,9.0,0.0
12505,11387,0,128,0,144,16,17,8.0,0.0
12506,516232,0,8123,0,8623,500,501,16.246,0.0
12507,247947,500,3498,500,4498,1000,501,6.996,0.5
12508,104406,211,1477,211,1899,422,212,7.0,0.0
12509,660473,442,2831,442,4157,1326,883,6.405,0.0
1251,731540,280,12165,280,12725,560,281,43.446,0.0
12510,522378,500,9500,500,10500,1000,501,19.0,0.0
12511,389240,500,6822,500,7822,1000,501,13.644,0.0
12513,3349081,4590,21159,4590,46050,24891,9079,8.594000000000001,0.75
12518,277934,227,1082,227,2232,1150,475,8.942,0.5
1252,395975,500,5520,500,6520,1000,501,11.04,0.0
12524,3278,5,14,5,37,23,23,3.5,0.0
12527,1252,3,7,3,19,12,11,3.5,0.0
1253,1948627,500,33572,500,34572,1000,501,67.144,0.0
12530,29340,157,468,157,793,325,172,3.0,0.0
1254,1583370,500,27177,500,28177,1000,501,54.354,0.0
12545,6919,12,48,12,104,56,48,3.429,0.0
1255,85811,127,1014,127,1268,254,128,7.984,0.0
12557,2677,5,14,5,40,26,23,3.5,0.0
1256,1616205,500,24989,500,25989,1000,501,49.978,0.0
1257,705451,500,11500,500,12500,1000,501,23.0,0.0
12570,24487,9,54,9,85,31,26,6.75,1.0
12573,986,2,6,2,14,8,8,6.0,1.0
12576,1332,4,8,4,21,13,10,2.667,0.0
1258,520598,500,8000,500,9000,1000,501,16.0,0.0
12588,1616,2,9,2,17,8,9,4.5,0.0
1259,704988,500,11500,500,12500,1000,501,23.0,0.0
12595,2066,6,11,6,35,24,20,2.2,0.0
12598,7009,13,11,13,75,64,62,1.0,1.0
1260,87709,96,1572,96,1764,192,97,16.375,0.0
12607,896,2,8,2,15,7,7,4.0,0.0
1261,1340708,500,22796,500,23796,1000,501,45.592,0.0
12611,4917,16,42,16,91,49,34,2.625,0.0
12613,7804,12,49,12,108,59,51,1.531,0.0
12619,3042,5,12,5,31,19,19,2.4,0.0
1262,1270279,500,18206,500,19206,1000,501,36.412,0.0
12620,3273,9,15,9,47,32,25,1.875,1.0
12629,3455,2,24,2,54,30,31,1.333,0.0
1263,28480,7,468,7,482,14,8,66.857,0.0
12636,8590,4,23,4,81,58,31,7.667,0.5
12639,10597,12,68,12,91,23,15,6.182,1.0
1264,408434,500,6430,500,7430,1000,501,12.86,0.0
12645,3671,4,8,4,50,42,42,2.667,0.0
1265,850749,500,13158,500,14158,1000,501,26.316,0.0
12655,13358,34,113,34,201,88,58,3.054,1.0
1266,1203532,500,20416,500,21416,1000,501,40.832,0.0
1267,417534,500,6674,500,7674,1000,501,13.348,0.0
12670,14834,35,74,35,208,134,95,2.114,0.0
12676,8997,17,49,17,134,85,69,2.579,0.0
1268,524439,500,8014,500,9014,1000,501,16.028,0.0
12683,3796,5,13,5,40,27,27,2.6,0.0
12684,978,2,7,2,14,7,7,3.5,0.0
1269,395510,500,5538,500,6538,1000,501,11.076,0.0
12692,8769,33,34,33,133,99,69,1.062,0.0
12693,1389,3,10,3,15,5,6,5.0,1.0
12695,3031,3,7,3,45,38,38,3.5,0.0
12699,3731,7,36,7,50,14,11,6.0,0.0
1270,541442,500,7212,500,8212,1000,501,14.424,0.0
1271,461156,500,6075,500,7075,1000,501,12.15,0.0
12714,4645,11,29,11,73,44,36,2.9,0.0
1272,282526,500,3500,500,4500,1000,501,7.0,0.0
12726,794,1,7,1,12,5,7,7.0,0.0
12729,2101,3,12,3,32,20,21,4.0,0.0
1273,143048,296,1805,296,2397,592,297,6.098,0.0
12739,6801,12,33,12,85,52,46,2.538,0.0
1274,1387145,500,23821,500,24821,1000,501,47.642,0.0
12743,61359,17,111,17,145,34,21,6.938,0.8333333333333334
1275,145282,297,1878,297,2472,594,298,6.323,0.0
12750,3505,12,22,12,61,39,30,1.833,0.0
12751,2317,8,21,8,41,20,14,2.333,0.0
12753,1240,2,6,2,12,6,7,3.0,0.0
12755,4394,6,34,6,68,34,30,1.789,0.0
12759,1795,4,6,4,14,8,6,2.0,0.0
1276,847741,500,13177,500,14177,1000,501,26.354,0.0
12769,2381,3,22,3,41,19,17,2.0,0.0
1277,214326,256,3072,256,3584,512,257,12.0,0.0
12775,2438,7,15,7,41,26,22,2.143,0.0
1278,19858,21,272,21,314,42,22,12.952,0.0
12781,2990,5,7,5,22,15,12,1.75,0.0
12783,4677,10,45,10,93,48,39,4.5,0.0
12787,2717,5,7,5,20,13,10,1.75,0.0
1279,1200270,500,17010,500,18010,1000,501,34.02,0.0
1280,31297,7,518,7,532,14,8,74.0,0.0
12807,4884,19,29,19,101,72,46,1.526,0.0
12809,47463,17,96,17,130,34,21,6.0,1.0
1281,55265,7,840,7,854,14,8,120.0,0.0
12813,13837,75,151,75,306,155,82,2.041,0.0
12818,7489,20,43,20,102,59,41,2.15,0.0
1282,1663740,500,28619,500,29619,1000,501,57.238,0.0
12822,1063,2,6,2,16,10,10,6.0,0.0
12827,2999,2,14,2,19,5,7,14.0,0.0
1283,19692,21,269,21,311,42,22,12.81,0.0
12835,2391,6,11,6,29,18,18,2.2,1.0
12838,1656,4,10,4,26,16,13,3.333,0.0
1284,512904,500,8106,500,9106,1000,501,16.212,0.0
12843,2089,7,16,7,38,22,17,2.667,0.0
1285,705412,500,11500,500,12500,1000,501,23.0,0.0
12854,4530,10,20,10,62,42,35,2.222,0.0
1286,1065453,500,17883,500,18883,1000,501,35.766,0.0
12862,2282,2,6,2,29,23,24,3.0,0.0
12866,2001,1,15,1,25,10,11,2.5,0.0
1287,936427,500,15778,500,16778,1000,501,31.556,0.0
12870,14389,22,50,22,234,184,159,2.083,0.0
12873,3823,2,14,2,49,35,35,1.75,0.0
12879,45631,0,712,0,712,0,178,4.0,0.0
1288,1038090,500,17651,500,18651,1000,501,35.302,0.0
12885,3315,3,13,3,50,37,36,6.5,0.0
1289,959645,500,16199,500,17199,1000,501,32.398,0.0
12896,3047,5,18,5,43,25,25,4.5,0.0
1290,32034,7,534,7,548,14,8,76.286,0.0
12904,4421,11,27,11,68,41,33,1.929,1.0
1291,440950,500,7560,500,8560,1000,501,15.12,0.0
12917,2398,9,19,9,44,25,17,2.375,0.0
12919,16091,13,60,13,166,106,38,8.571,0.0
1292,483937,500,7124,500,8124,1000,501,14.248,0.0
12923,6054,21,27,21,97,70,59,1.929,0.0
12928,1717,2,9,2,17,8,9,4.5,0.0
1293,1770618,500,24591,500,25591,1000,501,49.182,0.0
12930,15650,14,33,14,215,182,175,2.062,1.0
12936,2513,4,7,4,25,18,18,3.5,0.0
1294,450840,500,7830,500,8830,1000,501,15.66,0.0
1295,87787,131,1042,131,1304,262,132,7.954,0.0
12954,6885,16,49,16,104,55,45,2.882,0.0
12956,2992,3,11,3,41,30,28,2.2,0.0
12957,1185,2,3,2,14,11,11,1.0,0.0
1296,423791,500,7055,500,8055,1000,501,14.11,0.0
12962,1815,5,12,5,31,19,16,3.0,0.0
12963,1500,3,4,3,10,6,6,1.333,0.0
12964,3016,4,16,4,40,24,22,4.0,0.0
12966,12651,40,91,40,219,128,94,1.282,0.0
1297,1695380,500,29221,500,30221,1000,501,58.442,0.0
12970,11496,17,96,17,131,35,22,6.0,0.0
12972,1633,5,11,5,27,16,13,2.75,0.0
12977,2173,4,13,4,32,19,17,4.333,0.0
1298,10280,7,147,7,161,14,8,21.0,0.0
12984,1240,2,6,2,12,6,7,3.0,0.0
1299,214075,256,3072,256,3584,512,257,12.0,0.0
1300,1144463,500,19365,500,20365,1000,501,38.73,0.0
1301,897459,500,15094,500,16094,1000,501,30.188,0.0
13013,26998,55,65,55,252,187,85,4.333,0.6666666666666666
13016,5439,11,24,11,72,48,40,2.4,0.8333333333333334
1302,1169255,500,16547,500,17547,1000,501,33.094,0.0
1303,413213,500,6860,500,7860,1000,501,13.72,0.0
13034,1440,3,8,3,23,15,14,4.0,0.0
1304,10864,16,128,16,160,32,17,8.0,0.0
13041,1622,4,9,4,24,15,14,3.0,0.0
13045,1157,2,6,2,16,10,9,6.0,0.0
13049,5338,11,35,11,70,35,24,4.375,1.0
1305,755852,500,12326,500,13326,1000,501,24.652,0.0
13050,2113,4,14,4,29,15,16,3.5,0.0
13059,2546,1,10,1,33,23,24,5.0,0.0
1306,31159,7,515,7,529,14,8,73.571,0.0
13062,3688,6,14,6,33,19,14,2.8,0.0
13066,23216,54,147,54,341,194,141,1.885,0.0
13068,1091,2,6,2,15,9,9,6.0,0.0
1307,412430,500,6843,500,7843,1000,501,13.686,0.0
13071,1149,2,6,2,17,11,10,6.0,0.0
13077,3107,7,17,7,37,20,14,1.545,0.0
13080,1241,3,12,3,18,6,7,6.0,0.0
13081,2956,5,7,5,22,15,12,1.75,0.0
13083,3390,4,33,4,55,22,23,2.75,0.0
13086,1898,4,10,4,28,18,17,3.333,0.0
13088,4107,11,22,11,63,41,35,2.444,0.0
1309,707242,500,11500,500,12500,1000,501,23.0,0.0
13096,4020,8,8,8,38,30,12,1.0,0.0
1310,860231,500,13238,500,14238,1000,501,26.476,0.0
13105,7988,23,42,23,129,87,63,1.355,0.0
13108,2035,6,11,6,39,28,25,1.571,0.0
1311,1114634,500,15686,500,16686,1000,501,31.372,0.0
13114,9373,49,103,49,208,105,58,2.102,0.0
1312,1389560,500,23832,500,24832,1000,501,47.664,0.0
13123,6608,20,50,20,124,74,57,2.5,0.0
13124,6188,17,43,17,89,46,32,2.867,0.0
13126,981,2,5,2,14,9,9,5.0,0.0
1313,146898,297,1892,297,2486,594,298,6.37,0.0
13132,1270,2,6,2,12,6,7,3.0,0.0
13138,2488,5,12,5,35,23,22,2.4,0.0
1314,938774,500,16190,500,17190,1000,501,32.38,0.0
13141,5434,1,8,1,75,67,66,8.0,0.0
13142,7415,6,15,6,62,47,49,3.0,0.0
13149,4720,10,23,10,73,50,37,2.3,0.0
1315,1485078,500,25075,500,26075,1000,501,50.15,0.0
13154,3831,7,24,7,58,34,28,3.0,0.0
1316,215239,256,3072,256,3584,512,257,12.0,0.0
13166,6784,19,32,19,105,73,58,1.778,0.0
1317,322680,500,4165,500,5165,1000,501,8.33,0.0
13173,18576,51,119,51,301,182,136,1.676,1.0
13176,1901,3,12,3,24,12,12,3.0,0.0
1318,195541,65,3212,65,3342,130,66,49.415,0.0
13187,6242,4,31,4,83,52,46,1.348,1.0
13188,1563,2,8,2,21,13,13,8.0,0.0
1319,74798,110,880,110,1100,220,111,8.0,0.0
13197,2379,8,16,8,38,22,16,2.286,0.0
1320,10309,7,147,7,161,14,8,21.0,0.0
1321,431379,500,6000,500,7000,1000,501,12.0,0.0
1322,1040435,500,17931,500,18931,1000,501,35.862,0.0
1323,39984,13,676,13,702,26,14,52.0,0.0
1324,19861,21,272,21,314,42,22,12.952,0.0
1325,1395285,500,23697,500,24697,1000,501,47.394,0.0
13252,8744,4,21,4,47,26,32,21.0,0.0
13254,65956,10,80,10,478,398,248,26.666,0.0
1326,430141,500,7209,500,8209,1000,501,14.418,0.0
13260,30731,14,89,14,127,38,29,7.417,0.0
13261,16619,28,58,28,185,127,74,2.148,0.0
13263,33191,99,53,99,346,293,106,1.0,0.0
13267,1524,3,1,3,6,5,6,1.0,0.0
1327,443994,500,6808,500,7808,1000,501,13.616,0.0
13275,20662,62,103,62,228,125,42,3.121,0.0
13279,16619,3,19,3,94,75,81,19.0,0.0
1328,1681631,500,23274,500,24274,1000,501,46.548,0.0
13283,14935418,18083,52711,18083,169920,117209,26711,22.223000000000003,0.8
13284,484477,888,888,888,4387,3499,1216,1.0,0.5833333333333334
13288,6192546,8818,42307,8818,78666,36359,16778,12.446,1.0
1329,457297,500,7639,500,8639,1000,501,15.278,0.0
13291,106620,282,290,282,1302,1012,273,4.823,0.0
13299,11584,3,12,3,84,72,78,12.0,0.0
1330,417478,500,6952,500,7952,1000,501,13.904,0.0
1331,143427,297,1810,297,2404,594,298,6.094,0.0
13319,25226,58,105,58,246,141,77,4.535,0.0
1332,381194,296,6051,296,6643,592,297,20.443,0.0
13323,3670,5,19,5,36,17,16,19.0,0.0
1333,1903560,500,29360,500,30360,1000,501,58.72,0.0
13334,29343,6,33,6,225,192,174,11.001,0.0
13339,336668,61,25,61,4324,4299,4246,8.714,0.75
1334,655161,500,10500,500,11500,1000,501,21.0,0.0
13347,187378084,89917,570526,89917,2203699,1633173,225645,10.696,0.9
13348,16397,1,10,1,191,181,182,10.0,1.0
1335,282496,500,3500,500,4500,1000,501,7.0,0.0
13351,27417,6,12,6,232,220,203,3.0,0.0
13356,3122417,853,14703,853,37396,22693,2226,30.537,0.5
13357,170812,393,893,393,1918,1025,414,21.766,0.875
1336,429188,500,6000,500,7000,1000,501,12.0,0.0
13360,89189,226,236,226,706,470,237,1.044,0.0
13368,199686,719,1414,719,2857,1443,739,9.986,1.0
13369,581100,1632,2103,1632,6459,4356,1780,41.284,0.0
1337,464845,500,8030,500,9030,1000,501,16.06,0.0
13378,145748295,464915,899195,464915,1770625,871430,696079,6.729999999999999,0.0
13379,149053,281,837,281,2092,1255,454,3.577,0.875
1338,57936,7,884,7,898,14,8,126.286,0.0
13384,44739,6,13,6,374,361,348,3.25,0.0
13388,48078098,1642,2709,1642,441792,439083,282034,647.284,0.0
1339,247811,280,4480,280,5040,560,281,16.0,0.0
13391,3640,0,23,0,31,8,10,4.6,0.0
13394,17147,6,12,6,147,135,112,3.0,0.0
1340,756768,500,12326,500,13326,1000,501,24.652,0.0
13400,1396297,4016,1008,4016,17029,16021,7022,1.007,0.5
1341,841427,500,13096,500,14096,1000,501,26.192,0.0
13412,192805,412,1006,412,2088,1082,452,20.159,0.0
1342,582252,342,9025,342,9709,684,343,26.389,0.0
13420,200270,231,434,231,1984,1550,622,2.553,0.5
13421,38212,6,11,6,334,323,304,2.75,0.0
13425,6287,17,22,17,68,46,29,1.833,0.0
13427,8256,13,26,13,60,34,27,2.364,0.0
1343,486107,295,7080,295,7670,590,296,24.0,0.0
1344,429261,500,6000,500,7000,1000,501,12.0,0.0
13445,351299,9,67,9,2318,2251,1575,67.0,0.0
1345,895867,500,15288,500,16288,1000,501,30.576,0.0
13452,27400,6,11,6,234,223,210,2.75,0.0
1346,322660,500,4226,500,5226,1000,501,8.452,0.0
13461,2524534,1650,2961,1650,25635,22674,14539,1321.0700000000002,0.0
13469,12191,1,2,1,47,45,50,2.0,0.0
1347,9144,7,133,7,147,14,8,19.0,0.0
13471,72242,3,19,3,210,191,200,19.0,0.0
13474,4627,15,18,15,77,59,46,1.2,0.5
1348,1218956,500,20667,500,21667,1000,501,41.334,0.0
13482,22203,3,14,3,114,100,129,14.0,0.0
1349,358960,500,5347,500,6347,1000,501,10.694,0.0
1350,1087133,500,18949,500,19949,1000,501,37.898,0.0
13501,1208,1,3,1,14,11,11,3.0,0.0
13506,7844,2,1,2,27,26,29,1.0,0.0
1351,1530259,500,25949,500,26949,1000,501,51.898,0.0
1352,9176,7,133,7,147,14,8,19.0,0.0
13522,5463,1,2,1,17,15,21,2.0,0.0
1353,1789935,500,30759,500,31759,1000,501,61.518,0.0
13530,332529,479,1008,479,2140,1132,543,2.225,0.0
13532,74980,184,217,184,856,639,163,1.824,0.0
1354,359932,500,5354,500,6354,1000,501,10.708,0.0
13541,903707,1237,3240,1237,6052,2812,1326,4.534,0.0
1355,1565853,500,24172,500,25172,1000,501,48.344,0.0
1356,926721,500,14324,500,15324,1000,501,28.648,0.0
13565,6736,2,3,2,50,47,47,2.0,0.0
13568,5428,13,35,13,101,66,49,2.917,0.875
1357,1685,1,18,1,20,2,2,18.0,0.0
13574,40321,87,201,87,527,326,175,3.526,0.5
13577,47990828,291029,152729,291029,991544,838815,329391,4.0009999999999994,0.0
13579,1442149,2041,2916,2041,13597,10681,2557,2.004,0.5
1358,919887,500,15491,500,16491,1000,501,30.982,0.0
13581,6199,8,20,8,89,69,53,2.0,0.0
13582,5428,13,35,13,101,66,49,2.917,0.75
1359,214412,256,3072,256,3584,512,257,12.0,0.0
13594,2887,12,15,12,65,50,48,1.25,0.0
1360,429269,500,6000,500,7000,1000,501,12.0,0.0
13600,25151,5,11,5,147,136,150,11.0,0.0
1361,1585259,500,27211,500,28211,1000,501,54.422,0.0
13611,65573,228,175,228,659,484,297,1.061,0.0
1362,443502,500,7138,500,8138,1000,501,14.276,0.0
13622,38352211,73684,138330,73684,422248,283918,73828,3.4050000000000002,0.0
13623,27417,6,12,6,232,220,203,3.0,0.0
1363,856853,500,14010,500,15010,1000,501,28.02,0.0
13633,118198,234,507,234,1523,1016,366,6.773999999999999,1.0
1364,1829788,500,28547,500,29547,1000,501,57.094,0.0
1365,419354,105,7107,105,7317,210,106,67.686,0.0
1366,628171,500,10010,500,11010,1000,501,20.02,0.0
1367,458158,105,7800,105,8010,210,106,74.286,0.0
1368,1283647,500,18440,500,19440,1000,501,36.88,0.0
13683,279879,838,4278,838,8399,4121,2138,12.261,0.0
1369,48926,16,832,16,864,32,17,52.0,0.0
1370,4050,2,54,2,58,4,3,27.0,0.0
1371,1868391,500,32106,500,33106,1000,501,64.212,0.0
13715,985763,2503,5029,2503,15293,10264,5065,8.949,0.5
13719,25039544,44874,94625,44874,225589,130964,44711,2.123,0.0
1372,646372,500,9952,500,10952,1000,501,19.904,0.0
1373,522651,500,8000,500,9000,1000,501,16.0,0.0
1374,522815,500,8000,500,9000,1000,501,16.0,0.0
1375,726131,500,11701,500,12701,1000,501,23.402,0.0
13759,159924,306,888,306,1880,992,316,16.012,0.0
1376,85275,126,1008,126,1260,252,127,8.0,0.0
1377,71229,7,1117,7,1131,14,8,159.571,0.0
1378,75275,111,886,111,1108,222,112,7.982,0.0
1379,145481,294,1877,294,2465,588,295,6.384,0.0
13796,159924,306,888,306,1880,992,316,16.012,1.0
1380,1259011,500,21388,500,22388,1000,501,42.776,0.0
1381,400112,91,6781,91,6963,182,92,74.516,0.0
1382,1692582,500,29204,500,30204,1000,501,58.408,0.0
13822,9922453,34381,206286,34381,273158,66872,34748,24.0,0.0
1383,460580,500,7753,500,8753,1000,501,15.506,0.0
1384,1911654,500,32944,500,33944,1000,501,65.888,0.0
13845,47472,117,162,117,518,356,141,1.929,0.0
13847,609516,1006,632,1006,11380,10748,1200,1.213,1.0
1385,521302,500,8000,500,9000,1000,501,16.0,0.0
1386,214393,256,3072,256,3584,512,257,12.0,0.0
1387,143612,297,1813,297,2407,594,298,6.104,0.0
1388,19615,21,268,21,310,42,22,12.762,0.0
1389,429294,500,6000,500,7000,1000,501,12.0,0.0
1390,11386,12,192,12,216,24,13,16.0,0.0
13902,24431458,35010,64000,35010,294939,230939,69482,1.828,0.0
1391,1002375,500,16556,500,17556,1000,501,33.112,0.0
1392,858230,500,13238,500,14238,1000,501,26.476,0.0
1393,83179,96,1506,96,1698,192,97,15.688,0.0
1394,458552,105,7800,105,8010,210,106,74.286,0.0
1395,774272,295,12945,295,13535,590,296,43.881,0.0
1396,774872,295,12948,295,13538,590,296,43.892,0.0
1397,1289290,500,21775,500,22775,1000,501,43.55,0.0
1398,1257010,500,21388,500,22388,1000,501,42.776,0.0
13981,3212061,2866,27215,2866,30081,2866,1435,18.992,0.0
1399,559950,500,8753,500,9753,1000,501,17.506,0.0
13990,25814,39,213,39,450,237,90,8.52,0.5
13997,664346,149,722,149,4725,4003,2128,26.478,0.0
1400,985333,500,15022,500,16022,1000,501,30.044,0.0
1401,731460,500,11500,500,12500,1000,501,23.0,0.0
14011,181719,491,354,491,1613,1259,401,1.117,1.0
14013,1256301,1089,10902,1089,13052,2150,1129,10.048,1.0
14018,5922,14,47,14,77,30,27,9.4,0.0
1402,485745,500,7319,500,8319,1000,501,14.638,0.0
1403,457215,105,7780,105,7990,210,106,74.095,0.0
1404,743838,500,11683,500,12683,1000,501,23.366,0.0
14049,5409790,24643,23835,24643,99506,75671,27497,1.488,0.0
1405,520868,500,8000,500,9000,1000,501,16.0,0.0
14050,87241,501,501,501,1487,986,321,21.0,0.0
14054,35831,5,40,5,239,199,124,13.333,0.0
1406,1530259,500,25949,500,26949,1000,501,51.898,0.0
1407,572515,500,8885,500,9885,1000,501,17.77,0.0
14079,261945528,348817,21,2999957,1325620,1325599,348830,5.55030733416283,0.0
1408,1619174,500,27846,500,28846,1000,501,55.692,0.0
14080,8855,4,26,4,106,80,72,5.2,0.0
14084,4492480,6826,14537,6826,50795,36258,21082,1323.316,0.5
1409,440021,500,7440,500,8440,1000,501,14.88,0.0
1410,10871,16,128,16,160,32,17,8.0,0.0
1411,282686,500,3500,500,4500,1000,501,7.0,0.0
1412,1111279,500,18750,500,19750,1000,501,37.5,0.0
1413,418296,105,7095,105,7305,210,106,67.571,0.0
1414,656249,500,10473,500,11473,1000,501,20.946,0.0
1415,399301,500,5392,500,6392,1000,501,10.784,0.0
1416,1019084,500,17710,500,18710,1000,501,35.42,0.0
14162,4507278,21728,80053,21728,115047,34994,10906,7.369,0.5
14163,8743403,40135,143413,40135,230781,87368,20106,7.146,0.0
1417,391152,500,5812,500,6812,1000,501,11.624,0.0
14177,107705,126,243,126,983,740,236,1.929,0.8333333333333334
1418,13782,14,238,14,266,28,15,17.0,0.0
1419,852820,500,13168,500,14168,1000,501,26.336,0.0
14195,55639428,139746,233087,139746,585473,352386,115282,9.696000000000002,0.5
14196,15206428,44120,110531,44120,210964,100433,57277,54.535,0.5
14197,3870140,5860,20888,5860,35008,14120,6551,22.377000000000002,0.0
14198,9059796,24712,84294,24712,144907,60613,26772,17.39,0.0
1420,521280,500,8000,500,9000,1000,501,16.0,0.0
1421,10876,16,128,16,160,32,17,8.0,0.0
1422,706032,500,11279,500,12279,1000,501,22.558,0.0
1423,954923,500,16491,500,17491,1000,501,32.982,0.0
14235,8256,13,26,13,60,34,27,2.364,0.0
1424,1003326,500,17414,500,18414,1000,501,34.828,0.0
1425,213906,196,3375,196,3767,392,197,17.219,0.0
14252,145748295,464915,899195,464915,1770625,871430,696079,6.729999999999999,0.0
1426,1294590,500,18841,500,19841,1000,501,37.682,0.0
1427,249870,280,4412,280,4972,560,281,15.757,0.0
14277,14935418,18083,52711,18083,169920,117209,26711,22.223000000000003,0.75
1428,726518,112,11187,112,11411,224,113,99.884,0.0
1429,28436,7,468,7,482,14,8,66.857,0.0
14292,25226,58,105,58,246,141,77,4.535,0.0
14298,89189,226,236,226,706,470,237,1.044,0.0
14299,6287,17,22,17,68,46,29,1.833,0.0
1430,852932,500,13136,500,14136,1000,501,26.272,0.0
14304,609516,1006,632,1006,11380,10748,1200,1.213,1.0
14308,336668,61,25,61,4324,4299,4246,8.714,1.0
1431,1371546,500,23376,500,24376,1000,501,46.752,0.0
1432,731460,500,11500,500,12500,1000,501,23.0,0.0
14324,187378084,89917,570526,89917,2203699,1633173,225645,10.696,1.0
1433,214312,256,3072,256,3584,512,257,12.0,0.0
14336,581100,1632,2103,1632,6459,4356,1780,41.284,0.0
1434,10865,16,128,16,160,32,17,8.0,0.0
14344,199686,719,1414,719,2857,1443,739,9.986,1.0
1435,327768,500,4309,500,5309,1000,501,8.618,0.0
14352,149053,281,837,281,2092,1255,454,3.577,0.75
14355,3670,5,19,5,36,17,16,19.0,0.0
1436,57296,32,896,32,960,64,33,28.0,0.0
14364,33191,99,53,99,346,293,106,1.0,0.0
1437,392408,500,5836,500,6836,1000,501,11.672,0.0
1438,858928,500,13202,500,14202,1000,501,26.404,0.0
14382,1396297,4016,1008,4016,17029,16021,7022,1.007,0.5
14383,200270,231,434,231,1984,1550,622,2.553,0.5
14387,16619,3,19,3,94,75,81,19.0,0.0
1439,656874,500,10500,500,11500,1000,501,21.0,0.0
14396,72242,3,19,3,210,191,200,19.0,0.0
14399,3512960,155,6,155,32524,32518,5652,2.0,0.0
1440,899954,500,15083,500,16083,1000,501,30.166,0.0
14401,1520,3,1,3,6,5,6,1.0,0.0
1441,327916,500,4775,500,5775,1000,501,9.55,0.0
14411,8744,4,21,4,47,26,32,21.0,0.0
14417,484477,888,888,888,4387,3499,1216,1.0,0.6
1442,31174,7,515,7,529,14,8,73.571,0.0
1443,531552,500,8141,500,9141,1000,501,16.282,0.0
14430,985763,2503,5029,2503,15293,10264,5065,8.949,0.5
14434,111392,404,680,404,2634,1954,656,1.943,0.0
1444,792972,112,12225,112,12449,224,113,109.152,0.0
1445,564799,500,7500,500,8500,1000,501,15.0,0.0
14450,16619,28,58,28,185,127,74,2.148,0.0
14451,7943830,6934,152053,6934,316238,164185,153804,2.026,0.0
1446,446734,500,6000,500,7000,1000,501,12.0,0.0
1447,1079286,500,18623,500,19623,1000,501,37.246,0.0
14471,903707,1237,3240,1237,6052,2812,1326,4.534,0.0
14472,2785,2,13,2,35,22,23,13.0,0.0
14473,58168,4,37,4,1248,1211,1217,37.0,0.0
1448,571187,500,8816,500,9816,1000,501,17.632,0.0
14486,2887,12,15,12,65,50,48,1.25,0.5
1449,796766,112,12267,112,12491,224,113,109.527,0.0
14491,5428,13,35,13,101,66,49,2.917,1.0
14493,6199,8,20,8,89,69,53,2.0,0.0
1450,143825,296,1832,296,2424,592,297,6.189,0.0
14503,118198,234,507,234,1523,1016,366,6.773999999999999,0.5
1451,992257,500,17217,500,18217,1000,501,34.434,0.0
14517,5463,1,2,1,17,15,21,2.0,0.0
14519,9265,11,25,11,110,85,85,25.0,0.0
1452,2118491,500,30829,500,31829,1000,501,61.658,0.0
14520,25151,5,11,5,147,136,150,11.0,0.0
1453,324707,500,4275,500,5275,1000,501,8.55,0.0
14530,2447132,6199,11142,6199,27575,16433,7170,470.068,0.5
1454,55361,32,864,32,928,64,33,27.0,0.0
14543,4627,15,18,15,77,59,46,1.2,0.0
14546,8590,4,23,4,81,58,31,7.667,0.5
14547,30731,14,89,14,127,38,29,7.417,0.0
14549,1208,1,3,1,14,11,11,3.0,0.0
1455,1695748,500,29190,500,30190,1000,501,58.38,0.0
14558,9557,4,13,4,55,42,48,13.0,0.0
1456,39873,13,676,13,702,26,14,52.0,0.0
1457,429224,500,6000,500,7000,1000,501,12.0,0.0
14573,3107,7,17,7,37,20,14,1.545,0.0
1458,146056,168,2352,168,2688,336,169,14.0,0.0
14580,6192546,8818,42307,8818,78666,36359,16778,12.446,1.0
14581,390322,1486,1498,1486,5050,3552,1382,3.201,0.0
14583,29343,6,33,6,225,192,174,11.001,0.0
14587,44739,6,13,6,374,361,348,3.25,0.0
1459,888948,500,14957,500,15957,1000,501,29.914,0.0
14592,351299,9,67,9,2318,2251,1575,67.0,0.0
14599,17147,6,12,6,147,135,112,3.0,0.0
1460,439371,105,7449,105,7659,210,106,70.943,0.0
14603,170812,393,893,393,1918,1025,414,21.766,0.875
14604,5945,6,12,6,49,37,30,3.0,0.0
1461,986434,500,16692,500,17692,1000,501,33.384,0.0
1462,1297360,500,18631,500,19631,1000,501,37.262,0.0
1463,324766,500,4753,500,5753,1000,501,9.506,0.0
14631,136854,477,2069,477,2546,477,479,4.338,0.0
14635,16091,13,60,13,166,106,38,8.571,0.0
14637,27400,6,11,6,234,223,210,2.75,0.0
1464,1066736,500,18405,500,19405,1000,501,36.81,0.0
14645,45631,0,712,0,712,0,178,4.0,0.0
1465,83493,96,1476,96,1668,192,97,15.375,0.0
14657,29340,157,468,157,793,325,172,3.0,0.0
1466,840907,500,13103,500,14103,1000,501,26.206,0.0
1467,1595976,500,21113,500,22113,1000,501,42.226,0.0
14676,1241,3,12,3,18,6,7,6.0,0.0
1468,214376,256,3072,256,3584,512,257,12.0,0.0
1469,1111238,500,18756,500,19756,1000,501,37.512,0.0
1470,444815,500,6000,500,7000,1000,501,12.0,0.0
1471,559761,500,8668,500,9668,1000,501,17.336,0.0
1472,468473,500,7997,500,8997,1000,501,15.994,0.0
1473,545501,500,7277,500,8277,1000,501,14.554,0.0
1474,1075279,500,18032,500,19032,1000,501,36.064,0.0
14742,185146,103,897,103,1439,542,362,9.645,0.0
1475,1423093,500,24252,500,25252,1000,501,48.504,0.0
14750,585603,1003,1009,1003,4320,3311,2070,1.006,0.9
14751,585603,1003,1009,1003,4320,3311,2070,1.006,0.9
1476,405388,91,6940,91,7122,182,92,76.264,0.0
1477,1263695,500,21571,500,22571,1000,501,43.142,0.0
1478,714052,295,11210,295,11800,590,296,38.0,0.0
1479,411966,500,6265,500,7265,1000,501,12.53,0.5
1480,214273,256,3072,256,3584,512,257,12.0,0.0
14801,86670343,118022,144578,118022,398924,254346,49851,5.916,0.0
14806,159924,306,888,306,1880,992,316,16.012,1.0
1481,398883,500,6202,500,7202,1000,501,12.404,0.0
1482,654152,500,10083,500,11083,1000,501,20.166,0.0
14822,23062,12,112,12,148,36,39,17.179000000000002,1.0
1483,424635,500,7124,500,8124,1000,501,14.248,0.0
1484,1278047,500,18343,500,19343,1000,501,36.686,0.0
1485,429206,500,6000,500,7000,1000,501,12.0,0.0
1486,86192,96,1536,96,1728,192,97,16.0,0.0
1487,755852,500,12326,500,13326,1000,501,24.652,0.0
1488,392408,500,5836,500,6836,1000,501,11.672,0.0
1489,334423,500,5033,500,6033,1000,501,10.066,0.0
1490,57485,7,882,7,896,14,8,126.0,0.0
1491,218333,197,3593,197,3987,394,198,18.239,0.0
14916,24431458,35010,64000,35010,294939,230939,69482,1.828,0.0
1492,1302548,500,20367,500,21367,1000,501,40.734,0.0
14921,47990828,291029,152729,291029,991544,838815,329391,4.0009999999999994,0.0
14924,1442149,2041,2916,2041,13597,10681,2557,2.004,0.5
14925,34419199,112532,205765,112532,734979,529214,132577,2.207,0.0
1493,1390704,500,21361,500,22361,1000,501,42.722,0.0
1494,404516,500,6333,500,7333,1000,501,12.666,0.0
14942,22394036,81025,173250,81025,319880,146630,81028,2.182,0.0
1495,654899,500,10500,500,11500,1000,501,21.0,0.0
1496,846786,500,13165,500,14165,1000,501,26.33,0.0
1497,562766,500,7500,500,8500,1000,501,15.0,0.0
14976,920839,1969,6812,1969,12289,5477,2240,3.881,0.5
14977,644134,2514,5024,2514,10038,5014,2365,3.349,0.5
14979,533183,1278,3674,1278,6967,3293,1595,3.645,0.0
1498,429219,500,6000,500,7000,1000,501,12.0,0.0
1499,74363,110,880,110,1100,220,111,8.0,0.0
1500,10876,16,128,16,160,32,17,8.0,0.0
15001,38677,40,144,40,603,459,262,20.609,0.8333333333333334
15002,40550,40,144,40,615,471,274,20.609,0.6
15003,39438,40,147,40,609,462,265,23.609,0.75
15004,38870,40,144,40,603,459,262,20.609,0.7
15005,39409,40,144,40,606,462,265,20.609,1.0
15006,37434,39,139,39,592,453,256,15.609,0.75
15007,43017,40,147,40,636,489,292,23.609,0.7142857142857143
15008,2291034,2063,10844,2063,26016,15172,2292,25.898,0.5
15009,2523087,1805,12491,1805,29158,16667,2295,33.601,1.0
1501,427632,500,6549,500,7549,1000,501,13.098,0.0
15010,61075,56,270,56,843,573,286,39.734,0.0
15011,287506,240,1251,240,3119,1868,469,32.114000000000004,0.5
15012,3032829,2108,14818,2108,34177,19359,2359,36.7,1.0
15013,568135,507,2837,507,6713,3876,737,29.369,0.625
15014,4961,0,21,0,53,32,34,3.5,0.5
1502,521102,500,8000,500,9000,1000,501,16.0,0.0
1503,363004,500,5434,500,6434,1000,501,10.868,0.0
1504,39900,13,676,13,702,26,14,52.0,0.0
15044,1464426,2592,6830,2592,15667,8837,2929,2.367,0.0
1505,1595132,500,27416,500,28416,1000,501,54.832,0.0
15050,332529,479,1008,479,2140,1132,543,2.225,0.0
15054,65573,228,175,228,659,484,297,1.061,0.5
15059,44981,14,94,14,476,382,382,64.5,0.0
1506,507234,500,8753,500,9753,1000,501,17.506,0.0
1507,10868,16,128,16,160,32,17,8.0,0.0
1508,1375207,500,23405,500,24405,1000,501,46.81,0.0
15082,192805,412,1006,412,2088,1082,452,20.159,0.0
1509,1551579,500,26500,500,27500,1000,501,53.0,0.0
15092,38352211,73684,138330,73684,422248,283918,73828,3.4050000000000002,0.0
15095,898270,2357,1104,2357,7993,6889,2365,1.0,0.75
1510,724823,500,11698,500,12698,1000,501,23.396,0.0
1511,1174754,500,16574,500,17574,1000,501,33.148,0.0
15119,2276,0,47,0,48,1,2,47.0,0.0
1512,490126,500,7185,500,8185,1000,501,14.37,0.0
1513,841628,500,12926,500,13926,1000,501,25.852,0.0
1514,941878,500,14427,500,15427,1000,501,28.854,0.0
15144,9025159,9010,68547,9010,150439,81892,9040,29.216,0.5
1515,356156,500,5230,500,6230,1000,501,10.46,0.0
15150,159924,306,888,306,1880,992,316,16.012,0.0
15156,2231685,1663,10063,1663,14170,4107,3416,5.912,0.0
1516,839196,500,12378,500,13378,1000,501,24.756,0.0
1517,1239322,500,21025,500,22025,1000,501,42.05,0.0
15173,65424,82,116,82,352,236,114,3.624,0.7
15174,586851,632,1274,632,3072,1798,822,4.246,0.7
15175,47139,38,62,38,304,242,204,4.77,0.6666666666666666
15176,3533524,8658,7796,8658,20994,13198,4856,3.308,0.8333333333333334
1518,346435,500,5229,500,6229,1000,501,10.458,0.0
15186,51276814,37752,139108,37752,291720,152612,39126,7.37,0.7
15187,2395729,3276,5616,3276,11882,6266,2114,5.576,0.5
1519,1165976,500,16447,500,17447,1000,501,32.894,0.0
15191,70705,30,28,30,322,294,404,4.666,0.6666666666666666
15192,865595,854,2184,854,4736,2552,948,5.126,0.6666666666666666
1520,492807,500,8337,500,9337,1000,501,16.674,0.0
15205,47472,117,162,117,518,356,141,1.929,0.0
1521,340304,500,5105,500,6105,1000,501,10.21,0.0
1522,946966,500,16174,500,17174,1000,501,32.348,0.0
1523,1780205,500,30546,500,31546,1000,501,61.092,0.0
1524,403384,500,6262,500,7262,1000,501,12.524,0.0
15243,4189129327,11678199,32768761,78537954,50857791,16001964,11678166,4.354946744206239,0.5
15245,4517,5,15,5,45,30,29,3.75,0.0
1525,32148,7,531,7,545,14,8,75.857,0.0
1526,1397286,500,23697,500,24697,1000,501,47.394,0.0
15261,279879,838,4278,838,8399,4121,2138,12.261,0.0
1527,2104976,500,30900,500,31900,1000,501,61.8,0.0
15275,25039544,44874,94625,44874,225589,130964,44711,2.123,0.0
1528,394188,500,5516,500,6516,1000,501,11.032,0.0
15282,9922453,34381,206286,34381,273158,66872,34748,24.0,0.0
1529,10872,16,128,16,160,32,17,8.0,0.0
1530,441834,500,6000,500,7000,1000,501,12.0,0.0
1531,282333,500,3500,500,4500,1000,501,7.0,0.0
1532,760449,500,12619,500,13619,1000,501,25.238,0.0
1533,455764,500,7427,500,8427,1000,501,14.854,0.0
15333,100704,282,290,282,1302,1012,273,4.823,0.0
1534,419318,296,6327,296,6919,592,297,21.375,0.0
1535,1197644,500,18887,500,19887,1000,501,37.774,0.0
1536,975700,500,16975,500,17975,1000,501,33.95,0.0
1537,989008,500,16530,500,17530,1000,501,33.06,0.0
1538,1752654,500,24350,500,25350,1000,501,48.7,0.0
15381,3122417,853,14703,853,37396,22693,2226,30.537,0.5
1539,562487,500,7500,500,8500,1000,501,15.0,0.0
1540,445908,500,6000,500,7000,1000,501,12.0,0.0
1541,419508,105,7109,105,7319,210,106,67.705,0.0
15414,48078098,1642,2709,1642,441792,439083,282034,647.284,0.0
1542,733835,500,11944,500,12944,1000,501,23.888,0.0
1543,1607954,500,27440,500,28440,1000,501,54.88,0.0
1544,728182,281,12115,281,12677,562,282,43.114,0.0
15442,3727,5,11,5,32,21,14,2.75,0.0
1545,146109,297,1908,297,2502,594,298,6.424,0.0
15458,6675,6,11,6,53,42,35,2.75,0.0
1546,142971,296,1804,296,2396,592,297,6.095,0.0
15468,127101,378,2079,378,2835,756,380,5.5,0.0
15469,115317,342,1881,342,2565,684,345,5.5,0.5
1547,447104,500,7174,500,8174,1000,501,14.348,0.0
15470,3649,0,30,0,35,5,6,6.0,0.0
15471,7745,17,102,17,136,34,18,6.0,0.0
15472,4541,9,45,9,63,18,10,5.0,0.0
15473,10861,19,114,19,152,38,20,6.0,0.0
15474,5994,13,47,13,73,26,14,3.615,0.0
15475,1279,0,8,0,10,2,3,4.0,0.5
15477,434257,500,6000,500,7000,1000,501,12.0,1.0
15478,465914,0,6000,0,6500,500,501,12.0,0.0
1548,1739152,500,30001,500,31001,1000,501,60.002,0.0
15480,2718,7,28,7,42,14,8,4.0,0.0
15482,326083,0,3500,0,4000,500,501,7.0,0.0
15483,224047,500,2500,500,3500,1000,501,5.0,0.0
15484,14794,34,151,34,219,68,35,4.441,0.0
15485,438323,0,5228,0,5728,500,501,10.456,0.0
15488,350333,0,4078,0,4578,500,501,8.156,0.0
15489,255740,500,3498,500,4498,1000,501,6.996,0.0
1549,411348,500,6766,500,7766,1000,501,13.532,0.0
15491,622078,0,5990,0,6490,500,501,11.98,0.0
15492,1583433,0,13992,0,14492,500,501,27.984,0.0
15493,365416,500,5000,500,6000,1000,501,10.0,0.0
15494,2088230,0,28689,0,29189,500,501,57.378,0.0
15495,374292,0,5074,0,5574,500,501,10.148,0.0
15496,260265,500,3503,500,4503,1000,501,7.006,0.0
15497,374795,500,5636,500,6636,1000,501,11.272,0.0
1550,325305,500,4766,500,5766,1000,501,9.532,0.0
15500,280721,500,2500,500,3500,1000,501,5.0,0.0
15501,182681,0,2000,0,2500,500,501,4.0,0.0
15502,157718,306,2370,306,2982,612,308,7.745,0.0
15503,462709,500,5500,500,6500,1000,501,11.0,0.0
15505,222598,0,2000,0,2500,500,501,4.0,0.0
15506,254543,0,2797,0,3297,500,501,5.594,0.0
15507,382600,0,4000,0,4500,500,501,8.0,0.0
15508,303839,500,3877,500,4877,1000,501,7.754,0.0
15509,1924856,0,23386,0,23886,500,501,46.772,0.0
1551,1947585,500,33625,500,34625,1000,501,67.25,0.0
15510,200963,0,2239,0,2640,401,402,5.584,0.0
15513,435749,0,4500,0,5000,500,501,9.0,0.0
15514,1931341,0,15536,0,16036,500,501,31.072,0.0
15515,166880,0,1500,0,2000,500,501,3.0,0.0
15516,387583,0,4500,0,5000,500,501,9.0,0.0
15517,190780,0,2003,0,2503,500,501,4.006,0.0
15518,330937,0,3500,0,4000,500,501,7.0,0.0
15519,248052,0,2500,0,3000,500,501,5.0,0.0
1552,1702,1,18,1,20,2,2,18.0,0.0
15520,357500,1000,4546,1000,6546,2000,1002,4.546,0.0
15521,755206,500,2562,500,3562,1000,501,5.124,0.0
15522,237705,500,3016,500,4016,1000,501,6.032,0.0
15523,1080717,0,14753,0,15253,500,501,29.506,0.0
15524,207904,0,1962,0,2462,500,501,3.924,0.0
15525,415122,500,5905,500,6905,1000,501,11.81,0.0
15526,227089,500,3000,500,4000,1000,501,6.0,0.0
15527,412583,0,4500,0,5000,500,501,9.0,0.0
15528,445583,0,4500,0,5000,500,501,9.0,0.0
1553,1696954,500,23463,500,24463,1000,501,46.926,0.0
15530,316080,500,4363,500,5363,1000,501,8.726,0.0
15531,287491,500,3497,500,4497,1000,501,6.994,0.0
15532,218815,0,2500,0,3000,500,501,5.0,0.0
15533,292584,0,3000,0,3500,500,501,6.0,0.0
15534,317208,500,4517,500,5517,1000,501,9.034,0.0
15535,209984,596,2929,596,4121,1192,598,4.914,0.0
15536,363721,0,4000,0,4500,500,501,8.0,0.0
15537,255881,0,3303,0,3803,500,501,6.606,0.0
15539,122552,176,1668,176,2196,528,354,4.739,0.0
1554,582252,342,9025,342,9709,684,343,26.389,0.0
15540,259015,500,3000,500,4000,1000,501,6.0,0.0
15541,300683,500,3123,500,4123,1000,501,6.246,0.0
15543,304151,0,3048,0,3548,500,501,6.096,0.0
15544,318226,500,4253,500,5253,1000,501,8.506,0.0
15545,99724,164,1028,164,1356,328,165,6.268,0.0
15546,398815,0,1552,0,2885,1333,1334,1.164,0.0
15547,246767,388,2325,388,3101,776,389,5.992,0.0
1555,214084,256,3072,256,3584,512,257,12.0,0.0
15550,862827,907,2983,907,6964,3981,1258,9.998,0.0
1556,858664,112,13427,112,13651,224,113,119.884,0.0
15569,626567,500,9421,500,10921,1500,502,18.842,0.0
1557,39699,13,676,13,702,26,14,52.0,0.0
15571,202098,500,2000,500,3000,1000,501,4.0,0.0
15575,318983,97,2199,97,2393,194,98,22.67,0.0
15576,6261,10,40,10,70,30,12,4.0,0.0
1558,1967845,500,34111,500,35111,1000,501,68.222,0.0
15581,153347,149,1389,149,1687,298,150,9.322,0.0
15584,613520,500,7073,500,8573,1500,502,14.146,0.0
1559,660437,500,9979,500,10979,1000,501,19.958,0.0
15590,48666,34,306,34,374,68,35,9.0,0.0
15591,814692,500,5854,500,6854,1000,501,11.708,0.0
15598,9890,18,72,18,126,54,22,4.0,0.0
1560,80419,96,1404,96,1596,192,97,14.625,0.0
15605,8383,17,34,17,85,51,35,2.0,0.0
15609,76478,0,787,0,866,79,80,9.962,0.0
1561,570103,500,9142,500,10142,1000,501,18.284,0.0
1562,445638,500,6000,500,7000,1000,501,12.0,0.0
15621,687052,500,8039,500,9534,1495,502,16.078,0.0
15624,108166,1,4,1,6,2,2,4.0,0.0
15625,1522,0,9,0,10,1,2,9.0,0.0
1563,726518,112,11187,112,11411,224,113,99.884,0.0
1564,3922,2,52,2,56,4,3,26.0,0.0
15641,1993286,2147,3439,2147,15110,11671,1889,2.031,0.8333333333333334
15642,241394,117,191,117,781,590,157,1.592,1.0
15647,8264,0,84,0,104,20,21,4.2,0.0
15648,1951,1,3,1,5,2,2,3.0,0.0
15649,475573,255,5011,255,5521,510,256,19.651,0.0
1565,564848,500,9576,500,10576,1000,501,19.152,0.0
15650,17169,12,216,12,240,24,13,18.0,0.0
15651,150198,142,1844,142,2128,284,143,12.986,0.0
15652,9577,12,120,12,144,24,13,10.0,0.5
15653,1951,1,3,1,5,2,2,3.0,0.0
15658,98854,136,222,136,812,590,179,1.644,0.0
1566,781891,500,12500,500,13500,1000,501,25.0,0.0
15660,7590,4,19,4,46,27,28,1.462,0.0
1567,853635,500,13170,500,14170,1000,501,26.34,0.0
1568,521000,500,8000,500,9000,1000,501,16.0,0.0
15681,70290585,34595,61233,34595,289907,228674,32716,15.048000000000002,0.5
1569,874500,500,14671,500,15671,1000,501,29.342,0.0
1570,502834,500,6677,500,7677,1000,501,13.354,0.0
1571,781891,500,12500,500,13500,1000,501,25.0,0.0
1572,208412,181,3334,181,3696,362,182,18.42,0.0
15729,7600302,3916,6682,3916,30619,23937,3743,3.762,0.8333333333333334
1573,427503,500,6887,500,7887,1000,501,13.774,0.0
15730,1552321,820,1457,820,6511,5054,920,3.4699999999999998,0.8333333333333334
1574,12913,14,224,14,252,28,15,16.0,0.0
15748,878401,471,908,471,3776,2868,623,3.37,1.0
1577,384117,296,7399,296,7991,592,297,24.997,0.0
1578,1729392,500,29191,500,30191,1000,501,58.382,0.0
15784,116938,117,217,117,900,683,170,1.669,1.0
1579,406464,296,6284,296,6876,592,297,21.23,0.0
1580,936495,500,15482,500,16482,1000,501,30.964,0.0
1581,142327,296,1776,296,2368,592,297,6.0,0.0
15812,3351,0,28,0,35,7,8,4.0,0.0
1583,1662929,500,28337,500,29337,1000,501,56.674,0.0
1584,403854,296,6201,296,6793,592,297,20.949,0.0
1585,695817,500,11457,500,12457,1000,501,22.914,0.0
15853,263578,945,1934,945,4205,2271,832,3.358,0.0
15854,99474,425,899,425,1545,646,248,4.124,0.0
15856,89491,204,820,204,1262,442,257,4.02,0.0
15857,12547,30,120,30,180,60,61,4.0,0.0
15858,311978,1,5110,1,8823,3713,3286,1.835,0.0
15859,1232364,5395,16185,5395,21580,5395,5396,3.0,0.0
1586,997643,500,16649,500,17649,1000,501,33.298,0.0
15860,14362,90,90,90,233,143,86,3.0,0.0
15863,3623924,9622,37708,9622,56796,19088,9476,3.984,0.0
15865,5413,24,72,24,96,24,25,3.0,0.0
15866,46943,268,601,268,957,356,157,4.485,0.0
15868,23922501,62773,250178,62773,375312,125134,62587,16.063000000000002,0.0
15869,1107108,3013,11362,3013,17158,5796,2901,3.921,0.0
15870,2136,4,12,4,24,12,13,3.0,0.0
15872,53708,264,462,264,975,513,312,3.5,0.0
15873,37563,236,354,236,746,392,209,3.0,0.0
15874,17127,1,267,1,448,181,182,1.894,0.0
15877,1286,4,3,4,10,7,8,3.0,0.0
15878,17734,41,134,41,266,132,86,3.268,0.0
1588,1141529,500,18958,500,19958,1000,501,37.916,0.0
15880,2278,15,15,15,35,20,13,3.0,0.0
15881,198245,416,1711,416,2543,832,442,7.749,0.0
15882,207420,436,1789,436,2661,872,464,7.727,0.0
15884,201713,425,1721,425,2571,850,453,7.723,0.0
15885,206801,436,1765,436,2637,872,465,7.713,0.0
15886,979,5,5,5,10,5,6,1.0,0.0
15887,12466,19,88,19,126,38,25,9.244,0.0
15888,12692,19,92,19,130,38,25,9.689,0.0
1589,109691,30,1822,30,1882,60,31,60.733,0.0
15890,12546,19,89,19,127,38,25,9.378,0.0
15892,11458,19,88,19,125,37,31,9.256,0.0
15895,10584,19,78,19,115,37,23,4.105,0.0
15900,10806,18,83,18,119,36,22,4.611,0.0
15901,10157,17,77,17,111,34,21,4.529,0.0
15902,9724,16,75,16,107,32,20,4.688,0.0
15903,176234,608,1313,608,2499,1186,637,2.468,0.0
15905,89179,1,1579,1,2454,875,876,1.976,0.0
15907,42029,196,588,196,784,196,197,3.0,0.0
15908,12183,1,193,1,330,137,138,1.874,0.0
15909,2752,18,18,18,42,24,15,3.0,0.0
15910,39717,80,239,80,482,243,148,2.987,0.0
15911,2591486,757,69447,757,70961,1514,1515,91.74,0.0
15913,2622481,757,69885,757,71399,1514,1515,92.318,0.0
15914,2604145,753,69364,753,70870,1506,1507,92.117,0.0
15915,86481,208,681,208,1201,520,305,3.274,0.0
15916,1822,9,9,9,21,12,9,3.0,0.0
15918,61086,1,1029,1,1774,745,743,1.841,0.0
15920,1239,6,6,6,14,8,7,3.0,0.0
15923,61512,521,1186,521,1707,521,207,5.814,0.0
15925,36032,102,306,102,561,255,178,3.0,0.0
15926,1168267,4405,7315,4405,16102,8787,4408,2.72,0.0
15927,12361,50,135,50,205,70,34,4.5,0.0
15928,451243,1752,4380,1752,7008,2628,896,5.0,0.0
1593,454219,0,9000,0,9500,500,501,18.0,0.0
15930,6657737,15269,61110,15269,106930,45820,31449,4.002,0.0
15931,108582519,341182,341183,341182,909816,568633,113942,36.0,0.0
15932,108149837,340084,340085,340084,906887,566802,113576,36.0,0.0
15933,113461192,347641,347642,347641,927038,579396,116097,36.0,0.0
15934,107089036,351535,351536,351535,937422,585886,117395,36.0,0.0
15935,120355828,375307,375308,375307,1000814,625506,125327,39.0,0.0
15936,105920941,336613,336614,336613,897634,561020,112421,36.0,0.0
15937,101266261,320392,320393,320392,854378,533985,107002,33.0,0.0
15938,115595081,364576,364577,364576,972197,607620,121744,39.0,0.0
15939,108401991,345163,345164,345163,920432,575268,115273,36.0,0.0
1594,451344,0,9000,0,9500,500,501,18.0,0.0
15940,118471937,366169,366170,366169,976447,610277,122274,39.0,0.0
15941,121487054,377923,377924,377923,1007789,629865,126196,39.0,0.0
15942,111276582,344797,344798,344797,919455,574657,115513,36.0,0.0
15943,8914,16,79,16,110,31,18,4.938,0.0
15944,8911,16,79,16,110,31,18,4.938,0.0
15945,30278,53,251,53,352,101,63,23.566000000000003,0.0
15946,22012,42,204,42,283,79,44,4.857,0.0
15947,9469,17,84,17,117,33,19,4.941,0.0
15948,9685,19,94,19,131,37,21,4.947,0.0
15949,9703,19,94,19,131,37,21,4.947,0.0
15950,17356,23,132,23,155,23,24,5.739,0.0
15952,399839,1442,2930,1442,5811,2881,1773,2.032,0.0
15953,2023,5,15,5,25,10,11,3.0,0.0
15954,9434,1,163,1,272,109,110,1.918,0.0
15955,74929,372,1055,372,1571,516,239,5.672,0.0
15956,1936816,5313,21202,5313,31818,10616,5316,3.998,0.0
15957,1352573,3604,14332,3604,21526,7194,3607,3.992,0.0
15958,900250,1957,7827,1957,11769,3942,2009,4.051,0.0
15959,952764,2069,8275,2069,12441,4166,2121,4.048,0.0
15960,5745447,15365,61425,15365,92179,30754,15407,8.0,0.0
15961,5839,22,66,22,110,44,35,3.0,0.0
15962,1387,6,9,6,18,9,8,3.0,0.0
15963,1255,3,3,3,9,6,7,3.0,0.0
15968,57070176,3244,194413,3244,203745,9332,3561,60.527,0.0
15969,1375632,861,6620,861,9752,3132,2170,8.841000000000001,0.0
15970,4715810,5614,16842,5614,44912,28070,16880,3.0,0.0
15976,1558227,3336,8816,3336,13820,5004,3348,20.0,0.0
15977,1557633,3336,8816,3336,13820,5004,3348,20.0,0.0
15978,1666674,3336,8816,3336,13820,5004,3348,20.0,0.0
15979,57070176,3244,194413,3244,203745,9332,3561,60.527,0.0
15980,1375632,861,6620,861,9752,3132,2170,8.841000000000001,0.0
1600,6039,0,72,0,81,9,10,8.0,0.0
1602,87465,0,880,0,970,90,91,9.778,0.0
16021,263578,945,1934,945,4205,2271,832,3.358,0.0
16034,445738,661,1707,661,4027,2320,1296,391.883,0.0
16035,347435,602,1369,602,3308,1939,856,53.882999999999996,0.0
16036,347434,602,1369,602,3308,1939,856,53.882999999999996,0.0
16037,347504,602,1369,602,3308,1939,856,53.882999999999996,0.0
16038,349454,604,1384,604,3327,1943,862,68.883,0.0
16039,374445,633,1556,633,3588,2032,980,240.883,0.0
16040,347575,602,1370,602,3309,1939,856,54.882999999999996,0.0
16041,347458,602,1369,602,3308,1939,856,53.883,0.0
16042,347554,602,1370,602,3309,1939,856,54.882999999999996,0.0
16043,347554,602,1370,602,3309,1939,856,54.882999999999996,0.0
16044,345019,598,1354,598,3284,1930,843,38.882999999999996,0.0
16045,345019,598,1354,598,3284,1930,843,38.882999999999996,0.0
16046,505576,705,1977,705,4518,2541,1561,661.883,0.0
16047,345019,598,1354,598,3284,1930,843,38.882999999999996,0.0
16048,345019,598,1354,598,3284,1930,843,38.882999999999996,0.0
16049,345019,598,1354,598,3284,1930,843,38.882999999999996,0.0
16050,419217,680,1821,680,3983,2162,1157,505.883,1.0
16051,347573,602,1370,602,3309,1939,856,54.882999999999996,0.0
16052,360281,617,1452,617,3436,1984,916,136.883,0.5
16053,359552,614,1449,614,3424,1975,904,133.883,0.0
16054,347427,602,1369,602,3308,1939,856,53.882999999999996,0.0
16055,347897,602,1370,602,3310,1940,857,54.882999999999996,0.0
16056,347903,602,1370,602,3310,1940,857,54.882999999999996,0.0
16057,348832,603,1376,603,3319,1943,861,60.882999999999996,0.0
16058,347955,602,1370,602,3310,1940,857,54.883,0.0
16059,347913,602,1369,602,3310,1941,858,53.882999999999996,0.0
1606,433032,0,9000,0,9500,500,501,18.0,0.0
16060,347709,602,1370,602,3310,1940,857,54.882999999999996,0.0
16061,347689,602,1370,602,3310,1940,857,54.882999999999996,0.5
16062,347210,601,1367,601,3304,1937,853,51.882999999999996,1.0
16063,348558,603,1373,603,3317,1944,862,57.882999999999996,1.0
16064,347516,601,1369,601,3306,1937,853,53.882999999999996,0.0
16065,347659,602,1371,602,3310,1939,856,55.882999999999996,0.5
16066,347635,602,1370,602,3309,1939,856,54.882999999999996,0.5
16067,347818,602,1369,602,3308,1939,856,53.882999999999996,0.0
16068,347427,602,1369,602,3308,1939,856,53.882999999999996,0.0
16069,347731,602,1369,602,3308,1939,856,53.883,0.0
16070,347632,602,1369,602,3308,1939,856,53.882999999999996,0.0
16072,377709,632,1546,632,3579,2033,980,230.883,0.0
16073,350351,605,1388,605,3336,1948,868,72.88300000000001,0.0
16074,347511,602,1369,602,3308,1939,856,53.882999999999996,0.5
16075,365208,622,1490,622,3489,1999,936,174.883,0.5
16076,350525,604,1375,604,3330,1955,874,59.882999999999996,0.0
16077,348834,603,1379,603,3321,1942,860,63.882999999999996,1.0
16078,349635,604,1384,604,3329,1945,864,68.883,0.5
16079,831686,500,21816,500,23316,1500,1002,43.632,0.0
16080,218577,51,5536,51,5638,102,52,108.549,0.0
16081,449451,500,9475,500,10975,1500,1002,18.95,0.0
16082,239132,51,6834,51,6936,102,52,134.0,0.0
16083,220251,51,6222,51,6324,102,52,122.0,0.0
16084,355451,51,10042,51,10144,102,52,196.902,0.0
16086,220235,51,6222,51,6324,102,52,122.0,0.0
16087,351807,51,9936,51,10038,102,52,194.824,0.0
16088,220228,51,6222,51,6324,102,52,122.0,0.0
16089,355126,51,10037,51,10139,102,52,196.804,0.0
16090,351807,51,9936,51,10038,102,52,194.824,0.0
16091,221523,51,5661,51,5763,102,52,111.0,0.0
16092,239081,51,6834,51,6936,102,52,134.0,0.0
16093,217485,51,6018,51,6120,102,52,118.0,0.0
16094,217535,51,6018,51,6120,102,52,118.0,0.0
16095,231998,51,5967,51,6069,102,52,117.0,0.0
16096,223216,51,6324,51,6426,102,52,124.0,0.0
16097,361746,51,10251,51,10353,102,52,201.0,0.0
16098,231767,51,5967,51,6069,102,52,117.0,0.0
16099,223461,51,6324,51,6426,102,52,124.0,0.0
1610,326354,500,3511,500,4511,1000,501,7.022,0.0
16100,238829,51,6834,51,6936,102,52,134.0,0.0
16101,221550,51,5661,51,5763,102,52,111.0,0.0
16102,217489,51,6018,51,6120,102,52,118.0,0.0
16103,1006149,1000,16489,1000,18989,2500,1502,10.993,0.0
16104,213717,56,3918,56,4086,168,114,34.982,0.0
16105,220709,51,5661,51,5763,102,52,111.0,0.0
16106,221488,51,5661,51,5763,102,52,111.0,0.0
16107,239233,51,6834,51,6936,102,52,134.0,0.0
16108,217297,51,6018,51,6120,102,52,118.0,0.0
16109,221645,51,5661,51,5763,102,52,111.0,0.0
16110,778056,500,18499,500,19999,1500,1002,18.499,0.0
16111,213412,51,5660,51,5762,102,52,110.98,0.0
16112,235926,51,6681,51,6783,102,52,131.0,0.0
16113,239241,51,6834,51,6936,102,52,134.0,0.0
16114,365661,51,10353,51,10455,102,52,203.0,0.0
16115,220420,51,6222,51,6324,102,52,122.0,0.0
16116,368515,51,10455,51,10557,102,52,205.0,0.0
16117,218316,51,5538,51,5640,102,52,108.588,0.0
16118,220436,51,6220,51,6322,102,52,121.961,0.0
16119,340045,51,9572,51,9674,102,52,187.686,0.0
16120,209376,51,5914,51,6016,102,52,115.961,0.0
16121,309478,51,8694,51,8796,102,52,170.471,0.0
16122,226933,51,5790,51,5892,102,52,113.529,0.0
16123,209344,51,5914,51,6016,102,52,115.961,0.0
16124,328543,51,9282,51,9384,102,52,182.0,0.0
16125,219848,51,5792,51,5894,102,52,113.569,0.0
16126,209230,51,5912,51,6014,102,52,115.922,0.0
16127,2834245,500,77704,500,79204,1500,1002,77.704,0.0
16128,2771238,500,75922,500,77422,1500,1002,75.922,0.0
16129,58126,57,1191,57,1362,171,116,10.447,0.0
16130,327628,51,9275,51,9377,102,52,181.863,0.0
16131,240074,51,6681,51,6783,102,52,131.0,0.0
16132,239289,51,6834,51,6936,102,52,134.0,0.0
16133,226880,51,5785,51,5887,102,52,113.431,0.0
16134,629250,500,11974,500,13474,1500,1002,11.974,0.0
16135,209270,51,5912,51,6014,102,52,115.922,0.0
16136,15944,0,324,0,342,18,19,18.0,0.0
16137,255323,0,6888,0,6944,56,57,123.0,0.0
16138,778056,500,18499,500,19999,1500,1002,18.499,0.0
16139,323052,51,9278,51,9380,102,52,181.922,0.0
16140,21616,0,234,0,243,9,10,26.0,0.0
16141,323052,51,9278,51,9380,102,52,181.922,0.0
16142,718456,500,16178,500,17678,1500,1002,16.194,0.0
16143,1148799,1000,19999,1000,22652,2653,1655,13.333,0.0
16144,1119520,2000,21715,2000,26215,4500,2502,8.703,0.0
16145,322143,51,8772,51,8874,102,52,172.0,0.0
16146,227071,51,5795,51,5897,102,52,113.627,0.0
16147,2224249,500,43244,500,44744,1500,1002,43.244,0.0
16148,236052,51,6681,51,6783,102,52,131.0,0.0
16149,217494,51,6018,51,6120,102,52,118.0,0.0
1615,67067,65,780,65,910,130,66,12.0,0.0
16150,239132,51,6834,51,6936,102,52,134.0,0.0
16151,221292,51,5661,51,5763,102,52,111.0,0.0
16152,202891,51,5406,51,5508,102,52,106.0,0.0
16153,3229,2,128,2,151,23,23,6.737,0.0
16154,5499,2,225,2,261,36,36,7.258,0.0
16155,3229,2,128,2,151,23,23,6.737,0.0
16157,23471,23,186,23,278,92,27,8.087,0.0
16158,17027,21,159,21,232,73,30,7.571,0.0
16160,411870,500,4998,500,5998,1000,501,9.996,0.5
16162,191369,500,1991,500,2991,1000,501,3.982,0.0
16163,20403,25,200,25,275,75,27,8.0,0.0
16164,282787,500,4000,500,5000,1000,501,8.0,0.0
16166,174729,468,1872,468,2808,936,469,4.0,0.0
16167,13068,22,151,22,195,44,23,6.864,0.0
16169,213528,135,1350,135,1620,270,136,10.0,0.0
16170,20289,9,61,9,97,36,20,6.778,0.0
16171,16862,19,150,19,225,75,25,7.895,0.0
16173,63117,44,839,44,927,88,45,19.068,0.0
16176,7116,7,42,7,63,21,9,6.0,0.0
16180,9686,0,110,0,132,22,23,5.0,0.0
16183,11416,8,64,8,96,32,11,8.0,0.0
16188,2486,2,30,2,34,4,3,15.0,0.0
16189,5800,12,60,12,84,24,13,5.0,0.0
16190,64139,44,770,44,858,88,45,17.5,0.0
16193,1129,1,7,1,9,2,2,7.0,0.0
16194,1550,1,18,1,20,2,2,18.0,0.0
16195,203521,0,2501,0,3001,500,501,5.002,0.0
16197,427961,500,4498,500,5498,1000,501,8.996,0.0
16198,74319,108,1098,108,1314,216,109,10.167,0.0
16199,204944,312,2490,312,3114,624,313,7.981,0.0
1620,39283,115,460,115,690,230,116,4.0,0.0
16203,439678,461,5530,461,6452,922,462,11.996,0.0
16204,200194,500,2500,500,3500,1000,501,5.0,0.0
16205,293453,391,2872,391,3654,782,392,7.345,0.0
16208,23811,22,176,22,264,88,25,8.0,0.0
16209,354170,0,2806,0,3306,500,501,5.612,0.0
1621,1605120,0,35500,0,36000,500,501,71.0,0.5
16210,49469,44,516,44,604,88,45,11.727,0.0
16211,1152627,235,9306,235,9776,470,236,39.6,0.0
16212,2478464,500,19857,500,20857,1000,501,39.714,0.0
16213,18454,13,78,13,130,52,28,6.0,0.0
16214,818621,500,11500,500,12500,1000,501,23.0,0.0
16215,39133,0,468,0,528,60,61,7.8,0.0
16216,306172,0,2936,0,3436,500,501,5.872,0.0
16218,19578,19,152,19,228,76,36,8.0,0.0
1622,182162,0,3087,0,3351,264,265,11.693,0.5
16221,446641,500,6000,500,7000,1000,501,12.0,0.0
16222,308768,0,3000,0,3500,500,501,6.0,0.0
16223,104043,0,994,0,1161,167,168,5.952,0.0
16224,5634,5,40,5,60,20,8,8.0,0.0
16225,90012,142,1136,142,1420,284,143,8.0,0.0
16226,166471,392,1959,392,2743,784,393,4.997,0.0
16229,31203,73,438,73,584,146,74,6.0,0.0
1623,566566,0,9500,0,10000,500,501,19.0,0.0
16230,303172,500,4000,500,5000,1000,501,8.0,0.0
16231,14271,0,175,0,196,21,22,8.333,0.0
16232,1747,1,14,1,16,2,2,14.0,0.0
16233,81204,184,1197,184,1565,368,185,6.505,0.0
16235,4915,0,50,0,55,5,6,10.0,0.0
16236,13844442,500,2500,500,3500,1000,501,5.0,0.0
16239,517682,500,15000,500,16000,1000,501,30.0,0.0
16240,300771,335,3796,335,4466,670,336,11.331,0.0
16241,445335,490,5836,490,6816,980,491,11.91,0.0
16242,1319,1,11,1,13,2,2,11.0,0.0
16246,24020,23,193,23,285,92,26,8.391,0.0
16248,14684,28,196,28,252,56,29,7.0,0.0
16250,3717,5,35,5,45,10,6,7.0,0.0
16252,245421,0,3561,0,4061,500,501,7.122,0.0
16253,4007,5,60,5,70,10,6,12.0,0.0
16255,23337,60,240,60,360,120,61,4.0,0.0
16257,10662,10,195,10,215,20,11,19.5,0.0
16259,20496,19,152,19,228,76,23,8.0,0.0
16261,280221,500,4000,500,5000,1000,501,8.0,0.0
16262,1199,1,10,1,12,2,2,10.0,0.0
16263,474434,500,6000,500,7000,1000,501,12.0,0.0
16264,654736,121,4986,121,5228,242,122,41.207,0.0
16265,334890,0,3000,0,3500,500,501,6.0,0.0
16266,7586,3,19,3,31,12,8,6.333,0.0
16269,57156,92,736,92,920,184,93,8.0,0.0
1627,24773,41,287,41,369,82,42,7.0,0.6666666666666666
16273,52609,0,609,0,731,122,123,4.992,0.0
16275,440620,500,3500,500,4500,1000,501,7.0,0.0
16277,991,1,4,1,6,2,2,4.0,0.0
16279,21691,25,175,25,275,100,48,7.0,0.0
1628,4026,10,30,10,50,20,11,3.0,0.0
16280,196131,43,258,43,429,171,87,6.0,0.0
16282,1028515,500,17175,500,18175,1000,501,34.35,0.0
16287,12869,28,168,28,224,56,29,6.0,0.0
16288,532601,381,3932,381,4694,762,382,10.32,0.0
16289,369462,0,5000,0,5500,500,501,10.0,0.0
1629,1301,2,6,2,10,4,3,3.0,0.0
16290,3108,3,27,3,33,6,4,9.0,0.0
16291,239260,0,3556,0,4056,500,501,7.112,0.0
16292,51028,18,1008,18,1044,36,19,56.0,0.0
16293,447217,500,7907,500,8907,1000,501,15.814,0.0
16294,23748,20,400,20,440,40,21,20.0,0.0
16295,356116,500,6500,500,7500,1000,501,13.0,0.0
16297,458822,500,5993,500,7493,1500,1001,11.986,0.0
16299,143696,0,1799,0,2159,360,361,4.997,0.0
1630,1915,2,18,2,22,4,3,9.0,0.0
16301,498279,500,6307,500,7307,1000,501,12.614,0.0
16302,16794,25,200,25,250,50,26,8.0,0.0
16303,9728,11,123,11,145,22,12,11.182,0.0
16304,83337,174,1044,174,1392,348,175,6.0,0.0
16307,69506,44,275,44,449,174,89,6.25,0.0
16308,27779,57,399,57,513,114,58,7.0,0.0
1631,4312,9,45,9,63,18,10,5.0,0.0
16312,433359,500,3500,500,4500,1000,501,7.0,0.0
16313,292220,500,5000,500,6000,1000,501,10.0,0.0
16314,2355,0,12,0,21,9,10,12.0,0.0
16315,10964,0,202,0,212,10,11,20.2,0.0
16317,13582,8,112,8,128,16,9,14.0,0.0
16319,148738,350,1749,350,2449,700,351,4.997,0.0
1632,1629,3,9,3,15,6,4,3.0,0.0
16320,489460,417,3328,417,4162,834,418,7.981,0.0
16323,214935,0,2197,0,2697,500,501,4.394,0.0
16325,5208,0,36,0,48,12,13,3.0,0.0
16326,2099642,1,6,1,8,2,3,6.0,0.0
16327,1045,1,7,1,9,2,2,7.0,0.0
16328,82124,184,1197,184,1565,368,185,6.505,0.0
1633,7987,11,99,11,121,22,12,9.0,0.0
16330,5274,12,36,12,60,24,13,3.0,0.0
16331,18269,0,215,0,258,43,44,5.0,0.0
16332,299321,394,5122,394,5910,788,395,13.0,0.0
16333,24917,47,281,47,375,94,48,5.979,0.0
16334,15854,25,225,25,275,50,26,9.0,0.0
16336,315402,500,3000,500,4000,1000,501,6.0,0.0
16338,36861,50,332,50,432,100,51,6.64,0.0
1634,273780,500,4067,500,5067,1000,501,8.134,0.0
16340,135417,151,1510,151,1812,302,152,10.0,0.0
16341,55179,0,725,0,819,94,95,7.713,0.0
16343,1568,1,16,1,18,2,2,16.0,0.0
16344,5945,7,84,7,98,14,8,12.0,0.0
16345,387624,265,2385,265,2915,530,266,9.0,0.0
16346,158066,0,1870,0,2244,374,375,5.0,0.0
16347,29653,0,546,0,588,42,43,13.0,0.0
16348,2457511,500,19771,500,20771,1000,501,39.542,0.0
16349,1116,1,5,1,7,2,2,5.0,0.0
1635,209066,10,50,10,70,20,11,5.0,0.0
16351,5048,0,55,0,66,11,12,5.0,0.0
16352,330556,0,2994,0,3494,500,501,5.988,0.0
16355,1157,1,9,1,11,2,2,9.0,0.0
16357,89249,26,749,26,801,52,27,28.808,0.0
16359,47046,66,425,66,659,234,82,6.439,0.0
1636,282248,20,80,20,120,40,21,4.0,0.0
16360,204581,0,2502,0,3002,500,501,5.004,0.0
16361,47668,50,555,50,655,100,51,11.1,0.0
16365,196420,500,2500,500,3500,1000,501,5.0,0.0
16367,26889,29,229,29,342,113,35,7.897,0.0
16368,72279,81,1134,81,1296,162,82,14.0,0.0
1637,267330,17,68,17,102,34,18,4.0,0.0
16370,480624,336,3696,336,4368,672,337,11.0,0.0
16372,5529,3,42,3,48,6,4,14.0,0.0
16373,217339,500,3000,500,4000,1000,501,6.0,0.0
16376,15014,0,192,0,216,24,25,8.0,0.0
16377,107272,0,1003,0,1130,127,128,7.898,0.0
16379,24842,23,185,23,277,92,26,8.043,0.0
1638,228034,19,95,19,133,38,20,5.0,0.0
16380,293648,500,4000,500,5000,1000,501,8.0,0.0
16381,1364596,280,11022,280,11582,560,281,39.364,0.0
16383,1377,1,10,1,12,2,2,10.0,0.0
16384,1754,3,12,3,18,6,4,4.0,0.0
16386,34572,56,448,56,560,112,57,8.0,0.0
16389,35270,59,472,59,590,118,60,8.0,0.0
1639,278269,500,3526,500,4526,1000,501,7.052,0.0
16390,517826,500,8090,500,9090,1000,501,16.18,0.0
16392,128095,500,500,500,1500,1000,501,1.0,0.0
16393,6857,13,65,13,91,26,14,5.0,0.0
16394,205782,257,2296,257,2810,514,258,8.934,0.0
16395,20577,0,230,0,276,46,47,5.0,0.0
16396,127016,0,1480,0,1776,296,297,5.0,0.0
16397,410068,500,5500,500,6500,1000,501,11.0,0.0
16399,9620,0,109,0,123,14,15,7.786,0.0
1640,466003,500,8883,500,9883,1000,501,17.766,0.0
16402,474917,500,4500,500,5500,1000,501,9.0,0.0
16409,1129,1,7,1,9,2,2,7.0,0.0
16410,60878,90,630,90,810,180,92,7.0,0.0
16412,6540,6,48,6,72,24,9,8.0,0.0
16413,7780897,12,84,12,108,24,14,7.0,0.0
16414,93625,0,1105,0,1326,221,222,5.0,0.0
16416,25069,60,300,60,420,120,61,5.0,0.0
16417,19274,0,323,0,342,19,20,17.0,0.0
16418,4513,5,40,5,50,10,6,8.0,0.0
1642,329397,500,4330,500,5330,1000,501,8.66,0.0
16420,13889,10,248,10,268,20,11,24.8,0.0
16421,257102,500,2000,500,3000,1000,501,4.0,0.0
16422,501833,500,7000,500,8000,1000,501,14.0,0.0
16423,226121,436,3052,436,3924,872,437,7.0,0.0
16425,120499,135,2683,135,2953,270,136,19.874,0.0
16426,1141,0,6,0,7,1,2,6.0,0.0
16427,66100,0,795,0,954,159,160,5.0,0.0
16428,13071,22,151,22,195,44,23,6.864,0.0
16429,22526,53,265,53,371,106,54,5.0,0.0
1643,7225,9,90,9,108,18,10,10.0,0.0
16431,30698,44,374,44,462,88,45,8.5,0.0
16432,25569,57,285,57,399,114,58,5.0,0.0
16434,255529,0,2295,0,2677,382,383,6.008,0.0
16435,269649,93,1069,93,1255,186,94,11.495,0.0
16436,1533,2,10,2,14,4,3,5.0,0.0
16438,89063,201,1005,201,1407,402,202,5.0,0.0
1644,23109,27,270,27,324,54,28,10.0,0.0
16442,158888,155,1705,155,2015,310,156,11.0,0.0
16443,10846,25,100,25,150,50,26,4.0,0.0
16445,187716,0,2000,0,2500,500,501,4.0,0.0
16446,14457,20,160,20,220,60,22,8.0,0.0
16447,935957,94,823,94,1011,188,95,8.755,0.0
16449,2216,0,18,0,21,3,4,6.0,0.0
16450,1259678,0,43755,0,44255,500,501,87.51,0.0
16452,204519,0,2000,0,2500,500,501,4.0,0.0
16453,21203,21,168,21,252,84,24,8.0,0.0
16454,5664,4,34,4,50,16,7,8.5,0.0
16458,290091,500,3500,500,4500,1000,501,7.0,0.0
16460,9939,12,130,12,165,35,24,10.833,0.0
16461,3645,3,30,3,36,6,4,10.0,0.0
16462,420220,500,5114,500,6114,1000,501,10.228,0.0
16464,2963,6,24,6,36,12,7,4.0,0.0
16466,1350,1,9,1,11,2,2,9.0,0.0
1647,624134,500,10535,500,11535,1000,501,21.07,0.0
16470,34573,22,132,22,220,88,46,6.0,0.0
16471,417143,500,5500,500,6500,1000,501,11.0,0.0
16472,13105,14,105,14,161,56,17,7.5,0.0
16473,53926,0,721,0,824,103,104,7.0,0.0
16475,25585,52,244,52,348,104,53,4.692,0.0
16476,1077,1,5,1,7,2,2,5.0,0.0
16478,453571,500,5976,500,6976,1000,501,11.952,0.0
16479,5642020,12,84,12,108,24,14,7.0,0.0
1648,589147,500,9776,500,10776,1000,501,19.552,0.0
16480,296995,0,3500,0,4000,500,501,7.0,0.0
16482,118894,0,1405,0,1686,281,282,5.0,0.0
16483,17577,0,180,0,225,45,46,4.0,0.0
16484,17883,23,230,23,299,69,47,10.0,0.0
16485,8955,0,95,0,114,19,20,5.0,0.0
16486,6243,14,70,14,98,28,15,5.0,0.0
16487,7047,0,89,0,102,13,14,6.846,0.0
16488,10803,0,153,0,170,17,18,9.0,0.0
1649,629640,500,10636,500,11636,1000,501,21.272,0.0
16491,2667,4,24,4,32,8,5,6.0,0.0
16494,4702,0,45,0,54,9,10,5.0,0.0
16496,8332,0,84,0,90,6,7,14.0,0.0
16499,84359,174,1044,174,1392,348,175,6.0,0.0
1650,144992,236,2174,236,2646,472,237,9.212,0.0
16500,441318,500,7861,500,8861,1000,501,15.722,0.0
16501,5020,9,54,9,72,18,10,6.0,0.0
16502,1778,2,17,2,21,4,3,8.5,0.0
16504,1413,2,10,2,14,4,3,5.0,0.0
16505,10811,0,115,0,124,9,10,12.778,0.0
16506,349812,500,5000,500,6000,1000,501,10.0,0.0
16507,176020,399,1995,399,2793,798,400,5.0,0.0
16508,112019,180,1440,180,1800,360,181,8.0,0.0
16509,301518,0,4000,0,4500,500,501,8.0,0.0
1651,630114,500,10646,500,11646,1000,501,21.292,0.0
16510,1959,2,24,2,28,4,3,12.0,0.0
16511,381096,500,5882,500,6882,1000,501,11.764,0.0
16512,367064,0,3680,0,4180,500,501,7.36,0.0
16514,9554,0,99,0,110,11,12,9.0,0.0
16517,14643,0,162,0,189,27,28,6.0,0.0
16518,15765,30,143,30,203,60,31,4.767,0.0
1652,634834,500,10686,500,11686,1000,501,21.372,0.0
16520,914420,101,16867,101,17069,202,102,167.0,0.0
16521,89916,0,1015,0,1218,203,204,5.0,0.0
16522,24249,52,244,52,348,104,53,4.692,0.0
16524,2455,3,32,3,38,6,4,10.667,0.0
16526,35550,30,330,30,390,60,31,11.0,0.0
16528,3937523,51,612,51,714,102,52,12.0,0.0
16530,78286,162,972,162,1296,324,163,6.0,0.0
16531,35265,0,435,0,522,87,88,5.0,0.0
16532,134974,0,1595,0,1914,319,320,5.0,0.0
16533,434977,500,5809,500,6809,1000,501,11.618,0.0
16534,152577,0,1394,0,1513,119,120,11.714,0.0
16535,116781,0,1360,0,1632,272,273,5.0,0.0
16536,206575,0,2467,0,2967,500,501,4.934,0.0
16537,146366,148,1712,148,2008,296,149,11.568,0.0
16538,15432,30,143,30,203,60,31,4.767,0.0
16539,84561,174,1044,174,1392,348,175,6.0,0.0
16541,2223,0,18,0,21,3,4,6.0,0.0
16542,329611,0,3000,0,3500,500,501,6.0,0.0
16543,459510,500,5497,500,6497,1000,501,10.994,0.0
16544,105623,181,1448,181,1810,362,182,8.0,0.0
16545,211776,500,3000,500,4000,1000,501,6.0,0.0
16546,652532,500,11500,500,12500,1000,501,23.0,0.0
16548,18743,19,152,19,228,76,22,8.0,0.0
16549,163465,131,1572,131,1834,262,132,12.0,0.0
1655,144992,236,2174,236,2646,472,237,9.212,0.0
16551,6647,0,70,0,77,7,8,10.0,0.0
16552,50105,45,385,45,565,180,49,8.556,0.0
16554,256879,500,3500,500,4500,1000,501,7.0,0.0
16555,448674,500,5490,500,6490,1000,501,10.98,0.0
16556,324320,0,4500,0,5000,500,501,9.0,0.0
16557,2009,1,21,1,23,2,2,21.0,0.0
16558,20930,30,300,30,360,60,31,10.0,0.0
16559,552858,500,9920,500,10920,1000,501,19.84,0.0
1656,239708,500,2818,500,3818,1000,501,5.636,0.5
16560,307709,227,4061,227,4515,454,228,17.89,0.0
16561,2558238,500,19967,500,20967,1000,501,39.934,0.0
16562,12191,11,209,11,231,22,12,19.0,0.0
16564,8737,20,100,20,140,40,21,5.0,0.0
16565,88693,26,749,26,801,52,27,28.808,0.0
16566,89104,0,1065,0,1158,93,94,11.452,0.0
16567,71906,109,763,109,981,218,110,7.0,0.0
16568,2553161,500,19989,500,20989,1000,501,39.978,0.0
16569,4532,9,45,9,63,18,10,5.0,0.0
16570,61090,0,1044,0,1102,58,59,18.0,0.0
16571,258178,301,3010,301,3612,602,302,10.0,0.0
16573,50751,0,570,0,684,114,115,5.0,0.0
16574,1067,1,6,1,8,2,2,6.0,0.0
16575,11155,9,54,9,90,36,20,6.0,0.0
16576,264151,0,3770,0,4270,500,501,7.54,0.0
16577,1220572,251,9863,251,10365,502,252,39.295,0.0
16578,287787,500,4000,500,5000,1000,501,8.0,0.0
1658,9013,11,121,11,143,22,12,11.0,0.0
16580,39398,36,973,36,1045,72,37,27.028,0.0
16581,320266,500,4989,500,5989,1000,501,9.978,0.0
16582,12565,11,198,11,220,22,12,18.0,0.0
16583,1527,2,10,2,14,4,3,5.0,0.0
16584,367772,0,3380,0,3880,500,501,6.76,0.0
16585,4309,5,40,5,50,10,6,8.0,0.0
16586,3894,6,36,6,48,12,7,6.0,0.0
1659,30268,54,324,54,432,108,55,6.0,0.0
16590,212071,0,2000,0,2500,500,501,4.0,0.0
16591,384590,500,3490,500,4990,1500,503,6.98,0.0
16592,306349,39,2880,39,2958,78,40,73.846,0.0
16593,354450,0,4000,0,4500,500,501,8.0,0.0
16594,214308,0,2497,0,2997,500,501,4.994,0.0
16596,3003,2,28,2,32,4,3,14.0,0.0
16597,12095,4,41,4,49,8,5,10.25,0.0
16598,2564257,500,19985,500,20985,1000,501,39.97,0.0
1660,95609,143,1285,143,1571,286,144,8.986,0.0
16600,455472,500,5942,500,6942,1000,501,11.884,0.0
16602,1123716,230,9100,230,9560,460,231,39.565,0.0
16603,14385,0,198,0,231,33,34,6.0,0.0
16604,1208756,0,40306,0,40806,500,501,80.612,0.0
16606,4846,8,56,8,72,16,9,7.0,0.0
16607,500055,500,12353,500,13353,1000,501,24.706,0.0
16608,1040373,500,16707,500,17707,1000,501,33.414,0.0
16609,399918,500,4940,500,5940,1000,501,9.88,0.0
16610,15932,18,134,18,203,69,24,7.444,0.0
16611,27324,0,325,0,390,65,66,5.0,0.0
16612,80787,162,972,162,1296,324,163,6.0,0.0
16614,17060,18,180,18,216,36,19,10.0,0.0
16615,8599,12,96,12,120,24,13,8.0,0.0
16617,7086,0,80,0,96,16,17,5.0,0.0
16618,1328,1,8,1,10,2,2,8.0,0.0
16619,2875,2,28,2,32,4,3,14.0,0.0
16623,53733,0,852,0,897,45,46,18.933,0.0
16625,92685,0,1110,0,1332,222,223,5.0,0.0
16626,463248,500,5500,500,6500,1000,501,11.0,0.0
16627,63341,0,763,0,878,115,116,6.635,0.0
16628,325511,0,3000,0,3500,500,501,6.0,0.0
16629,9729,10,170,10,190,20,11,17.0,0.0
16632,401890,246,2460,246,2952,492,247,10.0,0.0
16633,52866,44,488,44,576,88,45,11.091,0.0
16634,48881,110,550,110,770,220,111,5.0,0.0
16635,13857,0,252,0,266,14,15,18.0,0.0
16638,500066,0,13936,0,14070,134,135,104.0,0.0
1664,169230,278,1173,278,1857,684,407,4.219,0.5
16641,293931,500,5000,500,6000,1000,501,10.0,0.0
16643,6379,5,105,5,115,10,6,21.0,0.0
16645,1423,0,15,0,16,1,2,15.0,0.0
16648,73172,81,810,81,972,162,82,10.0,0.0
16649,97776,85,655,85,989,334,130,7.706,0.0
1665,75728,40,635,40,753,118,75,15.875,0.75
16651,403094,0,4500,0,5000,500,501,9.0,0.0
16654,90913,144,1112,144,1400,288,145,7.722,0.0
16655,4736,6,48,6,60,12,7,8.0,0.0
16656,190105,199,2058,199,2654,596,219,10.342,0.0
16657,340744,500,5706,500,6706,1000,501,11.412,0.0
1666,645149,1000,9182,1000,11182,2000,1002,9.182,0.0
16660,45709,0,484,0,605,121,122,4.0,0.0
16661,372456,0,4597,0,5073,476,477,9.658,0.0
16662,2653562,500,20044,500,21044,1000,501,40.088,0.0
16663,1742,1,15,1,17,2,2,15.0,0.0
16665,317161,0,3000,0,3500,500,501,6.0,0.0
16666,23985,31,399,31,461,62,32,12.871,0.0
16667,179081,0,2406,0,2604,198,199,12.152,0.0
16668,4759,4,20,4,35,15,9,5.0,0.0
16669,5495,5,25,5,50,25,17,5.0,0.0
1667,535123,500,8726,500,9726,1000,501,17.452,0.5
16670,389472,500,3987,500,4987,1000,501,7.974,0.0
16671,71035,102,741,102,945,204,103,7.265,0.0
16672,13614,32,160,32,224,64,33,5.0,0.0
16673,8547,20,60,20,100,40,21,3.0,0.0
16676,7082,0,80,0,96,16,17,5.0,0.0
16679,1084336,0,31159,0,31659,500,501,62.318,0.0
16681,21199,13,116,13,168,52,16,8.923,0.0
16682,38997,0,354,0,406,52,53,6.808,0.0
16683,209219,0,2500,0,3000,500,501,5.0,0.0
16685,989,1,5,1,7,2,2,5.0,0.0
16686,202386,500,2184,500,3184,1000,501,4.368,0.0
16687,9762,4,28,4,44,16,10,7.0,0.0
16688,146677,238,1428,238,1904,476,239,6.0,0.0
1669,477361,0,7661,0,8161,500,501,15.322,0.0
16691,3183,4,44,4,52,8,5,11.0,0.0
16694,222099,0,3000,0,3500,500,501,6.0,0.0
16695,13537,0,161,0,193,32,33,5.031,0.0
16697,46383,59,397,59,601,204,68,6.729,0.0
16698,197578,0,2108,0,2441,333,334,6.33,0.0
16699,256884,481,2878,481,3840,962,482,5.983,0.0
1670,382474,0,5000,0,5500,500,501,10.0,0.5
16700,415471,486,5246,486,6218,972,487,10.794,0.0
16702,15639,30,143,30,203,60,31,4.767,0.0
16703,1316,1,10,1,12,2,2,10.0,0.0
16705,920742,0,23000,0,23500,500,501,46.0,0.0
16706,26090,24,371,24,432,61,37,15.458,0.0
16707,13041,22,149,22,193,44,23,6.773,0.0
16708,1096,1,6,1,8,2,2,6.0,0.0
16709,25075,13,241,13,283,42,30,18.538,0.0
1671,260174,500,3500,500,4500,1000,501,7.0,0.0
16710,251910,0,3591,0,4091,500,501,7.182,0.0
16711,63893,0,588,0,686,98,99,6.0,0.0
16712,34584,83,332,83,498,166,84,4.0,0.0
16714,177048,237,2136,237,2617,481,245,9.013,0.0
16715,235951,500,3000,500,4000,1000,501,6.0,0.0
16716,7183,0,80,0,96,16,17,5.0,0.0
16717,1487,1,13,1,15,2,2,13.0,0.0
16718,78287,162,972,162,1296,324,163,6.0,0.0
16719,74963,0,993,0,1103,110,111,9.027,0.0
1672,398935,500,5026,500,6026,1000,501,10.052,0.0
16721,279467,239,4596,239,5270,674,339,19.23,0.0
16722,268700,500,2668,500,3668,1000,501,5.336,0.0
16723,1265,1,11,1,13,2,2,11.0,0.0
16724,6603,5,70,5,80,10,6,14.0,0.0
16725,359867,0,3000,0,3500,500,501,6.0,0.0
16726,3369,6,30,6,42,12,7,5.0,0.0
16728,1821543,0,59453,0,59953,500,501,118.906,0.0
1673,566025,0,9832,0,10332,500,501,19.664,0.0
16730,2013,0,15,0,16,1,2,15.0,0.0
16732,23734,0,248,0,310,62,63,4.0,0.0
16734,5972,4,47,4,63,16,11,11.75,0.0
16735,1824,1,9,1,11,2,2,9.0,0.0
16736,25354,52,244,52,348,104,53,4.692,0.0
16737,5373,3,42,3,48,6,4,14.0,0.0
16738,51989,42,252,42,418,166,84,6.0,0.0
16739,3450,7,28,7,42,14,8,4.0,0.0
1674,558874,0,9680,0,10180,500,501,19.36,0.0
16740,223230,261,2599,261,3121,522,262,9.958,0.0
16741,1557852,0,46209,0,46709,500,501,92.418,0.0
16742,6196,7,70,7,84,14,8,10.0,0.0
16743,209205,0,2500,0,3000,500,501,5.0,0.0
16744,111639,105,837,105,1047,210,106,7.971,0.0
16745,316342,500,2945,500,3945,1000,501,5.89,0.0
16747,64692,0,813,0,889,76,77,21.395,0.0
16748,1102,1,7,1,9,2,2,7.0,0.0
16749,204021,39,2880,39,2958,78,40,73.846,0.0
1675,358670,0,4585,0,5085,500,501,9.17,0.0
16750,2576,2,12,2,20,8,6,6.0,0.0
16751,324787,0,3012,0,3512,500,501,6.024,0.0
16753,107899,153,1354,153,1660,306,154,8.85,0.0
16755,81416,162,972,162,1296,324,163,6.0,0.0
16756,1806,2,19,2,23,4,3,9.5,0.0
16757,404804,257,4271,257,4785,514,258,16.619,0.0
16759,7567,7,112,7,126,14,8,16.0,0.0
1676,240139,500,2500,500,3500,1000,501,5.0,0.0
16761,54682,115,690,115,920,230,116,6.0,0.0
16762,30186,68,340,68,476,136,69,5.0,0.0
16765,481982,500,6000,500,7000,1000,501,12.0,0.0
16766,370931,0,4060,0,4560,500,501,8.12,0.0
16768,221603,500,2500,500,3500,1000,501,5.0,0.0
16769,4323,4,64,4,72,8,5,16.0,0.0
1677,564078,0,9845,0,10345,500,501,19.69,0.0
16770,67547,75,648,75,798,150,76,8.64,0.0
16771,81243,113,1347,113,1573,226,114,11.92,0.0
16772,22665,0,272,0,327,55,56,4.945,0.0
16773,48866,44,544,44,632,88,45,12.364,0.0
16775,7897,0,78,0,91,13,14,6.0,0.0
16776,263881,500,2188,500,3188,1000,501,4.376,0.0
16778,81204,184,1197,184,1565,368,185,6.505,0.0
16779,511601,500,5496,500,6496,1000,501,10.992,0.0
1678,635692,0,11063,0,11563,500,501,22.126,0.0
16780,429919,500,3668,500,4668,1000,501,7.336,0.0
16781,304969,38,2878,38,2954,76,39,75.737,0.0
16783,305735,39,2880,39,2958,78,40,73.846,0.0
16785,336408,500,4500,500,5500,1000,501,9.0,0.0
16786,1557,1,11,1,13,2,2,11.0,0.0
16787,91396,118,954,118,1190,236,119,8.085,0.0
16788,105274,0,1079,0,1214,135,136,7.993,0.0
16789,13502,19,152,19,190,38,20,8.0,0.0
1679,530629,0,7722,0,8222,500,501,15.444,0.0
16790,55291,62,566,62,690,124,63,9.129,0.0
16791,359135,0,3000,0,3500,500,501,6.0,0.0
16793,1536,2,10,2,14,4,3,5.0,0.0
16794,6236,0,70,0,84,14,15,5.0,0.0
16795,162409,0,1504,0,1623,119,120,12.639,0.0
16797,7160,0,80,0,96,16,17,5.0,0.0
1680,560524,0,9855,0,10355,500,501,19.71,0.0
16800,34797,45,313,45,459,146,49,6.956,0.0
16801,11120,0,97,0,104,7,8,13.857,0.0
16804,7581,0,90,0,103,13,14,6.923,0.0
16805,365393,0,3500,0,4000,500,501,7.0,0.0
16806,609859,281,5814,281,6376,562,282,20.69,0.0
16807,54054,58,923,58,1039,116,59,15.914,0.0
16808,143689,234,1872,234,2340,468,235,8.0,0.0
16809,11798,25,100,25,150,50,26,4.0,0.0
1681,519963,500,9578,500,10578,1000,501,19.156,0.0
16810,2118,4,16,4,24,8,5,4.0,0.0
16811,33120,0,395,0,474,79,80,5.0,0.0
16812,5324,4,56,4,64,8,5,14.0,0.0
16814,12760,8,224,8,240,16,9,28.0,0.0
16815,449223,500,5980,500,6980,1000,501,11.96,0.0
16817,82271,64,320,64,512,192,67,5.0,0.0
16818,211456,0,2500,0,3000,500,501,5.0,0.0
16820,81401,0,970,0,1164,194,195,5.0,0.0
16823,83597,184,1197,184,1565,368,185,6.505,0.0
16824,24150,25,200,25,275,75,27,8.0,0.0
16827,269252,0,3956,0,4456,500,501,7.912,0.0
16828,2716,4,24,4,32,8,5,6.0,0.0
16829,15839,10,60,10,100,40,22,6.0,0.0
1683,181996,0,2394,0,2736,342,343,7.0,0.0
16831,147659,143,1397,143,1683,286,144,9.769,0.0
16832,425220,500,7501,500,8501,1000,501,15.002,0.0
16833,204515,500,2000,500,3000,1000,501,4.0,0.0
16834,296734,0,3000,0,3500,500,501,6.0,0.0
16835,98966,0,1382,0,1545,163,164,8.479,0.0
16837,316223,0,3000,0,3500,500,501,6.0,0.0
16838,190595,500,2000,500,3000,1000,501,4.0,0.0
16839,9623,10,153,10,173,20,11,15.3,0.0
1684,6879,12,72,12,96,24,13,6.0,0.0
16840,31042,75,300,75,450,150,76,4.0,0.0
16841,4500,5,65,5,75,10,6,13.0,0.0
16842,41518,0,497,0,597,100,101,4.97,0.0
16844,183713,500,2000,500,3000,1000,501,4.0,0.0
16846,25924,58,290,58,406,116,59,5.0,0.0
16847,88975,0,1056,0,1271,215,216,4.912,0.0
16848,188884,500,2500,500,3500,1000,501,5.0,0.0
16849,4294,6,54,6,66,12,7,9.0,0.0
1685,358942,0,6311,0,6811,500,501,12.622,0.0
16851,1420,1,12,1,14,2,2,12.0,0.0
16852,2398501,500,19759,500,20759,1000,501,39.518,0.0
16853,22831,23,161,23,253,92,48,7.0,0.0
16855,6244,6,48,6,72,24,9,8.0,0.0
16856,24216,52,244,52,348,104,53,4.692,0.0
16857,220613,0,2500,0,3000,500,501,5.0,0.0
16858,28613,58,342,58,458,116,59,5.897,0.0
16859,259729,500,3000,500,4000,1000,501,6.0,0.0
1686,566622,0,9903,0,10403,500,501,19.806,0.0
16861,45793,47,531,47,625,94,48,11.298,0.0
16862,462948,500,5487,500,6487,1000,501,10.974,0.0
16863,109660,176,1408,176,1760,352,178,8.0,0.0
16864,11701,15,150,15,180,30,16,10.0,0.0
16865,1265,1,11,1,13,2,2,11.0,0.0
16866,18483,43,172,43,258,86,44,4.0,0.0
16869,546849,500,7500,500,8500,1000,501,15.0,0.0
1687,566166,0,9823,0,10323,500,501,19.646,0.0
16871,7744,5,40,5,60,20,12,8.0,0.0
16872,4840,4,76,4,84,8,5,19.0,0.0
16873,33055,31,247,31,371,124,35,7.968,0.0
16876,4051,3,42,3,48,6,4,14.0,0.0
16877,27402,0,288,0,360,72,73,4.0,0.0
16878,21009,21,268,21,310,42,22,12.762,0.0
1688,566091,0,9804,0,10304,500,501,19.608,0.0
16880,1945,1,7,1,11,4,5,7.0,0.0
16881,5228,0,65,0,73,8,9,8.125,0.0
16883,25379,52,244,52,348,104,53,4.692,0.0
16885,10944,11,132,11,154,22,12,12.0,0.0
16886,2983,0,42,0,44,2,3,21.0,0.0
16887,35139,43,319,43,490,171,58,7.419,0.0
16888,6100,7,52,7,73,21,9,7.429,0.0
16889,1447,0,15,0,16,1,2,15.0,0.0
1689,677050,0,11650,0,12150,500,501,23.3,0.0
16891,330386,500,4998,500,5998,1000,501,9.996,0.0
16892,333651,0,3000,0,3500,500,501,6.0,0.0
16893,1552,1,11,1,13,2,2,11.0,0.0
16894,3718,0,35,0,40,5,6,7.0,0.0
16895,92613,144,1152,144,1440,288,145,8.0,0.0
16897,33080,52,416,52,520,104,53,8.0,0.0
16899,3215,4,44,4,52,8,5,11.0,0.0
1690,960547,970,10664,970,12604,1940,972,10.994,0.0
16900,1210,0,7,0,8,1,2,7.0,0.0
16901,47169,49,547,49,645,98,50,11.163,0.0
16902,5068,0,40,0,45,5,6,8.0,0.0
16905,137483,82,2351,82,2515,164,83,28.671,0.0
16906,1057,1,6,1,8,2,2,6.0,0.0
16907,1729,2,18,2,22,4,3,9.0,0.0
16908,1741,3,12,3,18,6,4,4.0,0.0
16909,231461,0,2718,0,3218,500,501,5.436,0.0
1691,1027872,0,10222,0,10722,500,501,20.444,1.0
16911,289614,0,4000,0,4500,500,501,8.0,0.0
16914,149903,168,1292,168,1946,654,247,7.69,0.0
16915,208163,0,2500,0,3000,500,501,5.0,0.0
16917,26164,0,368,0,414,46,47,8.0,0.0
16919,108427,0,1305,0,1566,261,262,5.0,0.0
16920,71278,50,401,50,601,200,53,8.02,0.0
16921,464246,500,6000,500,7000,1000,501,12.0,0.0
16922,1546,1,11,1,13,2,2,11.0,0.0
16923,81766,174,1044,174,1392,348,175,6.0,0.0
16924,372233,0,5500,0,6000,500,501,11.0,0.0
16925,25092,33,208,33,274,66,34,6.303,0.0
16927,464465,500,6000,500,7000,1000,501,12.0,0.0
16928,384973,500,4993,500,5993,1000,501,9.986,0.0
16929,401858,0,4500,0,5000,500,501,9.0,0.0
16930,2861,6,24,6,36,12,7,4.0,0.0
16933,8752,9,153,9,171,18,10,17.0,0.0
16934,73698,82,820,82,984,164,83,10.0,0.0
16935,509803,133,14098,133,14364,266,134,106.0,0.0
16936,5233,5,52,5,62,10,6,10.4,0.0
16937,20593,31,413,31,475,62,32,13.323,0.0
16938,1403,2,10,2,14,4,3,5.0,0.0
16941,2645,5,20,5,30,10,6,4.0,0.0
16944,455176,500,6095,500,7095,1000,501,12.19,0.0
16945,1714,0,9,0,12,3,4,3.0,0.0
16946,2879,5,30,5,40,10,6,6.0,0.0
16947,2990,2,28,2,32,4,3,14.0,0.0
16949,15181,30,143,30,203,60,31,4.767,0.0
1695,971412,925,9478,925,11328,1850,927,10.246,0.0
16950,912647,0,23000,0,23500,500,501,46.0,0.0
16951,33588,0,375,0,450,75,76,5.0,0.0
16952,4599,4,40,4,48,8,5,10.0,0.0
16953,17291,38,266,38,342,76,40,7.0,0.0
16954,1167,0,8,0,9,1,2,8.0,0.0
16955,39828,66,462,66,594,132,67,7.0,0.0
16956,25298,44,278,44,366,88,45,6.318,0.0
16957,617317,500,8882,500,9882,1000,501,17.764,0.0
16958,13864,9,113,9,165,52,32,12.556,0.0
16959,883542,500,16500,500,17500,1000,501,33.0,0.0
1696,946920,909,11954,909,13772,1818,911,13.151,0.0
16960,326985,0,3000,0,3500,500,501,6.0,0.0
16961,3664,0,36,0,39,3,4,12.0,0.0
16965,10165,14,124,14,152,28,15,8.857,0.0
16966,83438,102,714,102,918,204,103,7.0,0.0
16967,54579,44,872,44,960,88,45,19.818,0.0
16968,317804,0,3000,0,3500,500,501,6.0,0.0
16969,15713,20,220,20,260,40,21,11.0,0.0
1697,291871,0,5000,0,5500,500,501,10.0,0.0
16970,12240,10,200,10,220,20,11,20.0,0.0
16971,83859,174,1044,174,1392,348,175,6.0,0.0
16973,10276,23,115,23,161,46,24,5.0,0.0
16974,1245,1,11,1,13,2,2,11.0,0.0
16975,211342,0,2500,0,3000,500,501,5.0,0.0
16976,359409,391,4689,391,5471,782,392,11.992,0.0
16978,2036,4,12,4,20,8,5,3.0,0.0
1698,209548,500,3500,500,4500,1000,501,7.0,1.0
16980,6794,6,62,6,74,12,7,10.333,0.0
16982,203776,0,2500,0,3000,500,501,5.0,0.0
16983,246692,0,3764,0,4264,500,501,7.528,0.0
16984,606389,500,4000,500,5413,1413,914,8.0,0.0
16985,1040,1,7,1,9,2,2,7.0,0.0
16987,1922,1,6,1,10,4,4,6.0,0.0
16988,1544,2,12,2,16,4,3,6.0,0.0
16989,214473,0,2500,0,3000,500,501,5.0,0.0
1699,248121,500,3208,500,4208,1000,501,6.416,1.0
16994,982717,388,14819,388,15595,776,389,38.193,0.0
16995,5694,6,72,6,84,12,7,12.0,0.0
16996,203270,0,2501,0,3001,500,501,5.002,0.0
16997,195010,0,1701,0,2201,500,501,3.402,0.0
16999,448584,500,7993,500,8993,1000,501,15.986,0.0
1700,341798,610,4665,610,5885,1220,612,7.648,0.0
17002,18989,0,323,0,342,19,20,17.0,0.0
17003,113298,196,1764,196,2156,392,197,9.0,0.0
17004,17895,27,189,27,243,54,28,7.0,0.0
17005,34603,0,415,0,498,83,84,5.0,0.0
17010,2614043,500,19952,500,20952,1000,501,39.904,0.0
17011,7224,12,103,12,127,24,13,8.583,0.0
17012,1062,1,7,1,9,2,2,7.0,0.0
17013,1337184,500,17772,500,19596,1824,1087,35.544,0.0
17014,4089,2,21,2,25,4,3,10.5,0.0
17015,78441,85,850,85,1020,170,86,10.0,0.0
17016,178312,206,2060,206,2472,412,207,10.0,0.0
17017,7058,7,67,7,81,14,8,9.571,0.0
17018,6611,7,70,7,84,14,8,10.0,0.0
17019,329549,0,3000,0,3500,500,501,6.0,0.0
1702,676694,0,11717,0,12217,500,501,23.434,0.0
17020,201682,0,2501,0,3001,500,501,5.002,0.0
17022,332179,0,3000,0,3500,500,501,6.0,0.0
17024,452114,500,5444,500,6444,1000,501,10.888,0.0
17025,12191,12,207,12,231,24,13,17.25,0.0
17026,3885,0,40,0,48,8,9,10.0,0.0
17027,15751,19,285,19,323,38,20,15.0,0.0
17028,185756,0,1999,0,2499,500,501,3.998,0.0
17029,15000,11,121,11,143,22,12,11.0,0.0
1703,1631869,903,9418,903,11224,1806,905,10.43,0.0
17030,270972,0,4476,0,4976,500,501,8.952,0.0
17031,1542,2,12,2,16,4,3,6.0,0.0
17032,295352,500,4996,500,5996,1000,501,9.992,0.0
17033,240357,0,3584,0,4084,500,501,7.168,0.0
17034,282256,269,4746,269,5284,538,270,17.643,0.0
17035,3646,3,30,3,36,6,4,10.0,0.0
17037,9468,10,120,10,140,20,11,12.0,0.0
17039,4514,6,48,6,60,12,7,8.0,0.0
1704,680503,0,11701,0,12201,500,501,23.402,0.0
17040,13206,11,69,11,113,44,24,6.273,0.0
17041,11057,11,198,11,220,22,12,18.0,0.0
17042,1561,1,15,1,17,2,2,15.0,0.0
17045,7684,3,19,3,31,12,9,6.333,0.0
17046,8656,13,143,13,169,26,14,11.0,0.0
17047,2655,2,36,2,40,4,3,18.0,0.0
17048,195301,219,2725,219,3163,438,220,12.443,0.0
17050,210385,500,2500,500,3500,1000,501,5.0,0.0
17051,98134,244,1219,244,1707,488,245,4.996,0.0
17053,296083,0,4000,0,4500,500,501,8.0,0.0
17054,6901,5,40,5,77,37,18,8.0,0.0
17056,337137,500,5000,500,6000,1000,501,10.0,0.0
17059,148400,142,1278,142,1562,284,143,9.0,0.0
1706,683111,0,11657,0,12157,500,501,23.314,0.0
17060,3198,4,44,4,52,8,5,11.0,0.0
17063,4201,4,34,4,42,8,5,8.5,0.0
17064,1167,1,10,1,12,2,2,10.0,0.0
17065,12598,0,126,0,132,6,7,21.0,0.0
17067,5456,8,69,8,85,16,9,8.625,0.0
17068,141580,0,1697,0,2039,342,343,4.962,0.0
1707,174210,0,2275,0,2671,396,397,5.745,0.0
17070,4926,5,52,5,62,10,6,10.4,0.0
17072,3648,3,30,3,36,6,4,10.0,0.0
17074,468437,0,3500,0,4000,500,501,7.0,0.0
17075,4654,0,50,0,60,10,11,5.0,0.0
17076,112378,119,1147,119,1385,238,120,9.639,0.0
17077,6248,0,70,0,84,14,15,5.0,0.0
17078,1302,1,10,1,12,2,2,10.0,0.0
17079,288557,500,4000,500,5000,1000,501,8.0,0.0
1708,881804,911,9466,911,11288,1822,913,10.391,1.0
17081,33098,51,388,51,490,102,52,7.608,0.0
17082,1186747,245,9576,245,10066,490,246,39.086,0.0
17085,298764,127,2286,127,2540,254,128,18.0,0.0
17086,318440,500,4000,500,5000,1000,501,8.0,0.0
17087,65046,43,347,43,519,172,46,8.07,0.0
17089,8679,5,35,5,55,20,12,7.0,0.0
1709,449167,0,6114,0,6614,500,501,12.228,0.75
17090,79779,162,972,162,1296,324,163,6.0,0.0
17091,203455,0,2500,0,3000,500,501,5.0,0.0
17092,200672,326,2608,326,3260,652,327,8.0,0.0
17094,4975,4,32,4,48,16,7,8.0,0.0
17095,1430827,231,10259,231,10721,462,232,44.411,0.0
17096,9738,15,160,15,190,30,16,10.667,0.0
17097,7507,0,77,0,88,11,12,7.0,0.0
17098,102033,69,417,69,693,276,138,6.043,0.0
17099,24077,18,147,18,183,36,19,8.167,0.0
1710,641574,985,8726,985,10696,1970,987,8.859,0.0
17100,21439,23,276,23,322,46,24,12.0,0.0
17102,659304,500,4070,500,6315,2245,513,8.14,0.0
17104,214710,0,2801,0,2935,134,135,20.903,0.0
17106,281914,0,4195,0,4695,500,501,8.39,0.0
17108,285197,0,4064,0,4564,500,501,8.128,0.0
17109,1782,2,17,2,21,4,3,8.5,0.0
17112,457028,500,5500,500,6500,1000,501,11.0,0.0
17114,208377,0,2500,0,3000,500,501,5.0,0.0
17115,288211,0,4171,0,4551,380,381,10.976,0.0
17117,7746,5,44,5,64,20,8,8.8,0.0
17118,147750,350,1749,350,2449,700,351,4.997,0.0
17119,25382,52,244,52,348,104,53,4.692,0.0
1712,2559184,500,53475,500,54475,1000,501,106.95,0.0
17120,30198,31,247,31,371,124,34,7.968,0.0
17121,2794,1,13,1,15,2,2,13.0,0.0
17122,66725,0,797,0,957,160,161,4.981,0.0
17124,3098,2,48,2,52,4,3,24.0,0.0
17125,8807,12,96,12,120,24,13,8.0,0.0
17126,18737,39,234,39,312,78,40,6.0,0.0
17127,29407,44,350,44,438,88,45,7.955,0.0
17128,18511,44,176,44,264,88,45,4.0,0.0
17129,121645,162,1620,162,1944,324,163,10.0,0.0
1713,196264,0,3000,0,3500,500,501,6.0,0.5
17130,29312,31,247,31,371,124,34,7.968,0.0
17132,28853,31,496,31,558,62,32,16.0,0.0
17134,121246,135,2683,135,2953,270,136,19.874,0.0
17135,33553,87,348,87,522,174,88,4.0,0.0
17138,89323,26,749,26,801,52,27,28.808,0.0
17139,3690,3,30,3,36,6,4,10.0,0.0
17141,29163,42,178,42,262,84,43,4.238,0.0
17142,3672,5,55,5,65,10,6,11.0,0.0
17143,203717,0,2501,0,3001,500,501,5.002,0.0
17144,31105,59,295,59,466,171,109,5.0,0.0
17145,205353,0,2444,0,2944,500,501,4.888,0.0
17146,115472,114,812,114,1040,228,115,7.123,0.0
17147,37297,92,368,92,552,184,93,4.0,0.0
17148,492361,0,6027,0,6161,134,135,44.978,0.0
17149,5403,5,30,5,50,20,12,6.0,0.0
1715,681311,0,11681,0,12181,500,501,23.362,0.0
17150,13151,22,151,22,195,44,23,6.864,0.0
17152,6827,0,75,0,90,15,16,5.0,0.0
17153,28907,45,225,45,315,90,46,5.0,0.0
17154,33598,32,510,32,574,64,33,15.938,0.0
17155,219538,500,3000,500,4000,1000,501,6.0,0.0
17157,234953,258,2580,258,3096,516,259,10.0,0.0
17158,5416,4,31,4,47,16,7,7.75,0.0
17159,7367,0,80,0,96,16,17,5.0,0.0
1716,683730,0,11576,0,12076,500,501,23.152,0.0
17162,373655,0,3498,0,3998,500,501,6.996,0.0
17163,353191,276,6345,276,6897,552,277,22.989,0.0
17164,22754,23,161,23,253,92,48,7.0,0.0
17167,3644,3,30,3,36,6,4,10.0,0.0
17168,733535,500,6045,500,7045,1000,501,12.09,0.0
1717,712176,909,9454,909,11272,1818,911,10.4,0.0
17172,30076,0,394,0,455,61,62,6.567,0.0
17173,72498,108,1098,108,1314,216,109,10.167,0.0
17174,54103,0,896,0,952,56,57,16.0,0.0
17176,7907401,23,138,23,184,46,24,6.0,0.0
17177,465812,500,6500,500,7500,1000,501,13.0,0.0
17179,522969,0,6483,0,6983,500,501,12.966,0.0
17181,31459,76,304,76,456,152,77,4.0,0.0
17183,10083,14,139,14,167,28,15,9.929,0.0
17184,5954,14,70,14,98,28,15,5.0,0.0
17185,23714,0,280,0,336,56,57,5.0,0.0
17188,402694,0,3681,0,4181,500,501,7.362,0.0
17190,331059,0,3000,0,3500,500,501,6.0,0.0
17192,25149,13,188,13,288,100,69,14.462,0.0
17193,13005,13,195,13,221,26,14,15.0,0.0
17194,257468,0,2382,0,2779,397,398,6.0,0.0
17197,311684,500,3500,500,4500,1000,501,7.0,0.0
17198,458701,500,6077,500,7077,1000,501,12.154,0.0
1720,941601,0,10337,0,10837,500,501,20.674,1.0
17200,3771341,500,5000,500,6000,1000,502,10.0,0.0
17203,1050,1,4,1,6,2,2,4.0,0.0
17205,529238,500,5433,500,6433,1000,501,10.866,0.0
17206,884813,500,6096,500,7096,1000,501,12.192,0.0
17208,454939,500,5914,500,6914,1000,501,11.828,0.0
17210,1324,1,11,1,13,2,2,11.0,0.0
17211,41456,88,528,88,704,176,89,6.0,0.0
17214,19967,0,398,0,429,31,32,12.839,0.0
17215,44133,0,792,0,850,58,59,13.655,0.0
17216,347928,0,3000,0,3500,500,501,6.0,0.0
17217,287985,500,3500,500,4500,1000,501,7.0,0.0
17218,709532,125,5562,125,5812,250,126,44.496,0.0
17219,226215,264,2633,264,3161,528,265,9.973,0.0
17220,9342,12,118,12,154,36,25,9.833,0.0
17222,7135,7,91,7,105,14,8,13.0,0.0
17224,452751,500,5863,500,6863,1000,501,11.726,0.0
17225,13808,32,192,32,256,64,34,6.0,0.0
17226,203282,38,2878,38,2954,76,39,75.737,0.0
17227,6813,0,48,0,64,16,17,3.0,0.0
17228,63217,44,698,44,786,88,45,15.864,0.0
1723,1193902,970,10668,970,12608,1940,972,10.998,0.0
17230,1771,1,14,1,16,2,2,14.0,0.0
17232,3647,3,30,3,36,6,4,10.0,0.0
17233,1124992,0,33864,0,34364,500,501,67.728,0.0
17234,2229,4,20,4,28,8,5,5.0,0.0
17235,31830,22,184,22,272,88,25,8.364,0.0
17236,387677,500,5000,500,6000,1000,501,10.0,0.0
17239,7261,16,80,16,112,32,17,5.0,0.0
1724,290556,0,5000,0,5500,500,501,10.0,0.0
17240,344491,0,2990,0,3490,500,501,5.98,0.0
17242,1332,1,10,1,12,2,2,10.0,0.0
17243,431085,500,4527,500,5527,1000,502,9.054,0.0
17244,11098,15,158,15,188,30,16,10.533,0.0
17245,1205956,248,9757,248,10253,496,249,39.343,0.0
17246,914076,101,16867,101,17069,202,102,167.0,0.0
17248,303370,0,4000,0,4500,500,501,8.0,0.0
17249,67344,88,925,88,1101,176,89,10.511,0.0
1725,265629,0,3500,0,4000,500,501,7.0,0.0
17251,5728,0,58,0,70,12,13,4.833,0.0
17252,18347,14,336,14,364,28,15,24.0,0.0
17253,369593,500,3000,500,4000,1000,501,6.0,0.0
17254,13055,22,151,22,195,44,23,6.864,0.0
17255,5623,5,41,5,61,20,8,8.2,0.0
17256,59423,0,775,0,877,102,103,7.598,0.0
1726,918880,985,10726,985,12696,1970,987,10.889,0.0
17260,7390,10,90,10,110,20,11,9.0,0.0
17261,2797,3,24,3,30,6,4,8.0,0.0
17262,20984,0,160,0,192,32,33,5.0,0.0
17263,3972,0,28,0,30,2,3,14.0,0.0
17265,476393,133,7049,133,7315,266,134,53.0,0.0
17268,322264,0,4500,0,5000,500,501,9.0,0.0
17269,16465,13,208,13,234,26,14,16.0,0.0
1727,717700,926,9482,926,11334,1852,928,10.24,0.0
17270,139191,0,1575,0,1890,315,316,5.0,0.0
17271,1319,1,11,1,13,2,2,11.0,0.0
17273,21798,22,176,22,264,88,25,8.0,0.0
17274,8812,11,73,11,95,22,12,6.636,0.0
17275,2616543,500,45382,500,46382,1000,501,90.764,0.0
17276,1560139,0,53255,0,53755,500,501,106.51,0.0
1728,946111,925,11976,925,13826,1850,927,12.947,0.0
17280,224193,327,3270,327,3924,654,328,10.0,0.0
17281,176323,275,1557,275,2107,550,276,5.662,0.0
17282,8582,9,81,9,108,27,11,9.0,0.0
17284,22028,31,245,31,338,93,33,7.903,0.0
17285,116453,208,1456,208,1872,416,209,7.0,0.0
17286,19675,0,341,0,372,31,32,11.0,0.0
17287,2433,4,26,4,34,8,5,6.5,0.0
17289,33083,51,418,51,520,102,52,8.196,0.0
17290,305542,38,2878,38,2954,76,39,75.737,0.0
17291,14800,15,225,15,255,30,16,15.0,0.0
17293,186109,176,2816,176,3168,352,177,16.0,0.0
17295,70611,41,1096,41,1215,119,50,26.732,0.0
17296,10119,11,125,11,147,22,12,11.364,0.0
17297,305568,38,2878,38,2954,76,39,75.737,0.0
17298,59839,0,778,0,880,102,103,7.627,0.0
17300,4438,8,48,8,64,16,9,6.0,0.0
17301,22108,17,144,17,212,68,20,8.471,0.0
17302,449896,500,6040,500,7040,1000,501,12.08,0.0
17303,263531,354,3538,354,4246,708,355,9.994,0.0
17304,477778,500,5498,500,6498,1000,501,10.996,0.0
17306,212068,0,2498,0,2998,500,501,4.996,0.0
17307,2731,4,16,4,24,8,5,4.0,0.0
17308,374391,0,3000,0,3500,500,501,6.0,0.0
17309,3198,4,44,4,52,8,5,11.0,0.0
17310,343580,0,3000,0,3500,500,501,6.0,0.0
17311,5807,7,84,7,98,14,8,12.0,0.0
17312,36411,0,435,0,522,87,88,5.0,0.0
17313,672753,339,3290,339,3968,678,340,9.705,0.0
17314,23418,0,324,0,360,36,37,9.0,0.0
17315,16053,24,262,24,310,48,25,10.917,0.0
17316,17848,10,160,10,180,20,11,16.0,0.0
17318,10583,0,118,0,130,12,13,9.833,0.0
1732,1374436,926,11984,926,13836,1852,928,12.942,0.0
17320,304962,38,2878,38,2954,76,39,75.737,0.0
17321,6370,6,90,6,102,12,7,15.0,0.0
17325,61055,0,751,0,902,151,152,4.974,0.0
17326,177753,303,3022,303,3628,606,304,9.974,0.0
17327,30559,41,328,41,451,123,44,8.0,0.0
17328,25689,0,285,0,343,58,59,4.914,0.0
17329,270528,361,4332,361,5054,722,362,12.0,0.0
1733,1155884,910,11460,910,13280,1820,912,12.593,0.0
17330,161332,0,2072,0,2368,296,297,7.0,0.0
17331,75033,137,1059,137,1333,274,138,7.73,0.0
17332,317334,500,4000,500,5000,1000,501,8.0,0.0
17333,239017,246,2214,246,2706,492,247,9.0,0.0
17334,13793,30,150,30,210,60,31,5.0,0.0
17336,34758,22,132,22,220,88,46,6.0,0.0
17337,422322,500,5493,500,6493,1000,501,10.986,0.0
17338,16864,12,72,12,120,48,26,6.0,0.0
17339,255966,0,3531,0,3752,221,222,15.977,0.0
17340,368791,0,4762,0,5262,500,501,9.524,0.0
17341,55282,73,483,73,629,146,74,6.616,0.0
17344,12306,32,192,32,256,64,34,6.0,0.0
17345,20184,45,225,45,315,90,46,5.0,0.0
17346,2573308,500,20023,500,21023,1000,501,40.046,0.0
17347,1095488,500,17548,500,18548,1000,501,35.096,0.0
17348,1946,2,12,2,16,4,3,6.0,0.0
17349,8372,7,42,7,70,28,17,6.0,0.0
17350,28532,77,231,77,385,154,78,3.0,0.0
17352,41318,70,533,70,673,140,71,7.614,0.0
17353,39764,74,592,74,740,148,75,8.0,0.0
17354,375392,500,4992,500,6483,1491,992,9.984,0.0
17355,249212,0,3838,0,4338,500,501,7.676,0.0
17356,5063,3,28,3,34,6,4,9.333,0.0
17357,5491,4,92,4,100,8,5,23.0,0.0
17359,15667,0,184,0,207,23,24,8.0,0.0
1736,1050391,994,12456,994,14444,1988,996,12.531,1.0
17360,4420,0,30,0,40,10,11,3.0,0.0
17361,340846,0,3500,0,4000,500,501,7.0,0.0
17363,11315190,437,1748,437,2622,874,438,4.0,0.0
17365,119014,163,1198,163,1524,326,164,7.35,0.0
17366,177608,0,2439,0,2562,123,124,19.829,0.0
17367,4173,5,60,5,70,10,6,12.0,0.0
17368,36978,78,468,78,624,156,79,6.0,0.0
17369,12378,27,135,27,189,54,28,5.0,0.0
1737,270170,0,3500,0,4000,500,501,7.0,0.0
17370,89135,118,939,118,1175,236,119,7.958,0.0
17372,319384,0,4767,0,5267,500,501,9.534,0.0
17376,35647,31,186,31,298,112,52,6.0,0.0
17377,325299,0,3000,0,3500,500,501,6.0,0.0
17378,800299,500,17835,500,19335,1500,606,35.67,0.0
17379,2232,4,16,4,24,8,5,4.0,0.0
17380,11997,28,112,28,168,56,29,4.0,0.0
17381,5959,5,41,5,61,20,9,8.2,0.0
17382,258758,500,2500,500,3500,1000,501,5.0,0.0
17384,34213,77,385,77,539,154,78,5.0,0.0
17385,3619,3,30,3,36,6,4,10.0,0.0
17386,91599,0,1889,0,2024,135,136,13.993,0.0
17387,11916,21,167,21,209,42,22,7.952,0.0
17388,1552,1,11,1,13,2,2,11.0,0.0
17389,5706,4,35,4,51,16,7,8.75,0.0
1739,1634094,904,9424,904,11232,1808,906,10.425,0.0
17390,40975,42,250,42,418,168,45,5.952,0.0
17392,465179,500,5523,500,6523,1000,501,11.046,0.0
17394,545701,300,4999,300,5599,600,301,16.663,0.0
17395,14571,34,170,34,238,68,35,5.0,0.0
17396,50477,53,588,53,694,106,54,11.094,0.0
17399,80385,0,1092,0,1248,156,157,7.0,0.0
1740,1027080,924,11970,924,13818,1848,926,12.955,1.0
17400,30268,40,281,40,413,132,55,7.025,0.0
17401,617737,500,11940,500,12940,1000,501,23.88,0.0
17403,213528,135,1350,135,1620,270,136,10.0,0.0
17405,82956,175,1050,175,1400,350,176,6.0,0.0
17407,463505,500,5997,500,6997,1000,501,11.994,0.0
17408,105105,0,1409,0,1610,201,202,7.01,0.0
17409,339441,500,5000,500,6000,1000,501,10.0,0.0
1741,823588,924,9478,924,11326,1848,926,10.258,0.0
17410,126500,0,1515,0,1818,303,304,5.0,0.0
17411,48979,115,687,115,917,230,116,5.974,0.0
17412,9244,12,108,12,132,24,13,9.0,0.0
17414,18164,22,343,22,387,44,23,15.591,0.0
17415,194086,229,2537,229,2995,458,230,11.079,0.0
17416,448731,0,7500,0,8000,500,501,15.0,0.0
17417,733397,500,5982,500,6982,1000,502,11.964,0.0
17418,4042,10,28,10,48,20,11,2.8,0.0
17419,15344,0,184,0,207,23,24,8.0,0.0
1742,888085,0,10338,0,10838,500,501,20.676,1.0
17420,8891,5,30,5,50,20,12,6.0,0.0
17422,222471,0,3000,0,3500,500,501,6.0,0.0
17423,303375,346,3456,346,4148,692,347,9.988,0.0
17426,6235,0,70,0,84,14,15,5.0,0.0
17429,8801,12,96,12,120,24,13,8.0,0.0
1743,1058446,924,11968,924,13816,1848,926,12.952,0.0
17431,290752,201,1809,201,2211,402,202,9.0,0.0
17432,1976,1,21,1,23,2,2,21.0,0.0
17434,112991,0,1390,0,1669,279,280,4.982,0.0
17435,292236,500,5000,500,6000,1000,501,10.0,0.0
1744,675832,0,11709,0,12209,500,501,23.418,0.0
17440,2999,4,40,4,48,8,5,10.0,0.0
17441,150526,0,1780,0,2136,356,357,5.0,0.0
17442,1205,1,10,1,12,2,2,10.0,0.0
17443,319161,0,3008,0,3508,500,501,6.016,0.0
17444,35134,69,345,69,483,138,70,5.0,0.0
17445,106885,131,987,131,1503,516,159,7.534,0.0
17446,51790,0,600,0,720,120,121,5.0,0.0
17448,3257,5,30,5,40,10,6,6.0,0.0
17449,571145,500,4234,500,5234,1000,501,8.468,0.0
17450,52567,92,691,92,875,184,94,7.511,0.0
17451,155060,0,1849,0,2220,371,372,4.984,0.0
17452,334940,500,3510,500,4510,1000,501,7.02,0.0
17453,12064,21,119,21,161,42,22,5.667,0.0
17454,6268,0,70,0,84,14,15,5.0,0.0
17455,11866,21,122,21,164,42,22,5.81,0.0
17460,95067,0,1120,0,1344,224,225,5.0,0.0
17461,2897,3,39,3,45,6,4,13.0,0.0
17467,95618,64,381,64,637,256,130,5.953,0.0
17468,5603,5,30,5,50,20,12,6.0,0.0
1747,881777,909,9454,909,11272,1818,911,10.4,1.0
17470,510589,133,14098,133,14364,266,134,106.0,0.0
17473,28542,44,352,44,440,88,45,8.0,0.0
17474,24116,51,240,51,342,102,52,4.706,0.0
17475,12520,27,135,27,189,54,28,5.0,0.0
17476,1095,0,7,0,8,1,2,7.0,0.0
17479,148315,0,1326,0,1547,221,222,6.0,0.0
1748,460054,0,7500,0,8000,500,501,15.0,0.8333333333333334
17482,86114,141,1410,141,1692,282,142,10.0,0.0
17483,1491,1,16,1,18,2,2,16.0,0.0
17484,451168,0,5419,0,5919,500,501,10.838,0.0
17485,104637,119,888,119,1364,476,156,7.462,0.0
17486,126538,0,1495,0,1794,299,300,5.0,0.0
17489,104676,0,1072,0,1206,134,135,8.0,0.0
17491,5654,0,54,0,66,12,13,9.0,0.0
17492,80569,0,1100,0,1259,159,160,6.918,0.0
17494,41646,97,485,97,679,194,98,5.0,0.0
17495,209009,500,2495,500,3495,1000,501,4.99,0.0
17499,1688,2,18,2,22,4,3,9.0,0.0
1750,675527,0,11741,0,12241,500,501,23.482,0.0
17500,5000,0,55,0,66,11,12,5.0,0.0
17503,1652,1,12,1,14,2,2,12.0,0.0
17504,32561,73,365,73,511,146,74,5.0,0.0
17505,15635,30,143,30,203,60,31,4.767,0.0
17507,23450,24,359,24,407,48,25,14.958,0.0
17508,414077,0,4000,0,4500,500,501,8.0,0.0
17509,4237,4,24,4,36,12,9,6.0,0.0
1751,292314,0,5000,0,5500,500,501,10.0,0.0
17510,267883,500,3016,500,4016,1000,501,6.032,0.0
17511,9577,22,110,22,154,44,23,5.0,0.0
17512,91223,0,949,0,1068,119,120,7.975,0.0
17514,308101,359,3589,359,4307,718,360,9.997,0.0
17515,364601,0,4276,0,4776,500,501,8.552,0.0
17519,311636,490,4410,490,5390,980,491,9.0,0.0
17520,319931,500,4500,500,5500,1000,501,9.0,0.0
17521,203278,500,2500,500,3500,1000,501,5.0,0.0
17522,29676,0,353,0,424,71,72,4.972,0.0
17523,15768,30,143,30,203,60,31,4.767,0.0
17525,21655,19,114,19,183,69,33,6.0,0.0
17526,3881,4,24,4,32,8,5,6.0,0.0
17528,328346,500,3986,500,4986,1000,501,7.972,0.0
17529,69297,0,917,0,1037,120,121,7.642,0.0
17531,33231,52,416,52,520,104,53,8.0,0.0
17532,13177,31,124,31,186,62,32,4.0,0.0
17533,23999,58,290,58,406,116,59,5.0,0.0
17536,84895,127,1397,127,1651,254,128,11.0,0.0
17537,456917,500,6032,500,7032,1000,501,12.064,0.0
17539,42575,0,510,0,612,102,103,5.0,0.0
1754,9249731,3551,73200,3551,80302,7102,3553,20.614,0.0
17540,518296,0,6030,0,6164,134,135,45.0,0.0
17541,6846,4,52,4,60,8,5,13.0,0.0
17542,36859,0,420,0,504,84,85,5.0,0.0
17543,45789,47,531,47,625,94,48,11.298,0.0
17545,13159,22,151,22,195,44,23,6.864,0.0
17546,36688,0,570,0,608,38,39,15.0,0.0
17547,976,1,2,1,4,2,2,2.0,0.0
1755,1219779,908,11948,908,13764,1816,910,13.159,0.0
17551,457527,500,7946,500,8946,1000,502,15.892,0.0
17552,101425,172,1720,172,2064,344,173,10.0,0.0
17553,24770,32,219,32,283,64,33,6.844,0.0
17554,408387,500,6000,500,7000,1000,501,12.0,0.0
17556,11598,28,138,28,194,56,29,4.929,0.0
17557,157571,119,1425,119,1663,238,120,11.975,0.0
1756,6525,19,57,19,95,38,20,3.0,0.0
17560,4509,2,31,2,39,8,5,15.5,0.0
17561,74204,0,804,0,938,134,135,6.0,0.0
17563,479291,500,5265,500,6265,1000,501,10.53,0.0
17564,1171,1,9,1,11,2,2,9.0,0.0
17566,107900,133,1330,133,1596,266,134,10.0,0.0
17567,78640,162,972,162,1296,324,163,6.0,0.0
17568,578815,178,1561,178,1917,356,179,8.77,0.0
17569,13077,22,151,22,195,44,23,6.864,0.0
1757,1378298,420,12016,420,13356,1340,922,13.061,0.0
17570,1057,1,6,1,8,2,2,6.0,0.0
17573,2367,4,16,4,24,8,5,4.0,0.0
17574,461830,500,5999,500,6999,1000,501,11.998,0.0
17576,154068,0,1418,0,1537,119,120,11.916,0.0
17577,5795,8,80,8,96,16,9,10.0,0.0
17578,130558,0,1776,0,2000,224,225,7.929,0.0
1758,1124542,910,11960,910,13780,1820,912,13.143,1.0
17581,206331,0,2500,0,3000,500,501,5.0,0.0
17582,16920,20,220,20,260,40,21,11.0,0.0
17583,4771,5,45,5,60,15,11,9.0,0.0
17584,48207,44,756,44,844,88,45,17.182,0.0
17585,74733,103,1152,103,1358,206,104,11.184,0.0
17588,6248,5,100,5,110,10,6,20.0,0.0
1759,212948,0,3500,0,4000,500,501,7.0,0.0
17591,6782,6,37,6,61,24,14,6.167,0.0
17592,88367,0,942,0,1061,119,120,7.916,0.0
17593,147006,0,1437,0,1591,154,155,9.331,0.0
17594,914689,101,16867,101,17069,202,102,167.0,0.0
17595,37673,0,389,0,467,78,79,4.987,0.0
17597,1149296,234,9206,234,9674,468,235,39.342,0.0
17598,85156,97,735,97,1096,361,149,7.577,0.0
1760,290860,0,5000,0,5500,500,501,10.0,0.0
17600,386026,500,5000,500,6000,1000,501,10.0,0.0
17601,76534,162,972,162,1296,324,163,6.0,0.0
17606,3497,8,24,8,40,16,9,3.0,0.0
17607,44337,50,300,50,500,200,102,6.0,0.0
17609,147895,146,1734,146,2026,292,147,11.877,0.0
17610,202169,0,2261,0,2515,254,255,8.902,0.0
17613,304837,500,4000,500,5000,1000,501,8.0,0.0
17615,8802,12,96,12,120,24,13,8.0,0.0
17616,6611,15,75,15,105,30,16,5.0,0.0
17618,23098,32,288,32,352,64,33,9.0,0.0
17619,298495,0,3000,0,3500,500,501,6.0,0.0
17620,298846,0,4496,0,4996,500,501,8.992,0.0
17624,48893,45,448,45,538,90,46,9.956,0.0
17627,8609,7,57,7,84,27,10,8.143,0.0
17629,26227,0,310,0,372,62,63,5.0,0.0
1763,974635,906,11936,906,13748,1812,908,13.174,0.0
17630,2640,3,36,3,42,6,4,12.0,0.0
17631,1011,1,4,1,6,2,3,4.0,0.0
17632,7842,4,24,4,40,16,11,6.0,0.0
17633,81941,184,1197,184,1565,368,185,6.505,0.0
17634,4895740,23,138,23,184,46,25,6.0,0.0
17635,19805,13,182,13,208,26,14,14.0,0.0
17636,4663,10,40,10,60,20,11,4.0,0.0
17637,4921,3,78,3,84,6,4,26.0,0.0
17640,6447,0,100,0,109,9,10,11.111,0.0
17641,1581,1,20,1,22,2,2,20.0,0.0
17642,271314,432,3456,432,4320,864,433,8.0,0.0
17643,16456,22,150,22,228,78,31,6.818,0.0
17644,32440,28,223,28,279,56,29,7.964,0.0
17645,50720,108,648,108,864,216,109,6.0,0.0
17646,148242,160,1600,160,1920,320,161,10.0,0.0
17647,511468,0,6000,0,6500,500,501,12.0,0.0
17648,75278,77,663,77,894,231,79,8.61,0.0
17649,3898,5,50,5,60,10,6,10.0,0.0
1765,967285,907,9442,907,11256,1814,909,10.41,0.0
17651,464009,500,5500,500,6500,1000,501,11.0,0.0
17652,1172,1,10,1,12,2,2,10.0,0.0
17654,387624,265,2385,265,2915,530,266,9.0,0.0
17655,29418,42,420,42,504,84,43,10.0,0.0
17656,1167131,238,9430,238,9906,476,239,39.622,0.0
17657,21964,0,260,0,312,52,53,5.0,0.0
17658,17717,18,270,18,306,36,19,15.0,0.0
17660,65161,0,1188,0,1296,108,109,11.0,0.0
17661,13575,18,198,18,234,36,19,11.0,0.0
17662,33408,39,554,39,632,78,40,14.205,0.0
17664,811031,500,13094,500,14094,1000,501,26.188,0.0
17665,15260,10,260,10,280,20,11,26.0,0.0
17667,80069,62,743,62,867,124,63,11.984,0.0
17668,26058,0,304,0,365,61,62,4.984,0.0
17669,238211,500,2500,500,3500,1000,502,5.0,0.0
1767,1060839,924,11959,924,13807,1848,926,12.943,0.0
17672,20195,10,138,10,217,79,54,13.8,0.0
17673,6286,6,90,6,102,12,7,15.0,0.0
17674,16071,13,169,13,195,26,14,13.0,0.0
17675,771787,500,6020,500,7020,1000,501,12.04,0.0
17676,6259,0,70,0,84,14,15,5.0,0.0
17679,21716,24,312,24,360,48,25,13.0,0.0
1768,372838,500,7000,500,8000,1000,501,14.0,0.0
17680,266215,500,3499,500,4499,1000,501,6.998,0.0
17681,20625,31,217,31,310,93,33,7.0,0.0
17682,1452,1,12,1,14,2,2,12.0,0.0
17683,4323,6,66,6,78,12,7,11.0,0.0
17685,8032,9,81,9,99,18,10,9.0,0.0
17686,9585,8,48,8,80,32,18,6.0,0.0
17687,57342,0,748,0,846,98,99,7.633,0.0
17690,81434,162,972,162,1296,324,163,6.0,0.0
17691,32754,22,184,22,272,88,25,8.364,0.0
17693,7780922,12,84,12,108,24,13,7.0,0.0
17694,8414,18,89,18,125,36,19,4.944,0.0
17695,307826,0,3000,0,3500,500,501,6.0,0.0
17696,140416,0,1985,0,2216,231,232,8.593,0.0
17698,34717,31,186,31,298,112,53,6.0,0.0
1770,454620,500,6080,500,7080,1000,501,12.16,1.0
17700,8270,11,110,11,132,22,12,10.0,0.0
17704,6387,10,70,10,90,20,11,7.0,0.0
17705,449251,500,5999,500,6999,1000,501,11.998,0.0
17706,10133,0,110,0,132,22,23,5.0,0.0
17707,77389,50,401,50,601,200,53,8.02,0.0
1771,775174,0,13489,0,13989,500,501,26.978,0.0
17710,146674,251,2510,251,3012,502,252,10.0,0.0
17712,6706,10,80,10,100,20,11,8.0,0.0
17713,15284,0,156,0,177,21,22,7.429,0.0
17715,425320,500,5794,500,6794,1000,501,11.588,0.0
17719,2561400,500,19982,500,20982,1000,501,39.964,0.0
1772,915107,970,10664,970,12604,1940,972,10.994,0.0
17720,59255,0,771,0,872,101,102,7.634,0.0
17721,93878,113,912,113,1138,226,114,8.071,0.0
17722,305095,500,5500,500,6500,1000,501,11.0,0.0
17723,16015,23,276,23,322,46,24,12.0,0.0
17725,8232,20,80,20,120,40,21,4.0,0.0
17726,58736,0,1071,0,1140,69,70,15.522,0.0
17727,586092,500,9020,500,10020,1000,501,18.04,0.0
17728,291808,530,5116,530,6176,1060,532,9.653,0.0
1773,1083473,985,10724,985,12694,1970,987,10.887,0.0
17731,165287,267,1602,267,2136,534,268,6.0,0.0
17733,195946,43,258,43,428,170,86,6.0,0.0
17734,107368,152,1343,152,1647,304,153,8.836,0.0
17735,452252,500,5998,500,6998,1000,501,11.996,0.0
17736,505809,500,8500,500,9500,1000,501,17.0,0.0
17738,456232,500,5499,500,6499,1000,501,10.998,0.0
17740,454475,500,4827,500,5827,1000,501,9.654,0.0
17741,57053,165,531,165,861,330,166,3.218,0.0
17742,15290,30,143,30,203,60,31,4.767,0.0
17743,18661,8,112,8,128,16,9,14.0,0.0
17744,35450,23,138,23,230,92,47,6.0,0.0
17746,7976,13,89,13,115,26,14,6.846,0.0
17747,1199,1,10,1,12,2,2,10.0,0.0
17748,391034,500,5500,500,6500,1000,501,11.0,0.0
17749,212647,500,3000,500,4000,1000,501,6.0,0.0
1775,455627,500,6082,500,7082,1000,501,12.164,0.5
17751,251517,0,3899,0,4399,500,501,7.798,0.0
17753,4883,0,33,0,44,11,12,3.0,0.0
17755,737880,500,15781,500,16781,1000,501,31.562,0.0
17756,102953,115,1012,115,1357,345,117,8.8,0.0
17757,405337,267,2403,267,2937,534,268,9.0,0.0
1776,4856,0,60,0,70,10,11,6.0,0.0
17760,3149,0,26,0,28,2,3,13.0,0.0
17761,7041,11,110,11,132,22,12,10.0,0.0
17762,47387,50,300,50,500,200,102,6.0,0.0
17765,101196,64,530,64,786,256,67,8.281,0.0
17766,34860,0,241,0,256,15,16,16.067,0.0
17768,9915,16,152,16,184,32,18,9.5,0.0
1777,673799,0,11791,0,12291,500,501,23.582,0.0
17771,1189,0,9,0,10,1,2,9.0,0.0
17772,1919,2,16,2,20,4,3,8.0,0.0
17773,55334,81,567,81,729,162,82,7.0,0.0
17774,1124368,500,13085,500,15850,2765,1802,26.17,0.0
17775,42624,38,293,38,369,76,39,7.711,0.0
17779,11627,28,84,28,140,56,29,3.0,0.0
17781,1105548,0,15568,0,16068,500,501,31.136,0.0
17786,14864,12,168,12,192,24,13,14.0,0.0
17788,15007,29,174,29,232,58,30,6.0,0.0
1779,898656,0,10337,0,10837,500,501,20.674,0.0
17790,41429,46,347,46,521,174,58,7.543,0.0
17792,1072,1,6,1,8,2,2,6.0,0.0
17793,4125,8,32,8,48,16,9,4.0,0.0
17794,94728,84,647,84,972,325,128,7.702,0.0
17795,105908,192,1344,192,1728,384,193,7.0,0.0
17797,84692,133,1064,133,1330,266,134,8.0,0.0
17799,5958,0,80,0,88,8,9,10.0,0.0
1780,677184,0,11713,0,12213,500,501,23.426,0.0
17800,370520,473,3473,473,4419,946,474,7.342,0.0
17802,431652,285,4677,285,5247,570,286,16.411,0.0
17803,6515,6,36,6,60,24,14,6.0,0.0
17804,1723,0,14,0,15,1,2,14.0,0.0
17806,2808,3,24,3,30,6,4,8.0,0.0
17808,239755,0,4630,0,4818,188,189,24.628,0.0
17809,209113,0,2000,0,2500,500,501,4.0,0.0
1781,822463,910,9460,910,11280,1820,912,10.396,0.0
17811,171529,172,1721,172,2137,416,216,10.006,0.0
17813,256974,500,2000,500,3000,1000,501,4.0,0.0
17814,93253,0,1889,0,2024,135,136,13.993,0.0
17815,204659,323,2261,323,2907,646,324,7.0,0.0
17816,21378,13,116,13,168,52,16,8.923,0.0
17818,44253,105,525,105,735,210,106,5.0,0.0
17819,354568,500,4500,500,5500,1000,501,9.0,0.0
1782,1078255,970,10666,970,12606,1940,972,10.996,0.0
17820,223865,0,3000,0,3500,500,501,6.0,0.0
17821,1558,1,12,1,14,2,2,12.0,0.0
17822,98498,122,910,122,1388,478,149,7.459,0.0
17823,8399,7,42,7,70,28,16,6.0,0.0
17824,13582,2,42,2,46,4,3,21.0,0.0
17825,9512,17,102,17,136,34,18,6.0,0.0
17826,8456,0,84,0,105,21,22,4.0,0.0
17827,5499,5,28,5,48,20,12,5.6,0.0
17828,29043,39,507,39,585,78,40,13.0,0.0
17829,314088,500,4500,500,5500,1000,501,9.0,0.0
1783,1069902,970,10668,970,12608,1940,972,10.998,0.0
17830,74241,213,639,213,1065,426,214,3.0,0.0
17831,28631,81,261,81,423,162,82,3.222,0.0
17832,23267,19,307,19,345,38,20,16.158,0.0
17836,15298,17,187,17,221,34,18,11.0,0.0
17841,60932,0,644,0,805,161,162,4.0,0.0
17842,306370,0,4030,0,4530,500,501,8.06,0.0
17843,58005,26,749,26,801,52,27,28.808,0.0
17844,11697,11,176,11,209,33,24,8.0,0.0
17845,387291,500,3618,500,4618,1000,501,7.236,0.0
17846,5812,13,65,13,91,26,14,5.0,0.0
17848,7429,4,24,4,40,16,10,6.0,0.0
17850,6590,9,99,9,117,18,10,11.0,0.0
17851,31192,50,411,50,511,100,51,8.22,0.0
17853,53628,43,778,43,864,86,44,18.093,0.0
17855,15896,0,164,0,205,41,42,4.0,0.0
17856,246931,0,3764,0,4264,500,501,7.528,0.0
17857,16348,12,108,12,156,48,15,9.0,0.0
17859,1519,1,17,1,19,2,2,17.0,0.0
1786,757279,0,10338,0,10838,500,501,20.676,0.5
17861,16505,0,205,0,230,25,26,8.2,0.0
17863,227183,500,3000,500,4000,1000,501,6.0,0.0
17864,33740,42,310,42,473,163,52,7.381,0.0
17865,65974,65,585,65,715,130,66,9.0,0.0
17867,209044,0,2500,0,3000,500,501,5.0,0.0
17868,2366,1,12,1,22,10,10,12.0,0.0
17870,11721,9,54,9,90,36,20,6.0,0.0
17871,15115,0,165,0,198,33,34,5.0,0.0
17872,417034,500,5118,500,6118,1000,501,10.236,0.0
17873,56757,87,609,87,783,174,88,7.0,0.0
17874,624729,500,8000,500,9000,1000,501,16.0,0.0
17875,5381,3,22,3,34,12,6,7.333,0.0
17877,28839,27,229,27,337,108,30,8.481,0.0
17878,2682,4,24,4,32,8,5,6.0,0.0
17881,19848,11,67,11,111,44,24,6.091,0.0
17882,4608,0,42,0,45,3,4,14.0,0.0
17883,1044,1,6,1,8,2,2,6.0,0.0
17885,7941,7,145,7,159,14,8,20.714,0.0
17886,54848,0,760,0,846,86,87,8.837,0.0
17888,30403,23,594,23,640,46,24,25.826,0.0
17889,3559,6,36,6,48,12,7,6.0,0.0
17891,15756,9,126,9,144,18,10,14.0,0.0
17895,88970,106,945,106,1263,318,108,8.915,0.0
17897,306027,39,2880,39,2958,78,40,73.846,0.0
17899,577137,75,654,75,804,150,76,8.72,0.0
1790,671455,909,9454,909,11272,1818,911,10.4,0.0
17900,306330,39,2880,39,2958,78,40,73.846,0.0
17901,305730,39,2880,39,2958,78,40,73.846,0.0
17902,89023,26,749,26,801,52,27,28.808,0.0
17905,21879,0,264,0,317,53,54,4.981,0.0
17908,20287,42,252,42,336,84,43,6.0,0.0
17909,301887,0,3901,0,4401,500,501,7.802,0.0
17910,3726,4,30,4,38,8,5,7.5,0.0
17911,89242,117,933,117,1167,234,118,7.974,0.0
17914,114634,0,1334,0,1601,267,268,4.996,0.0
17915,60366,0,785,0,888,103,104,7.621,0.0
17916,2751,0,25,0,30,5,6,5.0,0.0
17917,241763,176,1760,176,2112,352,177,10.0,0.0
17918,41784,71,536,71,678,142,72,7.549,0.0
17920,41317,0,497,0,597,100,101,4.97,0.0
17921,396926,500,4481,500,5481,1000,502,8.962,0.0
17922,462582,500,6072,500,7072,1000,501,12.144,0.0
17923,462714,500,6029,500,7029,1000,501,12.058,0.0
17926,1702,0,16,0,17,1,2,16.0,0.0
17927,36373,31,515,31,577,62,32,16.613,0.0
17928,2645,2,15,2,19,4,3,7.5,0.0
17929,33941,82,328,82,492,164,83,4.0,0.0
17931,292557,0,4371,0,4871,500,501,8.742,0.0
17932,12864,19,133,19,190,57,21,7.0,0.0
17933,83659,174,1044,174,1392,348,175,6.0,0.0
17936,2645,0,28,0,32,4,5,7.0,0.0
17937,78287,162,972,162,1296,324,163,6.0,0.0
17938,316879,500,3000,500,4000,1000,501,6.0,0.0
1794,1052195,1017,10948,1017,12982,2034,1019,10.765,0.0
17940,587948,0,8588,0,9088,500,501,17.176,0.0
17941,40365,44,746,44,834,88,45,16.955,0.0
17943,44977,96,571,96,763,192,97,5.948,0.0
17944,16266,0,150,0,200,50,27,6.0,0.0
17945,437468,138,4816,138,5113,297,152,34.899,0.0
17946,3519,0,31,0,39,8,9,7.75,0.0
17947,463488,500,5996,500,6996,1000,501,11.992,0.0
17949,5490,5,40,5,60,20,8,8.0,0.0
1795,3798,0,40,0,50,10,11,4.0,0.0
17950,7778,7,137,7,151,14,8,19.571,0.0
17951,2257,0,11,0,12,1,2,11.0,0.0
17953,3838,3,33,3,39,6,4,11.0,0.0
17954,21469,23,179,23,271,92,37,7.783,0.0
17955,12867,19,133,19,190,57,21,7.0,0.0
17956,157747,174,1346,174,2023,677,289,7.736,0.0
17957,5657,2,24,2,28,4,3,12.0,0.0
17958,83613,174,1044,174,1392,348,175,6.0,0.0
17959,4007,5,60,5,70,10,6,12.0,0.0
1796,224732,0,4126,0,4322,196,197,21.051,0.0
17960,533872,500,9367,500,10367,1000,501,18.734,0.0
17966,254781,351,3231,351,3933,702,352,9.205,0.0
17968,3560,6,36,6,48,12,7,6.0,0.0
17969,1422,1,11,1,13,2,2,11.0,0.0
17971,38720,42,714,42,798,84,43,17.0,0.0
17972,1662,1,8,1,12,4,4,8.0,0.0
17973,5808,0,65,0,78,13,14,5.0,0.0
17974,4663,4,20,4,36,16,10,5.0,0.0
17977,387624,265,2385,265,2915,530,266,9.0,0.0
17978,8961,18,108,18,144,36,19,6.0,0.0
1798,1208390,910,9460,910,11280,1820,912,10.396,0.0
17980,109287,0,1753,0,1863,110,111,15.936,0.0
17983,25583,52,244,52,348,104,53,4.692,0.0
17984,221250,500,2500,500,3500,1000,501,5.0,0.0
17985,4680,0,48,0,55,7,8,6.857,0.0
17986,476938,500,5500,500,6500,1000,501,11.0,0.0
17987,16893,35,210,35,280,70,36,6.0,0.0
17989,9972,0,144,0,160,16,17,9.0,0.0
17992,6352,4,24,4,40,16,9,6.0,0.0
17994,32793,32,262,32,358,96,34,8.188,0.0
17996,7650,5,40,5,60,20,13,8.0,0.0
17998,967775,500,23000,500,24000,1000,501,46.0,0.0
17999,12955,0,153,0,171,18,19,8.5,0.0
1800,90902,0,1482,0,1578,96,97,15.438,0.0
18001,87479,0,1068,0,1289,221,222,4.833,0.0
18002,102932,0,1288,0,1449,161,162,8.0,0.0
18003,342466,500,5794,500,6794,1000,501,11.588,0.0
18004,12288,9,225,9,243,18,10,25.0,0.0
18005,397575,500,6318,500,7318,1000,501,12.636,0.0
18007,121627,0,1430,0,1716,286,287,5.0,0.0
1801,449446,500,6095,500,7095,1000,501,12.19,0.5
18010,80786,162,972,162,1296,324,163,6.0,0.0
18011,422642,500,5741,500,6741,1000,501,11.482,0.0
18013,260902,0,3826,0,4326,500,501,7.652,0.0
18016,3493766,500,8783,500,9783,1000,502,17.566,0.0
18017,90074,0,946,0,1065,119,120,7.95,0.0
18019,3831,4,29,4,37,8,5,7.25,0.0
18020,9509,7,57,7,92,35,28,8.143,0.0
18021,9120,15,135,15,165,30,16,9.0,0.0
18023,4000,4,61,4,69,8,5,15.25,0.0
18025,9393,8,49,8,81,32,18,6.125,0.0
18029,166580,0,1970,0,2364,394,395,5.0,0.0
18030,6994,9,90,9,108,18,10,10.0,0.0
18031,2842,3,21,3,27,6,4,7.0,0.0
18032,3622,0,48,0,54,6,7,8.0,0.0
18033,5871,0,65,0,78,13,14,5.0,0.0
18034,1245,1,10,1,12,2,2,10.0,0.0
18035,2821,2,38,2,42,4,3,19.0,0.0
18036,270257,484,2904,484,3872,968,485,6.0,0.0
18037,336785,0,3000,0,3500,500,501,6.0,0.0
18038,115872,0,1065,0,1226,161,162,6.615,0.0
1804,289857,0,5000,0,5500,500,501,10.0,0.0
18042,81435,162,972,162,1296,324,163,6.0,0.0
18043,513175,0,13936,0,14070,134,135,104.0,0.0
18046,2217,1,14,1,16,2,2,14.0,0.0
18048,6282,4,56,4,64,8,5,14.0,0.0
18049,15359,9,126,9,144,18,10,14.0,0.0
1805,1451297,909,11954,909,13772,1818,911,13.151,0.0
18050,1064,0,3,0,5,2,3,3.0,0.0
18052,201411,0,1984,0,2480,496,497,4.0,0.0
18053,325695,500,5006,500,6006,1000,501,10.012,0.0
18055,118610,107,946,107,1160,214,108,8.841,0.0
18057,20875,23,178,23,267,89,29,7.739,0.0
18058,328078,0,3500,0,4000,500,501,7.0,0.0
18062,211373,0,2499,0,2999,500,501,4.998,0.0
18064,17670,42,292,42,376,84,44,6.952,0.0
18065,28184,0,335,0,402,67,68,5.0,0.0
18066,1492923,0,52978,0,53478,500,501,105.956,0.0
18068,5402,4,56,4,68,12,9,14.0,0.0
1807,673323,970,8660,970,10600,1940,972,8.928,0.0
18072,278448,0,4146,0,4646,500,501,8.292,0.0
18073,6286,6,108,6,120,12,7,18.0,0.0
18076,401753,0,4500,0,5000,500,501,9.0,0.0
18077,198421,500,2500,500,3500,1000,501,5.0,0.0
18078,147978,147,1734,147,2028,294,148,11.796,0.0
18079,11485,10,81,10,121,40,13,8.1,0.0
18081,17230,26,208,26,260,52,27,8.0,0.0
18082,267482,500,3604,500,4604,1000,501,7.208,0.0
18083,13585,8,115,8,131,16,9,14.375,0.0
18084,30403,23,594,23,640,46,24,25.826,0.0
18086,5188,6,60,6,72,12,7,10.0,0.0
18087,17868479,500,5000,500,6000,1000,502,10.0,0.0
18088,327204,0,3000,0,3500,500,501,6.0,0.0
1809,222597,87,4437,87,4611,174,88,51.0,0.0
18090,282269,326,3260,326,3912,652,327,10.0,0.0
18091,114583,118,1149,118,1385,236,119,9.737,0.0
18094,1096194,500,11632,500,12632,1000,501,23.264,0.0
18095,2097,2,28,2,32,4,3,14.0,0.0
18096,659688,500,10500,500,11500,1000,501,21.0,0.0
18098,279637,0,2574,0,3003,429,430,6.0,0.0
18099,73119,0,804,0,938,134,135,6.0,0.0
1810,1055649,906,11936,906,13748,1812,908,13.174,0.0
18101,59303,0,771,0,872,101,102,7.634,0.0
18102,5649,4,34,4,50,16,7,8.5,0.0
18103,979209,500,14000,500,15000,1000,501,28.0,0.0
18104,233202,262,2144,262,2668,524,263,8.183,0.0
18105,21203,30,330,30,390,60,31,11.0,0.0
18109,12594,0,108,0,144,36,37,3.0,0.0
1811,373620,500,4000,500,5000,1000,501,8.0,0.0
18110,94430,0,1109,0,1331,222,223,4.995,0.0
18114,330463,0,3000,0,3500,500,501,6.0,0.0
18115,1072,1,6,1,8,2,2,6.0,0.0
18118,85211,92,920,92,1104,184,93,10.0,0.0
18119,318461,0,3500,0,4000,500,501,7.0,0.0
18121,106129,0,1235,0,1482,247,248,5.0,0.0
18123,1495,0,15,0,16,1,2,15.0,0.0
18124,426544,500,7517,500,8517,1000,501,15.034,0.0
18125,1531,1,12,1,14,2,2,12.0,0.0
18128,396437,264,2640,264,3168,528,265,10.0,0.0
18129,2447502,500,19782,500,20782,1000,501,39.564,0.0
1813,720727,0,14438,0,14938,500,501,28.876,0.0
18131,8400,7,42,7,70,28,16,6.0,0.0
18132,265461,0,3935,0,4435,500,501,7.87,0.0
18133,77970,87,659,87,979,320,136,7.575,0.0
18134,208950,0,2453,0,2953,500,501,4.906,0.0
18136,9592,22,110,22,154,44,23,5.0,0.0
18137,377218,0,5000,0,5500,500,501,10.0,0.0
18140,317687,0,3000,0,3500,500,501,6.0,0.0
18142,191649,42,252,42,420,168,86,6.0,0.0
18144,89887,0,940,0,1059,119,120,7.899,0.0
18145,18922,0,323,0,342,19,20,17.0,0.0
18146,5771,7,63,7,77,14,8,9.0,0.0
18147,319571,500,3000,500,4000,1000,501,6.0,0.0
18148,2674,3,21,3,27,6,4,7.0,0.0
18151,705185,500,12036,500,13036,1000,501,24.072,0.0
18153,41055,60,540,60,660,120,61,9.0,0.0
18156,316350,485,2910,485,3880,970,486,6.0,0.0
18157,32660,0,389,0,467,78,79,4.987,0.0
18160,446101,500,5835,500,6835,1000,501,11.67,0.0
18161,83660,174,1044,174,1392,348,175,6.0,0.0
18163,5115,3,26,3,55,29,17,8.667,0.0
18164,1769,2,17,2,21,4,3,8.5,0.0
18165,198599,0,2500,0,3000,500,501,5.0,0.0
18166,2697,5,18,5,28,10,6,3.6,0.0
18167,172716,0,1988,0,2260,272,273,7.309,0.0
18169,409002,0,3990,0,4490,500,501,7.98,0.0
1817,1048638,909,9454,909,11272,1818,911,10.4,0.0
18170,81756,184,1197,184,1565,368,185,6.505,0.0
18171,452181,500,5692,500,6692,1000,501,11.384,0.0
18172,79101,85,850,85,1020,170,86,10.0,0.0
18173,293388,0,4000,0,4500,500,501,8.0,0.0
18175,127948,0,1356,0,1695,339,340,4.0,0.0
18176,91905,0,1061,0,1277,216,217,4.912,0.0
18177,1546,1,11,1,13,2,2,11.0,0.0
18179,36356,17,561,17,595,34,18,33.0,0.0
1818,1107198,908,11948,908,13764,1816,910,13.159,0.0
18180,60651,89,623,89,801,178,90,7.0,0.0
18184,14473,15,227,15,257,30,16,15.133,0.0
18185,2206,1,9,1,11,2,2,9.0,0.0
18186,2863,5,25,5,35,10,6,5.0,0.0
18187,1413,2,10,2,14,4,3,5.0,0.0
18188,3133,3,36,3,42,6,4,12.0,0.0
1819,1052897,910,9460,910,11280,1820,912,10.396,0.0
18190,9154,14,112,14,140,28,15,8.0,0.0
18192,197713,229,1991,229,2678,687,232,8.694,0.0
18193,417861,133,6251,133,6517,266,134,47.0,0.0
18196,295072,0,3500,0,4000,500,501,7.0,0.0
18197,20944,18,270,18,306,36,19,15.0,0.0
18198,335704,0,3000,0,3500,500,501,6.0,0.0
18199,86569,0,1059,0,1272,213,214,4.972,0.0
18201,15337,18,128,18,200,72,25,7.111,0.0
18202,144968,0,1815,0,2178,363,364,5.0,0.0
18206,215538,500,3000,500,4000,1000,501,6.0,0.0
18207,82087,174,1044,174,1392,348,175,6.0,0.0
18209,532432,0,6834,0,6968,134,135,51.0,0.0
1821,815106,996,9970,996,11962,1992,998,10.01,0.0
18210,453708,500,5971,500,6971,1000,501,11.942,0.0
18211,6110,0,75,0,90,15,16,5.0,0.0
18212,213038,0,2475,0,2975,500,501,4.95,0.0
18213,258857,500,3000,500,4000,1000,501,6.0,0.0
18214,203511,0,2500,0,3000,500,501,5.0,0.0
18215,18749,0,174,0,207,33,34,5.273,0.0
18216,1809,1,8,1,12,4,4,8.0,0.0
18217,58073,26,749,26,801,52,27,28.808,0.0
18218,1044,0,6,0,7,1,2,6.0,0.0
18219,11790,9,70,9,106,36,12,7.778,0.0
1822,3075,0,40,0,45,5,6,8.0,0.0
18221,1312,1,13,1,15,2,2,13.0,0.0
18222,1754,2,19,2,23,4,3,9.5,0.0
18224,211253,0,1986,0,2486,500,501,3.972,0.0
18225,1089,1,5,1,7,2,2,5.0,0.0
18228,164584,212,1913,212,2337,424,213,9.024,0.0
18229,333332,0,4938,0,5438,500,501,9.876,0.0
1823,274490,500,3861,500,4861,1000,501,7.722,0.0
18230,89322,26,749,26,801,52,27,28.808,0.0
18231,220568,0,2500,0,3000,500,501,5.0,0.0
18233,16626,17,136,17,204,68,22,8.0,0.0
18234,3106,4,38,4,46,8,5,9.5,0.0
18235,92372,0,933,0,1169,236,237,3.953,0.0
18236,18777,19,152,19,228,76,22,8.0,0.0
18237,18030,0,192,0,240,48,49,4.0,0.0
18239,1733,1,9,1,13,4,5,9.0,0.0
1824,676207,0,11745,0,12245,500,501,23.49,0.0
18243,12943,10,236,10,256,20,11,23.6,0.0
18244,59445,0,776,0,878,102,103,7.608,0.0
18245,5623,0,54,0,62,8,9,6.75,0.0
18246,13070,22,151,22,195,44,23,6.864,0.0
18247,347914,500,4000,500,5000,1000,501,8.0,0.0
18248,2062518,0,60282,0,60782,500,501,120.564,0.0
18249,76270,83,824,83,990,166,84,9.928,0.0
18250,327550,0,3000,0,3500,500,501,6.0,0.0
18251,50616,0,684,0,781,97,98,7.052,0.0
18252,5094,11,44,11,66,22,13,4.0,0.0
18253,915385,500,23000,500,24000,1000,501,46.0,0.0
18254,410660,500,6000,500,7000,1000,502,12.0,0.0
18255,1111,0,8,0,9,1,2,8.0,0.0
18256,11729,8,65,8,97,32,11,8.125,0.0
18257,386360,500,5388,500,6388,1000,501,10.776,0.0
18258,391299,201,9181,201,9583,402,202,45.677,0.0
18259,2994,2,28,2,32,4,3,14.0,0.0
18261,586634,500,8765,500,9765,1000,501,17.53,0.0
18262,42525,44,480,44,568,88,45,10.909,0.0
18263,476672,315,5157,315,5787,630,316,16.371,0.0
18265,22080,31,248,31,341,93,34,8.0,0.0
18266,31088,13,182,13,208,26,14,14.0,0.0
18267,293613,0,4245,0,4745,500,501,8.49,0.0
18268,24115,51,240,51,342,102,52,4.706,0.0
18269,89051,26,749,26,801,52,27,28.808,0.0
1827,256159,438,3412,438,4288,876,440,7.79,0.0
18270,248723,0,3822,0,4322,500,501,7.644,0.0
18273,15795,12,96,12,144,48,15,8.0,0.0
18275,2210,4,20,4,28,8,5,5.0,0.0
18276,61056,42,377,42,545,168,45,8.976,0.0
18277,5022,4,32,4,48,16,7,8.0,0.0
18278,5815,5,40,5,60,20,8,8.0,0.0
18279,401553,500,5459,500,6954,1495,996,10.918,0.0
1828,812169,0,13992,0,14492,500,501,27.984,0.0
18283,225402,249,4069,249,4567,498,250,16.341,0.0
18288,93967,79,631,79,947,316,125,7.987,0.0
18289,327194,0,3000,0,3500,500,501,6.0,0.0
18291,1367,1,9,1,11,2,2,9.0,0.0
18292,265838,500,3497,500,4497,1000,501,6.994,0.0
18293,500194,134,13936,134,14204,268,135,104.0,0.0
18294,2043,3,18,3,24,6,4,6.0,0.0
18295,11425,28,115,28,171,56,29,4.107,0.0
18297,30664,33,330,33,396,66,34,10.0,0.0
18298,378763,500,3000,500,4000,1000,501,6.0,0.0
1830,225890,0,2803,0,3071,268,269,10.459,0.0
18300,30843,36,276,36,348,72,37,7.667,0.0
18303,35772,31,186,31,298,112,52,6.0,0.0
18304,434084,500,5747,500,6747,1000,501,11.494,0.0
18305,8710,13,143,13,169,26,14,11.0,0.0
18309,20269,15,210,15,240,30,16,14.0,0.0
18310,15870,30,143,30,203,60,31,4.767,0.0
18311,16909,19,160,19,217,57,21,8.421,0.0
18312,208719,0,2000,0,2500,500,501,4.0,0.0
18314,167936,0,2940,0,3234,294,295,10.0,0.0
18317,209255,0,2500,0,3000,500,501,5.0,0.0
18318,61397,42,377,42,545,168,45,8.976,0.0
18321,1469897,0,51599,0,52099,500,501,103.198,0.0
18322,171533,190,2487,190,2867,380,191,13.089,0.0
18323,1566,1,20,1,22,2,2,20.0,0.0
18324,13678,14,226,14,254,28,15,16.143,0.0
18325,311028,0,4058,0,4558,500,501,8.116,0.0
18326,440559,500,7792,500,8792,1000,501,15.584,0.0
18328,211249,0,2500,0,3000,500,501,5.0,0.0
18329,34205,49,490,49,588,98,50,10.0,0.0
1833,1583,3,9,3,15,6,4,3.0,0.0
18330,198712,115,1713,115,1943,230,116,14.896,0.0
18331,23953,51,240,51,342,102,52,4.706,0.0
18332,3764,5,55,5,65,10,6,11.0,0.0
18333,540328,0,6834,0,6968,134,135,51.0,0.0
18334,22831,23,161,23,253,92,49,7.0,0.0
18338,295238,193,1930,193,2316,386,194,10.0,0.0
18339,402382,500,6345,500,7345,1000,501,12.69,0.0
1834,74949,204,612,204,1020,408,205,3.0,0.0
18340,119774,166,1506,166,1838,332,167,9.072,0.0
18342,89174,0,945,0,1064,119,120,7.941,0.0
18344,1904359,0,58514,0,59014,500,501,117.028,0.0
18346,373319,248,2728,248,3224,496,249,11.0,0.0
18348,332103,336,5056,336,6062,1006,668,15.048,0.0
18349,11705,8,112,8,128,16,9,14.0,0.0
18350,27438,68,268,68,404,136,69,3.941,0.0
18351,334346,500,5000,500,6000,1000,501,10.0,0.0
18353,10706,12,144,12,168,24,13,12.0,0.0
18354,3020,3,40,3,46,6,4,13.333,0.0
18357,52252,44,1452,44,1540,88,45,33.0,0.0
18362,208174,0,2500,0,3000,500,501,5.0,0.0
18364,3739,5,35,5,45,10,6,7.0,0.0
18365,25768,34,306,34,374,68,35,9.0,0.0
18366,432685,500,7474,500,8474,1000,502,14.948,0.0
18369,701511,0,14463,0,14963,500,501,28.926,0.0
1837,138691,0,2152,0,2303,151,152,14.252,0.0
18370,1645,1,6,1,10,4,4,6.0,0.0
18372,251525,0,2380,0,2777,397,398,5.995,0.0
18374,2212,0,30,0,32,2,3,15.0,0.0
18376,50227,54,420,54,632,212,69,7.778,0.0
18377,1467,1,13,1,15,2,2,13.0,0.0
18379,4811,0,60,0,64,4,5,15.0,0.0
1838,253747,0,2974,0,3474,500,501,5.948,0.0
18380,11877,13,104,13,130,26,14,8.0,0.0
18381,367241,0,3671,0,4171,500,501,7.342,0.0
18384,41382,66,601,66,733,132,67,9.106,0.0
18385,98839,119,1033,119,1271,238,120,8.681,0.0
18386,17603,27,135,27,216,81,55,5.0,0.0
18387,220216,500,3000,500,4000,1000,501,6.0,0.0
18388,50084,74,814,74,962,148,75,11.0,0.0
1839,352780,0,7140,0,7560,420,421,17.0,0.0
18390,1944,1,6,1,10,4,4,6.0,0.0
18391,58802,0,620,0,775,155,156,4.0,0.0
18393,57781,0,755,0,854,99,100,7.626,0.0
18395,4136,5,58,5,68,10,6,11.6,0.0
18396,11964,12,180,12,204,24,13,15.0,0.0
18398,11569,27,108,27,162,54,28,4.0,0.0
1840,57474,0,1120,0,1190,70,71,16.0,0.0
18401,267855,317,3729,317,4363,634,318,11.763,0.0
18402,176960,0,2055,0,2466,411,412,5.0,0.0
18403,426945,500,4430,500,5430,1000,501,8.86,0.0
18404,258535,500,3515,500,4515,1000,501,7.03,0.0
18407,214275,478,2390,478,3346,956,479,5.0,0.0
18408,138532,140,1626,140,1906,280,141,11.614,0.0
1841,418366,0,8500,0,9000,500,501,17.0,0.0
18410,11797,17,191,17,225,34,18,11.235,0.0
18411,453909,500,5998,500,6998,1000,501,11.996,0.0
18413,1647468,500,7929,500,8929,1000,501,15.858,0.0
18415,13146,22,151,22,195,44,23,6.864,0.0
18416,9253,9,162,9,180,18,10,18.0,0.0
18417,613347,14,56,14,84,28,15,4.0,0.0
18418,6822,0,75,0,90,15,16,5.0,0.0
18419,9985,9,72,9,108,36,12,8.0,0.0
1842,375274,0,6074,0,6574,500,501,12.148,0.0
18426,1846,3,15,3,21,6,4,5.0,0.0
18427,172215,0,2069,0,2483,414,415,4.998,0.0
18430,499856,0,13936,0,14070,134,135,104.0,0.0
18431,31934,39,474,39,552,78,40,12.154,0.0
18432,85118,0,1080,0,1218,138,139,7.826,0.0
18433,29565,35,265,35,405,140,46,7.571,0.0
18434,16122,25,225,25,275,50,26,9.0,0.0
18436,203139,0,2500,0,3000,500,501,5.0,0.0
18438,90444,119,944,119,1182,238,120,7.933,0.0
18439,5025,0,55,0,66,11,12,5.0,0.0
1844,4624,0,60,0,64,4,5,15.0,0.0
18441,603569,416,4342,416,5174,832,418,10.438,0.0
18443,358331,500,4749,500,5749,1000,501,9.498,0.0
18444,2721644,0,6,0,7,1,2,6.0,0.0
18445,73801,115,803,115,1033,230,116,6.983,0.0
18446,27470,61,305,61,427,122,62,5.0,0.0
18449,8642,12,96,12,120,24,13,8.0,0.0
1845,212398,0,2000,0,2500,500,501,4.0,0.0
18452,4265,9,36,9,54,18,10,4.0,0.0
18453,428999,500,7546,500,8546,1000,501,15.092,0.0
18454,305649,500,4000,500,5000,1000,501,8.0,0.0
18455,1351905,278,10937,278,11493,556,279,39.342,0.0
18456,300322,0,4204,0,4704,500,501,8.408,0.0
18457,89030,26,749,26,801,52,27,28.808,0.0
18458,12517,11,88,11,132,44,17,8.0,0.0
18459,29414,0,350,0,420,70,71,5.0,0.0
18460,207264,0,2363,0,2836,473,474,4.996,0.0
18461,47366,134,402,134,670,268,135,3.0,0.0
18462,558607,0,6447,0,6947,500,501,12.894,0.0
18465,283587,58,516,58,632,116,59,8.897,0.0
18466,574826,500,10999,500,11999,1000,501,21.998,0.0
18468,2292,0,20,0,24,4,5,5.0,0.0
18472,1232,1,8,1,10,2,2,8.0,0.0
18473,67268,0,770,0,880,110,111,7.0,0.0
18474,14969,18,221,18,257,36,19,12.278,0.0
18475,162245,0,1512,0,1631,119,120,12.706,0.0
18477,10204,4,137,4,153,16,13,34.25,0.0
18478,355601,500,3500,500,4500,1000,501,7.0,0.0
1848,9044,18,83,18,119,36,19,4.611,0.0
18480,7508,17,85,17,119,34,18,5.0,0.0
18481,203763,0,2488,0,2988,500,501,4.976,0.0
18483,7377,0,64,0,71,7,8,9.143,0.0
18484,22103,22,176,22,264,88,25,8.0,0.0
18485,81020,184,1197,184,1565,368,185,6.505,0.0
18486,16900,0,223,0,248,25,26,8.92,0.0
18487,462045,500,5979,500,6979,1000,501,11.958,0.0
18488,13149,16,121,16,185,64,22,7.562,0.0
18489,9638,20,100,20,140,40,21,5.0,0.0
18490,5897,5,30,5,50,20,12,6.0,0.0
18491,397619,500,4500,500,5500,1000,501,9.0,0.0
18492,8148,0,117,0,130,13,14,9.0,0.0
18493,32998,46,200,46,292,92,47,4.348,0.0
18495,17705,12,84,12,132,48,27,7.0,0.0
18496,575070,500,4500,500,5500,1000,501,9.0,0.0
18497,22203,49,245,49,343,98,50,5.0,0.0
18503,17922,13,273,13,299,26,14,21.0,0.0
18505,6424,6,72,6,84,12,7,12.0,0.0
18506,1470,0,15,0,16,1,2,15.0,0.0
18508,204288,0,2501,0,3001,500,501,5.002,0.0
1851,1643638,0,36000,0,36500,500,501,72.0,0.0
18510,2720,2,37,2,41,4,3,18.5,0.0
18514,85358,133,1064,133,1330,266,134,8.0,0.0
18515,1226,1,10,1,12,2,2,10.0,0.0
18516,37574,0,360,0,480,120,65,6.0,0.0
18517,292535,500,5000,500,6000,1000,501,10.0,0.0
18518,391667,422,5659,422,6912,1253,794,13.41,0.0
18519,115435,163,1452,163,1778,326,164,8.908,0.0
18521,184846,314,2511,314,3139,628,315,7.997,0.0
18522,18371,21,301,21,343,42,22,14.333,0.0
18523,78981,133,1313,133,1579,266,134,9.872,0.0
18524,267605,500,2613,500,3613,1000,501,5.226,0.0
18525,253676,500,2966,500,3966,1000,501,5.932,0.0
18526,46355,0,590,0,649,59,60,10.0,0.0
18529,145665,149,1713,149,2011,298,150,11.497,0.0
18533,13282,12,196,12,220,24,13,16.333,0.0
18534,994,1,2,1,4,2,2,2.0,0.0
18535,613404,14,56,14,84,28,15,4.0,0.0
18537,6641,5,30,5,50,20,12,6.0,0.0
18538,68995,76,920,76,1148,228,153,12.105,0.0
18539,80508,50,401,50,601,200,53,8.02,0.0
1854,899,1,2,1,4,2,2,2.0,0.0
18540,141187,0,1670,0,2004,334,335,5.0,0.0
18541,31971,33,495,33,561,66,34,15.0,0.0
18542,74450,44,806,44,894,88,45,18.318,0.0
18544,21511,32,222,32,286,64,33,6.938,0.0
18545,120520,167,1513,167,1847,334,168,9.06,0.0
18546,5409,4,56,4,68,12,9,14.0,0.0
18548,3126,5,20,5,30,10,6,4.0,0.0
18550,6642,6,47,6,71,24,9,7.833,0.0
18553,1928,3,15,3,21,6,4,5.0,0.0
18554,619066,500,10000,500,11000,1000,501,20.0,0.0
18555,278186,500,3500,500,4500,1000,501,7.0,0.0
18557,281690,500,4014,500,5014,1000,501,8.028,0.0
18559,553833,500,9142,500,10142,1000,501,18.284,0.0
18560,1947,1,21,1,23,2,2,21.0,0.0
18562,29435,47,517,47,611,94,48,11.0,0.0
18563,143115,128,2816,128,3200,384,258,11.0,0.0
18564,1945,2,22,2,26,4,3,11.0,0.0
18565,325723,489,5511,489,6489,978,490,11.27,0.0
18566,442269,500,7860,500,8860,1000,501,15.72,0.0
18568,44648,37,429,37,503,74,38,11.595,0.0
18570,3645,3,30,3,36,6,4,10.0,0.0
18571,278337,500,3500,500,4500,1000,501,7.0,0.0
18572,466491,0,5490,0,5990,500,501,10.98,0.0
18574,23510,56,224,56,336,112,57,4.0,0.0
18575,11107,27,96,27,150,54,28,3.556,0.0
18576,188132,309,2472,309,3090,618,310,8.0,0.0
18577,343375,500,4500,500,5500,1000,501,9.0,0.0
18579,3009,2,18,2,26,8,5,9.0,0.0
1858,388897,500,5489,500,6489,1000,501,10.978,0.0
18581,6355,5,40,5,74,34,14,8.0,0.0
18582,44944,0,456,0,570,114,115,4.0,0.0
18583,5303,4,32,4,48,16,7,8.0,0.0
18584,191544,42,252,42,420,168,86,6.0,0.0
18585,7134,11,110,11,132,22,12,10.0,0.0
18586,186924,0,2000,0,2500,500,501,4.0,0.0
18587,3065,2,17,2,25,8,5,8.5,0.0
18588,346274,0,4000,0,4500,500,501,8.0,0.0
18589,3468,7,28,7,42,14,8,4.0,0.0
18590,108303,133,1330,133,1596,266,134,10.0,0.0
18591,59697,44,968,44,1056,88,45,22.0,0.0
18592,98945,0,2144,0,2278,134,135,16.0,0.0
18595,423603,0,5451,0,5951,500,501,10.902,0.0
18597,1239,1,6,1,8,2,2,6.0,0.0
18598,34717,31,186,31,298,112,52,6.0,0.0
18599,300936,0,4571,0,5071,500,501,9.142,0.0
18600,14505,24,192,24,240,48,25,8.0,0.0
18601,92915,0,852,0,1046,194,194,7.16,0.0
18602,5730,4,24,4,40,16,10,6.0,0.0
18603,4844,6,66,6,78,12,7,11.0,0.0
18604,8056,13,117,13,143,26,14,9.0,0.0
18605,162200,0,1502,0,1621,119,120,12.622,0.0
18606,356657,0,3354,0,3854,500,501,6.708,0.0
18608,437757,500,5496,500,6496,1000,501,10.992,0.0
18609,8294,0,77,0,88,11,12,7.0,0.0
18610,2021,2,22,2,26,4,3,11.0,0.0
18611,8612,12,96,12,120,24,13,8.0,0.0
18612,6339,8,72,8,88,16,9,9.0,0.0
18614,500321,402,8040,402,8844,804,403,20.0,0.0
18615,12911,0,132,0,165,33,34,4.0,0.0
18616,4925,8,35,8,51,16,9,4.375,0.0
18617,416069,500,5704,500,6704,1000,501,11.408,0.0
18618,1205668,248,9757,248,10253,496,249,39.343,0.0
18619,10946,22,132,22,176,44,23,6.0,0.0
18622,1801,0,15,0,18,3,4,5.0,0.0
18626,33888,36,360,36,432,72,37,10.0,0.0
18627,306628,500,3500,500,4500,1000,501,7.0,0.0
18628,117340,124,925,124,1421,496,160,7.46,0.0
18630,1639,1,9,1,13,4,4,9.0,0.0
18631,4008,7,35,7,49,14,8,5.0,0.0
18632,927831,500,12098,500,14098,2000,1501,24.196,0.0
18633,1206853,248,9757,248,10253,496,249,39.343,0.0
18634,4556,4,20,4,32,12,6,5.0,0.0
18635,314557,500,3000,500,4000,1000,501,6.0,0.0
18636,5421,0,60,0,72,12,13,5.0,0.0
18638,2030,2,22,2,26,4,3,11.0,0.0
18639,284853,0,4080,0,4580,500,501,8.16,0.0
18642,14590,32,160,32,224,64,33,5.0,0.0
18643,16244,0,162,0,189,27,28,6.0,0.0
18644,88589,26,749,26,801,52,27,28.808,0.0
18645,119702,278,1385,278,1941,556,279,4.982,0.0
18648,12566,14,238,14,266,28,15,17.0,0.0
18651,155567,153,2423,153,2729,306,154,15.837,0.0
18652,83902,174,1044,174,1392,348,175,6.0,0.0
18653,332776,0,5000,0,5500,500,501,10.0,0.0
18654,491951,0,6030,0,6164,134,135,45.0,0.0
18655,490360,500,5000,500,6000,1000,501,10.0,0.0
18658,6880,9,63,9,81,18,10,7.0,0.0
18660,54621,0,480,0,539,59,60,8.136,0.0
18661,1223,1,9,1,11,2,2,9.0,0.0
18665,17873,0,210,0,252,42,43,5.0,0.0
18667,27716,43,341,43,427,86,44,7.93,0.0
18668,535946,500,7024,500,8024,1000,501,14.048,0.0
18669,98574,0,2144,0,2278,134,135,16.0,0.0
18670,15435,30,143,30,203,60,31,4.767,0.0
18671,25565,53,248,53,354,106,54,4.679,0.0
18672,12373,25,125,25,175,50,26,5.0,0.0
18673,607098,0,8453,0,8953,500,501,16.906,0.0
18676,373756,490,4900,490,5880,980,491,10.0,0.0
18677,9187,10,162,10,182,20,11,16.2,0.0
18678,9926,12,128,12,163,35,24,10.667,0.0
18679,1880,0,14,0,15,1,2,14.0,0.0
18680,25588,52,244,52,348,104,53,4.692,0.0
18681,29749,27,480,27,534,54,28,17.778,0.0
18682,4150,3,42,3,48,6,4,14.0,0.0
18683,5432,5,35,5,55,20,12,7.0,0.0
18684,1552,1,11,1,13,2,2,11.0,0.0
18685,17317,36,216,36,288,72,37,6.0,0.0
18686,324154,500,5000,500,6000,1000,501,10.0,0.0
18688,285527,500,3000,500,4000,1000,501,6.0,0.0
18691,472160,134,6834,134,7102,268,135,51.0,0.0
18692,18614,13,79,13,131,52,28,6.077,0.0
18694,5664,4,56,4,64,8,5,14.0,0.0
18695,386757,133,14098,133,14364,266,134,106.0,0.0
18696,411001,500,5000,500,6000,1000,501,10.0,0.0
18697,373642,500,4924,500,5924,1000,501,9.848,0.0
1870,259202,0,4000,0,4500,500,501,8.0,0.0
18700,3351,6,36,6,48,12,7,6.0,0.0
18703,393056,500,5000,500,6000,1000,501,10.0,0.0
18704,41126,35,305,35,495,190,74,8.714,0.0
18705,7093,10,110,10,130,20,11,11.0,0.0
18706,62924,43,310,43,482,172,46,7.209,0.0
18709,66473,53,846,53,952,106,54,15.962,0.0
1871,517218,0,6000,0,6500,500,501,12.0,0.0
18710,13238,0,165,0,184,19,20,8.684,0.0
18712,555955,500,3998,500,4998,1000,501,7.996,0.0
18714,19595,0,230,0,276,46,47,5.0,0.0
18716,15897,30,143,30,203,60,31,4.767,0.0
18717,78197,0,1223,0,1331,108,109,11.324,0.0
18718,19257,23,252,23,321,69,47,10.957,0.0
18719,654236,500,5661,500,6661,1000,501,11.322,0.0
1872,10826,10,69,10,93,24,15,6.9,0.5
18720,311158,500,3500,500,4500,1000,501,7.0,0.0
18721,201828,500,2500,500,3500,1000,501,5.0,0.0
18722,22900,35,280,35,350,70,36,8.0,0.0
18724,1943472,0,57341,0,57841,500,501,114.682,0.0
18726,2810,3,21,3,27,6,4,7.0,0.0
18727,3382,4,28,4,36,8,5,7.0,0.0
18728,22702,0,250,0,300,50,51,5.0,0.0
18729,6388,16,48,16,80,32,17,3.0,0.0
18730,608841,500,10046,500,11046,1000,501,20.092,0.0
18731,7476,11,88,11,110,22,12,8.0,0.0
18733,9723,8,49,8,81,32,18,6.125,0.0
18734,20588,19,385,19,423,38,20,20.263,0.0
18735,2696,6,18,6,30,12,7,3.0,0.0
18736,1406095,236,9738,236,10210,472,237,41.263,0.0
18737,6794,9,90,9,108,18,10,10.0,0.0
18738,4465,10,40,10,60,20,11,4.0,0.0
18739,72539,88,989,88,1165,176,89,11.239,0.0
18740,1549,1,12,1,14,2,2,12.0,0.0
18741,284304,0,2486,0,2901,415,416,5.99,0.0
18742,51937,69,453,69,591,138,70,6.565,0.0
18743,692440,500,11398,500,12398,1000,501,22.796,0.0
18744,73009,0,988,0,1101,113,114,8.743,0.0
18747,13587,19,167,19,222,55,33,8.789,0.0
18748,74561,115,805,115,1035,230,116,7.0,0.0
1875,10759,0,170,0,186,16,17,10.625,0.0
18750,6853,10,110,10,130,20,11,11.0,0.0
18751,15288,23,253,23,299,46,24,11.0,0.0
18752,321435,0,4000,0,4500,500,501,8.0,0.0
18753,2918,5,30,5,40,10,6,6.0,0.0
18754,205140,500,2500,500,3500,1000,501,5.0,0.0
18756,41691,44,524,44,612,88,45,11.909,0.0
18757,13338,11,185,11,207,22,12,16.818,0.0
18758,88389,64,534,64,790,256,67,8.344,0.0
18761,252209,0,3552,0,4052,500,501,7.104,0.0
18762,2304,3,27,3,33,6,4,9.0,0.0
18763,82272,184,1201,184,1569,368,185,6.527,0.0
18764,5803,4,34,4,50,16,7,8.5,0.0
18765,15964,13,182,13,208,26,14,14.0,0.0
18766,208158,0,2499,0,2999,500,501,4.998,0.0
18767,335427,0,3000,0,3500,500,501,6.0,0.0
18769,3648,3,30,3,36,6,4,10.0,0.0
18770,466942,500,4995,500,5995,1000,501,9.99,0.0
18771,12362,27,135,27,189,54,28,5.0,0.0
18772,316702,0,3000,0,3500,500,501,6.0,0.0
18773,12067,18,144,18,180,36,19,8.0,0.0
18775,338543,500,5000,500,6000,1000,501,10.0,0.0
18776,12490,16,140,16,178,38,20,8.75,0.0
18779,323601,500,3004,500,4004,1000,501,6.008,0.0
18781,17952,24,192,24,264,72,26,8.0,0.0
18784,263822,99,871,99,1069,198,100,8.798,0.0
18786,434399,500,3706,500,4706,1000,501,7.412,0.0
18789,675847,0,10550,0,11050,500,501,21.1,0.0
18790,47127,0,643,0,697,54,55,11.907,0.0
18791,80284,184,1197,184,1565,368,185,6.505,0.0
18792,139793,141,1637,141,1919,282,142,11.61,0.0
18793,4364,4,72,4,80,8,5,18.0,0.0
18795,3808,0,32,0,34,2,3,16.0,0.0
18796,295022,500,3000,500,4000,1000,501,6.0,0.0
1880,15715,0,180,0,210,30,31,12.0,0.0
18801,42441,44,460,44,548,88,45,10.455,0.0
18802,5087,6,54,6,66,12,7,9.0,0.0
18805,3885,0,46,0,52,6,7,7.667,0.0
18806,72289,82,632,82,878,246,84,7.707,0.0
18807,4897,5,45,5,55,10,6,9.0,0.0
18808,206375,500,2500,500,3500,1000,501,5.0,0.0
18809,4083,5,35,5,45,10,6,7.0,0.0
18810,178725,193,1521,193,2287,766,306,7.881,0.0
18811,568901,1000,10093,1000,12093,2000,1002,10.093,0.0
18812,2396442,500,19710,500,20710,1000,501,39.42,0.0
18815,5424,12,60,12,84,24,13,5.0,0.0
18817,1954,1,6,1,10,4,4,6.0,0.0
18818,3183,4,44,4,52,8,5,11.0,0.0
18819,989,1,5,1,7,2,2,5.0,0.0
1882,253637,0,3000,0,3500,500,501,6.0,0.0
18821,5380,5,40,5,60,20,8,8.0,0.0
18823,65403,110,880,110,1100,220,111,8.0,0.0
18824,417763,133,6251,133,6517,266,134,47.0,0.0
18826,1551,1,11,1,13,2,2,11.0,0.0
18827,129450,119,1505,119,1743,238,120,12.647,0.0
1883,1473505,0,31500,0,32000,500,501,63.0,0.0
18830,6668,0,75,0,90,15,16,5.0,0.0
18831,275893,500,4022,500,5022,1000,501,8.044,0.0
18832,15371,14,270,14,298,28,15,19.286,0.0
18833,7509,13,78,13,104,26,14,6.0,0.0
18834,32692,44,518,44,606,88,46,11.773,0.0
18835,422680,500,5501,500,6501,1000,501,11.002,0.0
18837,305724,38,2878,38,2954,76,39,75.737,0.0
18838,2406,3,30,3,36,6,4,10.0,0.0
18839,339852,0,3000,0,3500,500,501,6.0,0.0
1884,124397,0,2197,0,2399,202,203,10.876,0.0
18841,282332,500,4000,500,5000,1000,501,8.0,0.0
18842,203864,0,2500,0,3000,500,501,5.0,0.0
18844,46861,48,544,48,640,96,49,11.333,0.0
18845,83341,174,1044,174,1392,348,175,6.0,0.0
18846,4927,8,56,8,72,16,9,7.0,0.0
18847,2898,1,21,1,23,2,2,21.0,0.0
18848,16004,0,242,0,264,22,23,11.0,0.0
18849,105545,0,1079,0,1214,135,136,7.993,0.0
1885,19116,0,208,0,224,16,17,13.0,0.0
18850,222473,500,2500,500,3500,1000,501,5.0,0.0
18851,393292,500,5166,500,6166,1000,501,10.332,0.0
18852,477027,133,7049,133,7315,266,134,53.0,0.0
18853,689420,384,9216,384,9984,768,385,24.0,0.0
18855,6918,3,19,3,31,12,8,6.333,0.0
18856,19554,44,258,44,346,88,45,5.864,0.0
18857,38900,98,392,98,588,196,99,4.0,0.0
18858,13145,12,198,12,234,36,26,8.25,0.0
1886,253704,0,2946,0,3321,375,376,7.856,0.5
18860,131667,192,1728,192,2112,384,193,9.0,0.0
18862,215224,0,2497,0,2997,500,501,4.994,0.0
18864,1742,2,18,2,22,4,3,9.0,0.0
18865,6616,6,108,6,120,12,7,18.0,0.0
18869,422602,500,5513,500,6513,1000,501,11.026,0.0
1887,24747,0,256,0,304,48,19,16.0,0.0
18871,209164,0,2500,0,3000,500,501,5.0,0.0
18872,172417,0,1736,0,2170,434,435,4.0,0.0
18873,4617,10,50,10,70,20,11,5.0,0.0
18874,265398,0,3704,0,4204,500,501,7.408,0.0
18875,5441,8,67,8,83,16,9,8.375,0.0
18878,21870,26,200,26,252,52,27,7.692,0.0
1888,122010,0,2333,0,2493,160,161,14.581,0.0
18880,55479,0,648,0,756,108,109,6.0,0.0
18882,13076,22,151,22,195,44,23,6.864,0.0
18883,1963,3,14,3,20,6,4,4.667,0.0
18884,24163,51,240,51,342,102,52,4.706,0.0
18885,76191,65,1081,65,1211,130,66,16.631,0.0
18886,6604,15,45,15,75,30,16,3.0,0.0
18888,1228,1,11,1,13,2,2,11.0,0.0
18889,1577,1,16,1,18,2,2,16.0,0.0
1889,869536,0,10730,0,11822,1092,1014,21.46,1.0
18890,5052,4,32,4,48,16,7,8.0,0.0
18891,12531,7,189,7,210,21,10,27.0,0.0
18892,15244,12,108,12,156,48,15,9.0,0.0
18893,90221,119,944,119,1182,238,120,7.933,0.0
18894,1389,2,10,2,14,4,3,5.0,0.0
18895,9060,14,112,14,140,28,15,8.0,0.0
18896,293400,448,4032,448,4928,896,449,9.0,0.0
18898,11106,27,108,27,162,54,28,4.0,0.0
18899,755519,500,14500,500,15500,1000,501,29.0,0.0
1890,21374,27,291,27,345,54,28,10.778,0.0
18901,3038,5,30,5,40,10,6,6.0,0.0
18902,10346,8,72,8,104,32,11,9.0,0.0
18903,709217,500,7998,500,9422,1424,527,15.996,0.0
18904,285084,0,2824,0,3324,500,501,5.648,0.0
18906,329533,0,3000,0,3500,500,501,6.0,0.0
18907,59055,0,770,0,871,101,102,7.624,0.0
18908,97563,222,888,222,1332,444,223,4.0,0.0
18909,332808,0,3000,0,3500,500,501,6.0,0.0
1891,68512,0,783,0,875,92,93,8.511,0.0
18910,14202599,176,1408,176,1760,352,178,8.0,0.0
18911,57977,0,757,0,856,99,100,7.646,0.0
18912,435906,500,4578,500,5578,1000,502,9.156,0.0
18913,49553,52,575,52,679,104,53,11.058,0.0
18914,33606,0,352,0,440,88,89,4.0,0.0
18915,192095,500,2000,500,3000,1000,501,4.0,0.0
18916,3075,6,18,6,30,12,7,3.0,0.0
18917,292621,0,4229,0,4729,500,501,8.458,0.0
18920,1277,1,12,1,14,2,2,12.0,0.0
18921,152097,303,2121,303,2727,606,304,7.0,0.0
18922,248295,500,3000,500,4000,1000,501,6.0,0.0
18923,45404,87,519,87,693,174,88,5.966,0.0
18924,2130,4,16,4,24,8,5,4.0,0.0
18926,21795,31,341,31,403,62,32,11.0,0.0
18929,8557,13,104,13,130,26,14,8.0,0.0
18930,143115,128,2816,128,3200,384,258,11.0,0.0
18932,112032,0,1566,0,1665,99,100,15.818,0.0
18933,12780,19,209,19,247,38,20,11.0,0.0
18934,4837,11,33,11,55,22,12,3.0,0.0
18936,3386,7,28,7,42,14,8,4.0,0.0
18937,50456,0,601,0,722,121,122,4.967,0.0
18938,22638,0,182,0,196,14,15,13.0,0.0
18939,4035,5,45,5,55,10,6,9.0,0.0
18942,6655,0,75,0,90,15,16,5.0,0.0
18945,52612,37,333,37,528,195,52,9.0,0.0
18946,354482,500,6000,500,7000,1000,501,12.0,0.0
18947,464873,500,5438,500,6438,1000,501,10.876,0.0
18949,5515,5,37,5,57,20,8,7.4,0.0
18952,18300,19,152,19,228,76,22,8.0,0.0
18953,15578,11,89,11,133,44,14,8.091,0.0
18954,513711,134,13936,134,14204,268,135,104.0,0.0
18956,73859,108,1098,108,1314,216,109,10.167,0.0
18957,502591,409,6610,409,7428,818,410,16.161,0.0
18958,2248,0,20,0,24,4,5,5.0,0.0
18959,8055,12,108,12,132,24,13,9.0,0.0
1896,804227,0,13885,0,14385,500,501,27.77,0.0
18960,9681,0,97,0,113,16,17,6.062,0.0
18962,102856,0,1155,0,1386,231,232,5.0,0.0
18963,926771,101,16867,101,17069,202,102,167.0,0.0
18965,3377,2,42,2,46,4,3,21.0,0.0
18966,214280,0,2500,0,3000,500,501,5.0,0.0
18968,219934,189,3780,189,4158,378,190,20.0,0.0
18969,126469,78,651,78,963,312,83,8.346,0.0
18972,280801,500,3500,500,4500,1000,501,7.0,0.0
18973,11058,27,96,27,150,54,28,3.556,0.0
18975,253651,0,3256,0,3594,338,325,16.612,0.0
18976,16528,12,99,12,147,48,15,8.25,0.0
18977,11208,0,131,0,158,27,28,4.852,0.0
18978,1954,2,22,2,26,4,3,11.0,0.0
1898,8945,26,78,26,130,52,27,3.0,0.0
18980,67514,76,595,76,888,293,117,7.829,0.0
18981,44990,44,572,44,660,88,45,13.0,0.0
18982,234614,0,2500,0,3000,500,501,5.0,0.0
18983,155485,168,2862,168,3198,336,169,17.036,0.0
18984,6261,14,70,14,98,28,15,5.0,0.0
18987,3335,0,30,0,36,6,7,5.0,0.0
18988,131545,169,845,169,1183,338,170,5.0,0.0
18989,17435,0,209,0,251,42,43,4.976,0.0
1899,51748,98,784,98,980,196,99,8.0,0.0
18990,6712,5,45,5,60,15,7,9.0,0.0
18991,5551,6,55,6,73,18,12,9.167,0.0
18992,5788,5,40,5,60,20,8,8.0,0.0
18995,418106,437,5244,437,6118,874,438,12.0,0.0
18996,280328,316,2439,316,3649,1210,503,7.718,0.0
18997,23000,13,117,13,143,26,14,9.0,0.0
18998,65350,50,1095,50,1195,100,51,21.9,0.0
18999,5697,11,55,11,77,22,12,5.0,0.0
1900,51190,97,776,97,970,194,98,8.0,0.0
19001,25143,31,403,31,465,62,32,13.0,0.0
19002,352120,0,3000,0,3500,500,501,6.0,0.0
19005,1324,1,12,1,14,2,2,12.0,0.0
19006,450389,500,5499,500,6499,1000,501,10.998,0.0
19007,17072,30,210,30,270,60,31,7.0,0.0
19008,308906,0,4500,0,5000,500,501,9.0,0.0
19009,85071,0,1582,0,1695,113,114,14.0,0.0
1901,51748,98,784,98,980,196,99,8.0,0.0
19011,1683,1,8,1,12,4,4,8.0,0.0
19012,19266,0,219,0,281,62,61,6.844,0.0
19013,282410,0,2998,0,3498,500,501,5.996,0.0
19014,316988,0,3000,0,3500,500,501,6.0,0.0
19015,965349,500,11481,500,12481,1000,501,22.962,0.0
19016,6329,6,36,6,60,24,14,6.0,0.0
19017,301472,0,3500,0,4000,500,501,7.0,0.0
19018,226015,500,2500,500,3500,1000,501,5.0,0.0
1902,51190,97,776,97,970,194,98,8.0,0.0
19020,269197,0,3121,0,3551,430,431,7.258,0.0
19021,15071,11,121,11,143,22,12,11.0,0.0
19022,856038,8,48,8,64,16,10,6.0,0.0
19023,105741,0,1072,0,1206,134,135,8.0,0.0
19024,6102,9,72,9,90,18,10,8.0,0.0
19027,1639,1,19,1,21,2,2,19.0,0.0
19028,30318,31,247,31,371,124,34,7.968,0.0
1903,298973,500,5256,500,6256,1000,501,10.512,0.0
19030,15303,30,143,30,203,60,31,4.767,0.0
19031,17755,42,292,42,376,84,44,6.952,0.0
19032,79133,162,972,162,1296,324,163,6.0,0.0
19033,1499191,0,51674,0,52174,500,501,103.348,0.0
19034,188821,210,1625,210,2454,829,293,7.738,0.0
19037,3198,0,36,0,39,3,4,12.0,0.0
19039,232480,176,1704,176,2056,352,177,9.682,0.0
19043,11465,26,104,26,156,52,27,4.0,0.0
19045,22168,19,114,19,183,69,33,6.0,0.0
19047,1102,1,7,1,9,2,2,7.0,0.0
19048,85038,50,300,50,450,150,52,6.0,0.0
19049,1636,0,15,0,16,1,2,15.0,0.0
1905,264754,500,3500,500,4500,1000,501,7.0,0.6666666666666666
19051,11212,8,198,8,214,16,9,24.75,0.0
19052,507519,402,8040,402,8844,804,403,20.0,0.0
19053,1378700,0,47250,0,47750,500,501,94.5,0.0
19054,32457,28,560,28,616,56,29,20.0,0.0
19055,186331,0,2205,0,2646,441,442,5.0,0.0
19056,267677,0,3644,0,4144,500,501,7.288,0.0
1906,229910,500,2500,500,3500,1000,501,5.0,0.0
19060,295855,0,4000,0,4500,500,501,8.0,0.0
19062,35974,60,360,60,480,120,61,6.0,0.0
19063,491053,500,6000,500,7000,1000,501,12.0,0.0
19064,723692,500,5200,500,6200,1000,501,10.4,0.0
19066,58157,0,655,0,786,131,132,5.0,0.0
19067,6608,6,48,6,72,24,9,8.0,0.0
1907,223430,500,2500,500,3500,1000,501,5.0,0.0
19070,299563,0,3500,0,4000,500,501,7.0,0.0
19071,4420,0,30,0,40,10,11,3.0,0.0
19073,132787,299,1495,299,2093,598,300,5.0,0.0
19074,925847,101,16867,101,17069,202,102,167.0,0.0
19075,1553,1,11,1,13,2,2,11.0,0.0
19076,172768,221,2873,221,3315,442,222,13.0,0.0
19077,32721,22,111,22,199,88,46,5.045,0.0
19078,376198,500,3625,500,5315,1690,589,7.25,0.0
19080,1135,1,9,1,11,2,2,9.0,0.0
19081,50405,82,656,82,820,164,83,8.0,0.0
19083,4303,1,12,1,14,2,2,12.0,0.0
19084,306503,217,1953,217,2387,434,218,9.0,0.0
19085,1205,1,10,1,12,2,2,10.0,0.0
19087,4827,5,45,5,55,10,6,9.0,0.0
19088,204668,0,2500,0,3000,500,501,5.0,0.0
19089,6505,7,119,7,133,14,8,17.0,0.0
1909,980646,910,9460,910,11280,1820,912,10.396,0.0
19091,1575,1,18,1,20,2,2,18.0,0.0
19092,475374,500,5989,500,6989,1000,501,11.978,0.0
19093,1303,1,11,1,13,2,2,11.0,0.0
19094,102255,230,1150,230,1610,460,231,5.0,0.0
19097,84556,174,1044,174,1392,348,175,6.0,0.0
19098,3197,2,18,2,26,8,5,9.0,0.0
19099,189706,0,2759,0,3131,372,373,7.417,0.0
19100,142761,0,1314,0,1533,219,220,6.0,0.0
19103,14608,0,107,0,127,20,21,5.35,0.0
19104,14143,0,150,0,175,25,26,6.0,0.0
19105,470661,500,9015,500,10015,1000,501,18.03,0.0
19106,7371,5,42,5,62,20,8,8.4,0.0
19107,54397,0,689,0,804,115,116,5.991,0.0
19109,9965,0,144,0,160,16,17,9.0,0.0
1911,1018898,0,12735,0,13235,500,501,25.47,0.0
19110,90224,112,1226,112,1450,224,113,10.946,0.0
19111,535446,500,7017,500,8017,1000,501,14.034,0.0
19112,3784,7,49,7,63,14,8,7.0,0.0
19114,123475,119,1425,119,1663,238,120,11.975,0.0
19115,3647,3,30,3,36,6,4,10.0,0.0
19119,27268,21,168,21,252,84,27,8.0,0.0
1912,244754,500,3577,500,4577,1000,502,7.154,0.0
19120,53256,44,554,44,642,88,45,12.591,0.0
19121,1482,2,12,2,16,4,3,6.0,0.0
19122,304673,500,3500,500,4500,1000,501,7.0,0.0
19124,29000,0,306,0,357,51,52,6.0,0.0
19126,10910,16,80,16,112,32,17,5.0,0.0
19127,396473,0,6527,0,7027,500,501,13.054,0.0
19128,255618,500,2996,500,3996,1000,501,5.992,0.0
19129,960922,98,826,98,1022,196,99,8.429,0.0
19130,1233,1,10,1,12,2,2,10.0,0.0
19131,2021,2,7,2,15,8,6,3.5,0.0
19133,56008,68,504,68,771,267,79,7.412,0.0
19134,60231,136,680,136,952,272,137,5.0,0.0
19135,37602,45,333,45,513,180,60,7.4,0.0
19136,121375,0,1415,0,1698,283,284,5.0,0.0
19137,5427,5,90,5,100,10,6,18.0,0.0
19138,207509,0,2499,0,2999,500,501,4.998,0.0
19139,1332047,274,10781,274,11329,548,275,39.347,0.0
19142,89060,26,749,26,801,52,27,28.808,0.0
19143,74016,0,804,0,938,134,135,6.0,0.0
19144,24317,51,240,51,342,102,52,4.706,0.0
19145,65798,0,1154,0,1231,77,78,14.987,0.0
19146,246325,198,2376,198,2772,396,199,12.0,0.0
19147,7070,0,64,0,69,5,6,12.8,0.0
19148,13064,22,151,22,195,44,23,6.864,0.0
19149,3356,0,35,0,42,7,8,5.0,0.0
19150,404303,0,14244,0,14481,237,238,60.101,0.0
19152,11199,26,104,26,156,52,28,4.0,0.0
19154,11024,0,124,0,149,25,26,4.96,0.0
19155,967832,500,23000,500,24000,1000,501,46.0,0.0
19157,5322,12,36,12,60,24,13,3.0,0.0
19158,7825,7,140,7,154,14,8,20.0,0.0
19159,3253,8,24,8,40,16,9,3.0,0.0
1916,443921,500,8500,500,9500,1000,502,17.0,0.0
19161,247839,0,3771,0,4271,500,501,7.542,0.0
19163,5961,5,40,5,60,20,8,8.0,0.0
19165,456025,500,5500,500,6500,1000,501,11.0,0.0
19166,453760,500,6130,500,7130,1000,501,12.26,0.0
19167,2862364,500,3500,500,4500,1000,501,7.0,0.0
1917,207147,0,2712,0,3212,500,501,5.424,0.0
19171,112649,50,1500,50,1600,100,51,30.0,0.0
19173,1954,2,22,2,26,4,3,11.0,0.0
19174,352627,0,4500,0,5000,500,501,9.0,0.0
19175,2639,0,28,0,32,4,5,7.0,0.0
19176,120758,0,1891,0,2000,109,110,17.349,0.0
19178,385122,0,3478,0,3978,500,501,6.956,0.0
19179,1203,1,12,1,14,2,2,12.0,0.0
19182,100245,0,1184,0,1421,237,238,4.996,0.0
19184,6431,5,40,5,75,35,24,8.0,0.0
19186,76557,162,972,162,1296,324,163,6.0,0.0
1919,304639,0,2920,0,3285,365,366,8.0,0.0
19190,47575,0,533,0,640,107,108,4.981,0.0
19191,151327,238,1904,238,2380,476,239,8.0,0.0
19193,26431,42,332,42,416,84,43,7.905,0.0
19194,42541,86,430,86,602,172,87,5.0,0.0
19196,8351,0,89,0,98,9,10,9.889,0.0
19198,10894,11,132,11,154,22,12,12.0,0.0
19199,178715,0,2271,0,2555,284,285,7.996,0.0
1920,874856,500,13935,500,14935,1000,501,27.87,0.0
19200,4698,4,32,4,48,16,8,8.0,0.0
19201,67784,55,617,55,727,110,56,11.218,0.0
19202,172146,180,1440,180,1800,360,181,8.0,0.0
19203,375120,0,3662,0,4162,500,501,7.324,0.0
19205,7520,17,68,17,102,34,19,4.0,0.0
19206,1448,0,10,0,12,2,3,5.0,0.0
19208,97052,0,1344,0,1512,168,169,8.0,0.0
19209,28762,0,336,0,384,48,49,7.0,0.0
19210,2570,3,33,3,39,6,4,11.0,0.0
19212,115537,0,1346,0,1436,90,91,14.956,0.0
19213,377207,500,3665,500,4665,1000,501,7.33,0.0
19216,6646,11,87,11,109,22,12,7.909,0.0
19217,20893,31,219,31,312,93,33,7.065,0.0
19219,507481,402,8040,402,8844,804,403,20.0,0.0
1922,162751,199,2243,199,2641,398,200,11.271,0.5
19220,3685,2,27,2,31,4,3,13.5,0.0
19222,100943,0,1364,0,1538,174,175,7.839,0.0
19223,281589,500,4000,500,5000,1000,501,8.0,0.0
19226,15766,30,143,30,203,60,31,4.767,0.0
19228,44561,0,530,0,636,106,107,5.0,0.0
1923,547174,0,9500,0,10000,500,501,19.0,0.0
19230,12012,29,116,29,174,58,30,4.0,0.0
19231,181429,0,1998,0,2226,228,229,8.763,0.0
19232,11316,8,63,8,95,32,11,7.875,0.0
19234,32614,14,97,14,152,55,29,6.929,0.0
19236,805640,500,9909,500,11409,1500,1001,19.818,0.0
19237,1057060,500,10812,500,11812,1000,502,21.624,0.0
19238,3095,4,44,4,52,8,5,11.0,0.0
1924,300728,500,3496,500,4496,1000,501,6.992,0.0
19243,50096,0,560,0,672,112,113,5.0,0.0
19244,208212,0,2465,0,2958,493,494,5.0,0.0
19245,48544,109,545,109,763,218,110,5.0,0.0
19246,5032,7,56,7,70,14,8,8.0,0.0
19247,37759,55,582,55,692,110,56,10.582,0.0
19249,33833,13,215,13,256,41,24,16.538,0.0
1925,378396,500,6994,500,7994,1000,501,13.988,0.0
19250,5821,8,64,8,80,16,9,8.0,0.0
19251,16503,8,196,8,212,16,9,24.5,0.0
19253,4583,4,20,4,36,16,10,5.0,0.0
19254,39070,52,663,52,767,104,53,12.75,0.0
19256,3481,5,40,5,50,10,6,8.0,0.0
19257,56201,49,821,49,919,98,50,16.755,0.0
1926,287412,500,3769,500,4769,1000,502,7.538,0.0
19260,302412,0,4456,0,4956,500,501,8.912,0.0
19261,349698,0,3000,0,3500,500,501,6.0,0.0
19263,342173,500,3000,500,4000,1000,501,6.0,0.0
19264,1386560,0,40653,0,41153,500,501,81.306,0.0
19265,9133,5,30,5,50,20,12,6.0,0.0
19266,6725,15,75,15,105,30,16,5.0,0.0
19267,91925,0,1085,0,1302,217,218,5.0,0.0
19269,2326,1,11,1,21,10,10,11.0,0.0
1927,5790,7,105,7,119,14,9,15.0,1.0
19270,15298,30,143,30,203,60,31,4.767,0.0
19271,1005549,500,13508,500,14508,1000,501,27.016,0.0
19272,8170,10,129,10,149,20,11,12.9,0.0
19273,48125,0,408,0,455,47,48,8.681,0.0
19276,209886,0,2000,0,2500,500,501,4.0,0.0
19277,2550,2,21,2,25,4,3,10.5,0.0
19278,26897,56,336,56,448,112,57,6.0,0.0
1928,5002,9,59,9,77,18,11,6.556,0.0
19281,16360946,500,9985,500,10985,1000,502,19.97,0.0
19282,101805,0,1145,0,1374,229,230,5.0,0.0
19283,8265,0,96,0,112,16,17,6.0,0.0
19284,126530,0,1495,0,1794,299,300,5.0,0.0
19286,221415,473,2832,473,3778,946,474,5.987,0.0
19287,85202,0,965,0,1158,193,194,5.0,0.0
19289,2554,2,12,2,20,8,6,6.0,0.0
1929,282141,500,3621,500,4621,1000,502,7.242,0.0
19290,16884,0,193,0,233,40,41,4.825,0.0
19292,481009,0,7500,0,8000,500,501,15.0,0.0
19293,78631,162,972,162,1296,324,163,6.0,0.0
19294,1413,0,9,0,10,1,2,9.0,0.0
19295,57761,94,752,94,940,188,95,8.0,0.0
19296,19188,25,175,25,275,100,35,7.0,0.0
19297,21675,19,114,19,183,69,34,6.0,0.0
19298,16349,0,190,0,209,19,20,10.0,0.0
19299,52399,44,836,44,924,88,45,19.0,0.0
1930,2133809,0,26551,0,27499,948,949,56.015,0.5
19300,89036,26,749,26,801,52,27,28.808,0.0
19301,208234,0,2498,0,2998,500,501,4.996,0.0
19302,78221,162,972,162,1296,324,163,6.0,0.0
19303,2626,2,28,2,32,4,3,14.0,0.0
19304,282664,500,4000,500,5000,1000,501,8.0,0.0
19305,446161,500,6000,500,7000,1000,501,12.0,0.0
19310,202685,0,2500,0,3000,500,501,5.0,0.0
19312,15650,24,192,24,240,48,25,8.0,0.0
19313,192202,227,1938,227,2619,681,229,8.537,0.0
19314,8792,7,168,7,182,14,8,24.0,0.0
19315,465450,256,7251,256,7763,512,257,28.324,0.0
19316,34595,0,364,0,455,91,92,4.0,0.0
19317,13469,32,160,32,224,64,33,5.0,0.0
1932,583974,2,10,2,14,4,3,5.0,0.0
19322,279311,500,3000,500,4000,1000,501,6.0,0.0
19324,13069,22,151,22,195,44,23,6.864,0.0
19325,8173,7,49,7,63,14,8,7.0,0.0
19327,214265,500,3000,500,4000,1000,501,6.0,0.0
19328,271473,311,2667,311,3600,933,314,8.576,0.0
19329,4311,6,60,6,72,12,7,10.0,0.0
1933,564580,500,10000,500,11000,1000,501,20.0,0.0
19333,5361,10,54,10,74,20,11,5.4,0.0
19334,76659,120,960,120,1200,240,121,8.0,0.0
19335,1540,2,10,2,14,4,3,5.0,0.0
19338,4950,8,36,8,52,16,9,4.5,0.0
19339,66053,101,909,101,1111,202,102,9.0,0.0
19340,8989,14,112,14,140,28,15,8.0,0.0
19341,2208,4,16,4,24,8,6,4.0,0.0
19342,346399,500,4991,500,5991,1000,501,9.982,0.0
19345,1639835,0,58903,0,59403,500,501,117.806,0.0
19346,305767,0,4445,0,4945,500,501,8.89,0.0
19349,9340,19,95,19,133,38,20,5.0,0.0
1935,294653,0,3500,0,4000,500,501,7.0,0.0
19350,4205,0,41,0,44,3,4,13.667,0.0
19353,99735,0,1197,0,1437,240,241,4.987,0.0
19354,9132,22,110,22,154,44,23,5.0,0.0
19356,15400,12,108,12,156,48,16,9.0,0.0
19357,426281,500,7506,500,8506,1000,501,15.012,0.0
19358,200894,0,2317,0,2692,375,376,6.179,0.0
19359,1519,1,17,1,19,2,2,17.0,0.0
1936,58558,150,750,150,1050,300,151,5.0,0.0
19360,335768,0,5000,0,5500,500,501,10.0,0.0
19362,110089,0,994,0,1160,166,167,5.988,0.0
19366,67674,70,537,70,807,270,84,7.671,0.0
19368,4660,0,41,0,44,3,4,13.667,0.0
1937,1985,2,30,2,34,4,4,15.0,0.0
19370,244516,500,3000,500,4000,1000,501,6.0,0.0
19371,449487,500,5500,500,6500,1000,501,11.0,0.0
19372,612182,500,6244,500,7244,1000,501,12.488,0.0
19373,60127,43,275,43,447,172,46,6.395,0.0
19375,429855,500,7526,500,8526,1000,501,15.052,0.0
19376,46298,115,575,115,805,230,116,5.0,0.0
19377,133839,208,1780,208,2196,416,209,8.558,0.0
19379,31842,0,330,0,385,55,56,6.0,0.0
1938,69055,40,318,40,645,327,132,7.95,0.0
19380,7626,5,30,5,50,20,12,6.0,0.0
19381,513057,0,13936,0,14070,134,135,104.0,0.0
19382,4223,10,30,10,50,20,11,3.0,0.0
19383,299173,500,4994,500,5994,1000,501,9.988,0.0
19385,6359,0,100,0,105,5,6,20.0,0.0
19387,9930,7,57,7,92,35,24,8.143,0.0
19389,38752,0,511,0,557,46,47,11.109,0.0
1939,2055001,500,21845,500,22845,1000,501,43.69,0.0
19391,43936,0,495,0,594,99,100,5.0,0.0
19393,93121,77,611,77,919,308,122,7.935,0.0
19394,341809,500,3491,500,4491,1000,502,6.982,0.0
19395,23616,0,260,0,312,52,53,5.0,0.0
19396,150500,271,1897,271,2439,542,272,7.0,0.0
19397,283475,0,3000,0,3500,500,501,6.0,0.0
19398,2460,5,15,5,25,10,6,3.0,0.0
19399,295206,0,4265,0,4765,500,501,8.53,0.0
19400,69503,88,505,88,766,261,169,5.739,0.0
19405,2449,2,14,2,18,4,3,7.0,0.0
19406,373763,0,3692,0,4192,500,501,7.384,0.0
19407,294253,500,4000,500,5000,1000,501,8.0,0.0
19408,37529,0,364,0,455,91,92,4.0,0.0
19409,256563,500,2532,500,3532,1000,501,5.064,0.0
19411,207413,127,1270,127,1524,254,128,10.0,0.0
19413,392763,460,5918,460,6838,920,461,12.865,0.0
19414,20372,22,176,22,263,87,45,8.0,0.0
19415,380017,0,6076,0,6490,414,415,14.676,0.0
1942,9397,18,122,18,158,36,20,6.778,0.0
19420,458073,500,5967,500,6967,1000,501,11.934,0.0
19421,14324,12,240,12,264,24,13,20.0,0.0
19423,13834,19,152,19,209,57,22,8.0,0.0
19424,290752,201,1809,201,2211,402,202,9.0,0.0
19425,1465,1,9,1,11,2,2,9.0,0.0
19427,6400,6,108,6,120,12,7,18.0,0.0
1943,5957,11,73,11,95,22,13,6.636,0.0
19430,13531,36,126,36,198,72,37,3.5,0.0
19431,81020,184,1197,184,1565,368,185,6.505,0.0
19432,86489,113,1469,113,1695,226,114,13.0,0.0
19433,23483,52,260,52,364,104,53,5.0,0.0
19434,2843,2,27,2,31,4,3,13.5,0.0
19435,3161,0,24,0,28,4,5,6.0,0.0
19437,15807,11,91,11,135,44,14,8.273,0.0
19438,1428,2,8,2,12,4,3,4.0,0.0
1944,248217,0,3500,0,4000,500,501,7.0,0.0
19441,1155412,236,9343,236,9815,472,237,39.589,0.0
19443,212403,0,2500,0,3000,500,501,5.0,0.0
19444,3711,3,24,3,36,12,7,8.0,0.0
19454,24282,51,240,51,342,102,52,4.706,0.0
19455,147615,0,1408,0,1619,211,212,6.673,0.0
19456,19002,0,323,0,342,19,20,17.0,0.0
19458,165985,121,1168,121,1410,242,122,9.653,0.0
19460,24720,27,214,27,321,107,33,7.926,0.0
19461,390509,0,6496,0,6996,500,501,12.992,0.0
19462,36722,0,405,0,486,81,82,5.0,0.0
19463,58167,26,749,26,801,52,27,28.808,0.0
19464,19245,0,215,0,258,43,44,5.0,0.0
19469,24580,0,390,0,450,60,49,13.0,0.0
19470,13077,22,151,22,195,44,23,6.864,0.0
19471,203360,38,2878,38,2954,76,39,75.737,0.0
19473,4598,6,42,6,54,12,7,7.0,0.0
19474,6666,0,75,0,90,15,16,5.0,0.0
19476,36137,0,440,0,550,110,111,8.0,0.0
19477,2904,2,17,2,25,8,5,8.5,0.0
1948,395617,0,6985,0,7485,500,501,13.97,0.5
19480,42963,100,400,100,600,200,101,4.0,0.0
19481,326383,0,3000,0,3500,500,501,6.0,0.0
19482,297049,0,4210,0,4710,500,501,8.42,0.0
19483,22168,19,114,19,183,69,33,6.0,0.0
19484,398589,0,3688,0,4188,500,501,7.376,0.0
19486,27927,44,350,44,438,88,45,7.955,0.0
19489,68595,112,955,112,1179,224,113,8.527,0.0
19490,1057,1,6,1,8,2,2,6.0,0.0
19491,11582,27,108,27,162,54,28,4.0,0.0
19492,26746,21,168,21,252,84,26,8.0,0.0
19493,5474,5,35,5,55,20,12,7.0,0.0
19494,158524,0,1894,0,2273,379,380,4.997,0.0
19498,17080,24,168,24,240,72,26,7.0,0.0
1950,238656,290,2927,290,3507,580,291,10.093,0.0
19500,5409,4,56,4,68,12,9,14.0,0.0
19502,298097,500,5000,500,6000,1000,501,10.0,0.0
19506,21851,0,255,0,291,36,37,7.083,0.0
19507,67494,69,741,69,879,138,70,10.739,0.0
19508,325361,0,3500,0,4000,500,501,7.0,0.0
19509,199768,0,2362,0,2835,473,474,4.994,0.0
1951,188714,313,1878,313,2504,626,314,6.0,0.6666666666666666
19511,83233,175,1050,175,1400,350,176,6.0,0.0
19512,38738,40,600,40,680,80,41,15.0,0.0
19513,265861,425,2975,425,3825,850,426,7.0,0.0
19514,16874,0,255,0,271,16,17,15.938,0.0
19515,37572,16,598,16,630,32,17,37.375,0.0
19516,39573,0,482,0,580,98,99,4.918,0.0
19517,33802,46,297,46,435,138,48,6.457,0.0
1952,507917,500,8795,500,9795,1000,501,17.59,0.0
19520,220921,0,3041,0,3541,500,501,6.082,0.0
19523,157263,0,1900,0,2124,224,225,8.482,0.0
19524,391570,133,14231,133,14497,266,134,107.0,0.0
19526,2489,0,30,0,33,3,4,10.0,0.0
19527,3068,0,30,0,36,6,7,5.0,0.0
19528,25559,58,290,58,406,116,59,5.0,0.0
19529,201203,127,1143,127,1397,254,128,9.0,0.0
1953,5963,7,105,7,119,14,9,15.0,0.0
19530,4952,0,63,0,66,3,4,21.0,0.0
19533,1167,1,10,1,12,2,2,10.0,0.0
19534,13022,13,195,13,221,26,14,15.0,0.0
19535,287229,500,4211,500,5211,1000,501,8.422,0.0
19536,11445,24,120,24,168,48,25,5.0,0.0
19537,2359,4,16,4,24,8,5,4.0,0.0
19538,428962,0,4500,0,5000,500,501,9.0,0.0
19539,62775,0,820,0,928,108,109,7.593,0.0
1954,586090,500,3993,500,4993,1000,502,7.986,0.0
19542,926738,101,16867,101,17069,202,102,167.0,0.0
19543,1055507,0,7494,0,9118,1624,1034,14.988,0.0
19544,77001,163,978,163,1304,326,164,6.0,0.0
19545,337579,500,4952,500,5952,1000,502,9.904,0.0
19546,19598,14,112,14,168,56,17,8.0,0.0
19547,19553,16,272,16,304,32,17,17.0,0.0
19548,1203,1,12,1,14,2,2,12.0,0.0
19549,397494,264,2640,264,3168,528,265,10.0,0.0
1955,302594,500,4000,500,5000,1000,502,8.0,0.0
19550,139294,82,2351,82,2515,164,83,28.671,0.0
19554,50802,64,766,64,894,128,65,11.969,0.0
19555,1845,2,22,2,26,4,3,11.0,0.0
19556,9770,14,126,14,154,28,15,9.0,0.0
19557,15895,18,131,18,203,72,25,7.278,0.0
19559,26211,44,307,44,395,88,45,6.977,0.0
1956,207662,375,2763,375,3513,750,377,7.368,0.0
19562,1136,1,9,1,11,2,2,9.0,0.0
19563,433472,500,7650,500,8650,1000,501,15.3,0.0
19564,1864539,66,462,66,594,132,68,7.0,0.0
19568,291808,530,5116,530,6176,1060,532,9.653,0.0
1957,3812,6,36,6,48,12,8,6.0,0.0
19571,18665962,500,8783,500,9783,1000,501,17.566,0.0
19572,273083,500,4378,500,5378,1000,501,8.756,0.0
19574,31752,54,304,54,466,162,56,5.63,0.0
19575,122960,62,1956,62,2080,124,63,31.548,0.0
19577,108939,168,1332,168,1668,336,169,7.929,0.0
19578,4925,8,35,8,51,16,9,4.375,0.0
19579,418876,256,6923,256,7435,512,257,27.043,0.0
1958,120013,96,1632,96,1824,192,98,17.0,0.0
19581,9783,10,60,10,89,29,20,6.0,0.0
19582,128460,175,2209,175,2559,350,176,12.623,0.0
19583,1315,0,11,0,12,1,2,11.0,0.0
19584,287632,0,4130,0,4630,500,501,8.26,0.0
19585,233792,500,2500,500,3500,1000,501,5.0,0.0
19586,745379,500,14000,500,15000,1000,501,28.0,0.0
19587,25465,0,310,0,372,62,63,5.0,0.0
19589,47730,74,615,74,763,148,75,8.311,0.0
19591,12281,19,143,19,181,38,20,7.526,0.0
19592,1165,1,10,1,12,2,2,10.0,0.0
19593,432707,500,7675,500,8675,1000,501,15.35,0.0
19594,331583,0,3474,0,3974,500,501,6.948,0.0
19596,176404,193,1930,193,2316,386,194,10.0,0.0
19598,6641,5,30,5,50,20,13,6.0,0.0
1960,57629,72,648,72,792,144,74,9.0,0.0
19601,153948,0,1807,0,2175,368,369,4.91,0.0
19602,469475,0,4447,0,4793,346,347,12.853,0.0
19603,95639,0,1080,0,1296,216,217,5.0,0.0
19604,1916,1,14,1,16,2,2,14.0,0.0
19605,20212,18,378,18,414,36,19,21.0,0.0
19608,79956,0,938,0,1072,134,135,7.0,0.0
19609,1276,1,10,1,12,2,2,10.0,0.0
1961,12093,24,120,24,168,48,26,5.0,0.0
19610,393209,500,3669,500,5226,1557,513,7.338,0.0
19611,320476,0,3000,0,3500,500,501,6.0,0.0
19613,46126,0,515,0,618,103,104,5.0,0.0
19614,2189,2,24,2,28,4,3,12.0,0.0
19616,29414,14,92,14,148,56,30,6.571,0.0
19617,285748,500,2500,500,3500,1000,501,5.0,0.0
19618,9392,0,102,0,118,16,17,6.375,0.0
19619,14455,22,110,22,154,44,23,5.0,0.0
1962,238502,500,3000,500,4000,1000,502,6.0,0.0
19622,1102,1,7,1,9,2,2,7.0,0.0
19623,18459,26,186,26,264,78,28,7.154,0.0
19624,3423,0,28,0,30,2,3,14.0,0.0
19625,9416,5,70,5,80,10,6,14.0,0.0
19628,10258,14,140,14,168,28,15,10.0,0.0
19629,95461,85,656,85,985,329,130,7.718,0.0
1963,29008,48,384,48,480,96,50,8.0,0.0
19630,196136,43,258,43,428,170,86,6.0,0.0
19631,34421,0,538,0,587,49,50,10.98,0.0
19634,604438,500,10000,500,11000,1000,501,20.0,0.0
19635,1445071,295,11629,295,12219,590,296,39.42,0.0
19636,6846,4,36,4,44,8,5,9.0,0.0
19637,58068,26,749,26,801,52,27,28.808,0.0
19638,26425,21,496,21,538,42,22,23.619,0.0
1964,355912,500,5003,500,6003,1000,502,10.006,0.0
19640,10412,7,101,7,115,14,8,14.429,0.0
19641,111933,0,1660,0,1826,166,167,10.0,0.0
19643,12964,31,155,31,217,62,32,5.0,0.0
19645,9571,7,175,7,189,14,8,25.0,0.0
19648,9267,7,56,7,84,28,11,8.0,0.0
1965,7297,13,65,13,91,26,15,5.0,0.0
19650,30660,73,296,73,442,146,75,4.055,0.0
19651,5746,4,68,4,76,8,5,17.0,0.0
19652,2590201,500,20069,500,21069,1000,501,40.138,0.0
19654,2359,0,22,0,24,2,3,11.0,0.0
19656,80629,156,1092,156,1404,312,157,7.0,0.0
19657,620001,500,8000,500,9000,1000,501,16.0,0.0
19658,339355,0,3000,0,3500,500,501,6.0,0.0
1966,825790,500,12344,500,13344,1000,502,24.688,0.0
19661,54767,0,900,0,950,50,51,18.0,0.0
19662,268501,500,2622,500,3622,1000,501,5.244,0.0
19663,17334,36,216,36,288,72,37,6.0,0.0
19664,265015,500,3000,500,4000,1000,501,6.0,0.0
19665,4004666,106,848,106,1060,212,108,8.0,0.0
19668,51520,44,472,44,560,88,45,10.727,0.0
19669,211459,0,2500,0,3000,500,501,5.0,0.0
1967,154914,189,2079,189,2457,378,191,11.0,0.0
19671,118953,117,1377,117,1611,234,118,11.769,0.0
19672,144413,167,834,167,1168,334,168,4.994,0.0
19675,7109,0,51,0,68,17,18,3.0,0.0
19676,576988,500,9212,500,10212,1000,501,18.424,0.0
19677,17224,12,72,12,120,48,26,6.0,0.0
19678,2211,2,9,2,17,8,6,4.5,0.0
1968,22368,44,220,44,308,88,46,5.0,0.0
19680,2617,2,36,2,40,4,3,18.0,0.0
19681,273654,0,3055,0,3395,340,341,8.985,0.0
19683,264182,500,4000,500,5000,1000,501,8.0,0.0
19684,31850,46,312,46,461,149,50,6.783,0.0
19686,29787,0,355,0,426,71,72,5.0,0.0
19688,20719,9,61,9,97,36,20,6.778,0.0
19689,2807,6,24,6,36,12,7,4.0,0.0
1969,20144,41,205,41,287,82,43,5.0,0.0
19692,167257,158,3160,158,3476,316,159,20.0,0.0
19693,5400,7,84,7,98,14,8,12.0,0.0
19694,1599,2,14,2,18,4,3,7.0,0.0
19695,1176,1,11,1,13,2,2,11.0,0.0
19697,9836,16,64,16,96,32,17,4.0,0.0
1970,69141,0,707,0,808,101,102,7.0,0.0
19701,2141,3,24,3,30,6,4,8.0,0.0
19702,183580,0,2000,0,2500,500,501,4.0,0.0
19704,165744,0,1960,0,2352,392,393,5.0,0.0
19706,44247,59,371,59,489,118,60,6.288,0.0
19707,198824,0,2496,0,2996,500,501,4.992,0.0
19709,299200,500,4994,500,5994,1000,501,9.988,0.0
1971,34186,76,304,76,456,152,78,4.0,0.0
19710,209505,0,2497,0,2997,500,501,4.994,0.0
19711,6319,4,56,4,64,8,5,14.0,0.0
19713,25438,57,285,57,399,114,58,5.0,0.0
19714,1551,1,11,1,13,2,2,11.0,0.0
19715,204077,39,2880,39,2958,78,40,73.846,0.0
19717,30317,68,340,68,476,136,69,5.0,0.0
19718,305443,38,2878,38,2954,76,39,75.737,0.0
19719,13769,16,163,16,195,32,17,10.188,0.0
1972,329339,500,3165,500,4165,1000,502,6.33,0.0
19721,21925,57,228,57,342,114,58,4.0,0.0
19722,528442,500,7105,500,8105,1000,501,14.21,0.0
19723,208109,0,2500,0,3000,500,501,5.0,0.0
19724,1885,3,15,3,21,6,4,5.0,0.0
19725,306816,500,3500,500,4500,1000,501,7.0,0.0
19727,1966,0,16,0,17,1,2,16.0,0.0
19729,1714,0,9,0,12,3,4,3.0,0.0
1973,1251895,500,20365,500,21365,1000,502,40.73,0.0
19730,56141,86,602,86,774,172,87,7.0,0.0
19732,86682,144,1112,144,1400,288,145,7.722,0.0
19735,3292,4,44,4,52,8,5,11.0,0.0
19736,88003,137,947,137,1221,274,138,6.912,0.0
19737,140463,144,1637,144,1925,288,145,11.368,0.0
19738,5676,5,90,5,100,10,6,18.0,0.0
1974,134292,160,1682,160,2002,320,162,10.512,0.0
19740,1220,1,10,1,12,2,2,10.0,0.0
19741,10636,12,180,12,204,24,13,15.0,0.0
19742,208388,0,2500,0,3000,500,501,5.0,0.0
19744,35053,0,239,0,254,15,16,15.933,0.0
19745,10484,25,75,25,125,50,26,3.0,0.0
1975,357849,500,5042,500,6042,1000,502,10.084,0.0
1976,6181,0,88,0,99,11,12,8.0,0.0
1978,44363,55,550,55,660,110,57,10.0,0.0
1979,20685,9,378,9,396,18,11,42.0,0.0
1980,46993,77,539,77,693,154,79,7.0,0.0
1981,29647,48,384,48,480,96,50,8.0,0.0
1988,340539,0,5500,0,6000,500,501,11.0,0.0
1990,72534,169,845,169,1183,338,170,5.0,0.0
1991,227023,169,1521,169,1859,338,170,9.0,0.0
1994,3174,0,36,0,42,6,7,6.0,0.0
1995,1203259,0,22000,0,22500,500,501,44.0,0.0
1996,46397,0,518,0,622,104,105,4.981,0.0
2,272953793,1208990,155784,1208990,3786372,3630588,1276314,25.982,0.0
2001,5717,0,62,0,70,8,9,7.75,0.0
2004,1563506,0,37352,0,37536,184,185,203.0,0.0
2005,86489,0,724,0,988,264,265,2.742,0.0
2006,87447,264,720,264,1248,528,265,2.727,0.0
2008,340361,0,5500,0,6000,500,501,11.0,0.0
2010,344124,0,5498,0,5998,500,501,10.996,0.0
2015,1537802,170,14533,170,14873,340,171,85.488,0.0
2021,104008,171,1193,171,1535,342,172,6.977,0.0
2023,19510,0,237,0,262,25,26,9.48,0.0
2024,96558,264,1097,264,1625,528,265,4.155,0.5
2025,87008,264,704,264,1232,528,265,2.667,0.0
2027,344727,0,5000,0,5500,500,501,10.0,0.0
2028,4101,0,24,0,32,8,9,3.0,0.0
2029,632084,0,8966,0,9136,170,171,52.741,0.0
2030,13014,18,144,18,180,36,19,8.0,0.0
2032,380504,500,5970,500,6970,1000,501,11.94,0.0
2033,61480,169,676,169,1014,338,170,4.0,0.0
2035,349884,0,5500,0,6000,500,501,11.0,0.0
2037,61010,0,534,0,623,89,90,6.0,0.0
2038,4192674,500,101500,500,102500,1000,501,203.0,0.5
2039,3735704,500,103500,500,104500,1000,501,207.0,0.5
2040,231612,500,3000,500,4000,1000,501,6.0,0.0
2042,2591,5,20,5,30,10,6,4.0,0.0
2043,53060,47,705,47,799,94,48,15.0,0.0
2045,1055773,0,14728,0,15228,500,501,29.456,0.0
2046,2983688,0,37200,0,37400,200,201,186.0,0.0
2052,5495,0,58,0,67,9,10,6.444,0.0
2053,3406,0,45,0,50,5,6,9.0,0.0
2055,346368,0,5499,0,5999,500,501,10.998,0.5
2057,4201034,500,101500,500,102500,1000,501,203.0,0.5
2059,5698661,500,8000,500,9000,1000,501,16.0,0.0
2060,19339,0,235,0,260,25,26,9.4,0.0
2064,624360,0,8842,0,9012,170,171,52.012,0.0
2066,4813,0,54,0,61,7,8,7.714,0.0
2067,342233,0,5500,0,6000,500,501,11.0,0.0
2071,2711,0,30,0,35,5,6,6.0,0.0
2073,279970,0,4500,0,5000,500,501,9.0,0.0
2078,99441,173,1203,173,1549,346,174,6.954,0.0
2081,629844,0,8742,0,8912,170,171,51.424,0.0
2082,336205,0,5500,0,6000,500,501,11.0,0.0
2085,895113,0,14500,0,15000,500,501,29.0,0.0
2087,385595,0,5305,0,5498,193,194,27.487,0.0
2089,124468,178,1324,178,1680,356,179,7.438,0.5
2092,351759,0,5500,0,6000,500,501,11.0,0.0
2093,2378136,200,29600,200,30000,400,201,148.0,0.0
2096,215204,169,1516,169,1854,338,170,8.97,0.0
20965,450585,317,709,317,1569,860,325,2.237,0.0
20967,9256843,3296,9087,3296,19557,10470,3305,2.757,0.0
20968,12231604,4424,21271,4424,30839,9568,4428,4.808,0.0
2097,92107,68,1282,68,1418,136,69,18.853,0.0
20970,4187818,2427,5149,2427,11501,6352,2440,2.122,0.0
20971,653223,380,918,380,1907,989,389,2.416,0.0
20972,1983638,1976,6998,1976,10040,3042,1978,3.541,0.0
20973,3211299,1695,8078,1695,10174,2096,1699,4.766,0.0
20974,6103949,5324,9937,5324,22375,12438,5333,1.866,0.0
20975,352289,283,864,283,1450,586,287,3.053,0.0
20976,931954,685,2104,685,3581,1477,689,3.072,0.0
20977,3882101,2794,4980,2794,12266,7286,2803,1.782,0.0
20978,1830849,1281,4014,1281,6861,2847,1285,3.133,0.0
20979,868969,76,454,76,605,151,79,5.974,0.0
2098,4198459,0,101500,0,102000,500,501,203.0,1.0
20980,3365762,1311,6027,1311,9226,3199,1317,4.597,0.0
20981,5845290,645,3604,645,4889,1285,648,5.588,0.0
20983,25352381,5953,21555,5953,40214,18659,5962,3.621,0.0
20984,3615261,1285,6245,1285,9497,3252,1291,4.86,0.0
20985,110751,98,225,98,442,217,107,2.296,0.0
20986,6091295,5053,12990,5053,21756,8766,5065,2.571,0.0
20987,1024660,514,1286,514,2687,1401,523,2.502,0.0
20988,61722141,11907,40692,11907,71610,30918,11915,3.417,0.0
20989,41456,38,116,38,189,73,41,3.053,0.0
20990,12776886,5442,22110,5442,33442,11332,5447,4.063,0.0
20991,37759704,13094,75428,13094,112541,37113,13100,5.761,0.0
20992,764326,220,587,220,1177,590,229,2.668,0.0
20993,12908916,5306,21532,5306,32653,11121,5311,4.058,0.0
20994,949818,766,2326,766,3896,1570,770,3.037,0.0
20995,538014,324,789,324,1621,832,333,2.435,0.0
20996,371727,339,863,339,1572,709,344,2.546,0.0
20997,29633685,9967,28489,9967,61155,32666,9976,2.858,0.0
20998,1842528,866,2194,866,4622,2428,875,2.533,0.0
20999,4177851,2517,5360,2517,12005,6645,2530,2.13,0.0
21000,13820961,3971,14368,3971,26752,12384,3980,3.618,0.0
21001,36894,30,100,30,156,56,34,3.333,0.0
21002,9533944,4191,16973,4191,25584,8611,4196,4.05,0.0
21003,56788,22,104,22,160,56,28,4.727,0.0
21004,6386970,3814,8127,3814,18173,10046,3827,2.131,0.0
21005,2697897,964,4519,964,6847,2328,970,4.688,0.0
21006,5387926,1895,9752,1895,14603,4851,1901,5.146,0.0
21007,795957,356,1454,356,2156,702,359,4.084,0.0
21008,4048522,2758,8607,2758,14830,6223,2762,3.121,0.0
2101,5437,0,57,0,65,8,9,7.125,0.0
21010,762416,675,1335,675,2946,1611,745,1.978,0.0
21011,7983994,3602,14558,3602,21932,7374,3607,4.042,0.0
21012,22434,22,71,22,113,42,26,3.227,0.0
21013,1154944,410,1906,410,2931,1025,416,4.649,0.0
21014,7762538,4356,16804,4356,26889,10085,4362,3.858,0.0
21015,16375,11,33,11,54,21,14,3.0,0.0
21016,5663950,3355,7120,3355,15953,8833,3368,2.122,0.0
21017,188968,230,460,230,920,460,236,2.0,0.0
21019,79207,72,187,72,341,154,89,2.597,0.0
2102,2983911,200,37200,200,37600,400,201,186.0,0.0
21020,2053854,931,4069,931,6489,2420,937,4.371,0.0
21021,33216070,5981,21974,5981,36779,14805,5989,3.674,0.0
21023,111332568,33342,97440,33342,210823,113383,33351,2.922,0.0
21024,42263,40,104,40,186,82,54,2.6,0.0
21026,125626,86,272,86,441,169,90,3.163,0.0
21027,6721534,3826,8039,3826,18161,10122,3839,2.101,0.0
21028,5205745,2321,9333,2321,14093,4760,2326,4.021,0.0
21029,3393566,1153,7124,1153,10617,3493,1159,6.179,0.0
2103,1563283,0,37352,0,37536,184,185,203.0,0.0
21030,45773236,14014,39955,14014,86080,46125,14023,2.851,0.0
21031,509373,500,7976,500,8976,1000,501,15.952,0.0
21032,1968,2,20,2,24,4,3,10.0,0.0
21033,248281,326,3586,326,4238,652,327,11.0,0.0
21034,200013,206,2678,206,3090,412,207,13.0,0.0
21035,33996,43,473,43,559,86,44,11.0,0.0
21036,603508,500,5993,500,6993,1000,501,11.986,0.0
21037,210321,217,2821,217,3255,434,218,13.0,0.0
21038,117828,118,2127,118,2363,236,119,18.025,0.0
21039,142647,221,2872,221,3314,442,222,12.995,0.0
2104,549458,500,10500,500,11500,1000,501,21.0,0.0
21040,2295884,500,46558,500,47969,1411,873,93.116,0.0
21041,270458,500,3671,500,4671,1000,501,7.342,0.0
21042,208024,215,2794,215,3224,430,216,12.995,0.0
21044,142851,38,2816,38,2919,103,65,74.105,0.0
21046,18745,24,264,24,312,48,25,11.0,0.0
21047,181025,98,2156,98,2352,196,99,22.0,0.0
21048,110464,43,2172,43,2269,97,55,50.512,0.0
21049,203767,222,2654,222,3098,444,223,11.955,0.0
21050,8886,15,120,15,150,30,16,8.0,0.0
21051,8594,15,135,15,165,30,16,9.0,0.0
21053,11128,15,225,15,255,30,16,15.0,0.0
21054,509891,500,6500,500,7500,1000,501,13.0,0.0
21055,30340,41,410,41,492,82,42,10.0,0.0
21056,277572,462,3696,462,4620,924,463,8.0,0.0
21057,1142952,216,10076,216,10508,432,217,46.648,0.0
21058,537806,500,9000,500,10000,1000,501,18.0,0.0
21059,128139,220,2419,220,2859,440,221,10.995,0.0
21060,512139,500,6500,500,7500,1000,501,13.0,0.0
21061,1372,1,12,1,14,2,2,12.0,0.0
21062,575375,500,8996,500,9996,1000,501,17.992,0.0
21063,547339,500,10000,500,11000,1000,501,20.0,0.0
21064,186780,221,2651,221,3093,442,222,11.995,0.0
21065,120433,220,2187,220,2627,440,221,9.941,0.0
21066,408676,500,6997,500,7997,1000,501,13.994,0.0
21067,250647,119,1760,119,1998,238,120,14.79,0.0
21068,1146714,216,10090,216,10522,432,217,46.713,0.0
21069,115235,209,1428,209,1846,418,210,6.833,0.0
2107,94358,264,1070,264,1598,528,265,4.053,0.5
21070,785356,500,13261,500,14261,1000,501,26.522,0.0
21071,38324,32,394,32,458,64,33,12.312,0.0
21072,644854,500,9974,500,10974,1000,501,19.948,0.0
21073,4587,4,72,4,80,8,5,18.0,0.0
21074,542339,500,8580,500,9580,1000,501,17.16,0.0
21075,994155,387,20099,387,21050,951,561,51.935,0.0
21076,220727,217,2820,217,3254,434,218,12.995,0.0
21077,23348,22,250,22,294,44,23,11.364,0.0
21078,8710,15,105,15,135,30,16,7.0,0.0
21079,48632,66,599,66,781,182,115,9.076,0.0
21080,97779,126,1386,126,1638,252,127,11.0,0.0
21081,397407,500,5500,500,6500,1000,501,11.0,0.0
21082,61451,55,1100,55,1210,110,56,20.0,0.0
21083,15553,15,270,15,300,30,16,18.0,0.0
21084,17592,22,242,22,286,44,23,11.0,0.0
21085,103648,105,1785,105,1995,210,106,17.0,0.0
21086,164304,222,2859,222,3303,444,223,12.878,0.0
21087,4207,4,64,4,72,8,5,16.0,0.0
21088,275310,500,3721,500,4721,1000,501,7.442,0.0
21089,90505,108,988,108,1204,216,109,9.148,0.0
2109,86075,264,709,264,1237,528,265,2.686,0.0
21090,486528,500,7500,500,8500,1000,501,15.0,0.0
21091,435252,500,6000,500,7000,1000,501,12.0,0.0
21092,66637,85,935,85,1105,170,86,11.0,0.0
21093,404554,500,3447,500,4447,1000,501,6.894,0.0
21094,210307,217,2821,217,3255,434,218,13.0,0.0
21095,202562,221,2650,221,3092,442,222,11.991,0.0
21096,164960,228,2280,228,2736,456,229,10.0,0.0
21097,568245,500,9500,500,10500,1000,501,19.0,0.0
21098,164155,221,2872,221,3314,442,222,12.995,0.0
21099,35861,36,612,36,684,72,37,17.0,0.0
2110,18052,20,229,20,269,40,21,11.45,0.0
21100,208950,215,2795,215,3225,430,216,13.0,0.0
21101,223768,249,3736,249,4234,498,250,15.004,0.0
21102,8667,8,145,8,161,16,9,18.125,0.0
21103,352397,500,4999,500,5999,1000,501,9.998,0.0
21104,361154,500,5000,500,6000,1000,501,10.0,0.0
21105,355260,500,6000,500,7000,1000,501,12.0,0.0
21106,4591,4,72,4,80,8,5,18.0,0.0
21107,5754,8,80,8,96,16,9,10.0,0.0
21108,563726,500,9500,500,10500,1000,501,19.0,0.0
21109,55140,75,750,75,900,150,76,10.0,0.0
21110,165057,85,2598,85,2768,170,86,30.565,0.0
21111,354138,500,4993,500,5993,1000,501,9.986,0.0
21112,336370,453,4530,453,5436,906,454,10.0,0.0
21113,342344,500,5586,500,6586,1000,501,11.172,0.0
21114,509320,500,6500,500,7500,1000,501,13.0,0.0
21115,804833,215,10531,215,10961,430,216,48.981,0.0
21116,213560,215,3870,215,4300,430,216,18.0,0.0
21117,2599,2,36,2,40,4,3,18.0,0.0
21118,239882,92,3176,92,3360,184,93,34.522,0.0
21119,293430,169,4126,169,4464,338,170,24.414,0.0
21120,79522,79,1423,79,1581,158,80,18.013,0.0
21121,11330,15,225,15,255,30,16,15.0,0.0
21122,175367,218,2834,218,3270,436,219,13.0,0.0
21123,140753,143,2431,143,2717,286,144,17.0,0.0
21124,8713,15,105,15,135,30,16,7.0,0.0
21125,480485,500,7488,500,8488,1000,501,14.976,0.0
21126,138791,222,2645,222,3089,444,223,11.914,0.0
21127,343561,500,4994,500,5994,1000,501,9.988,0.0
21129,539678,500,9500,500,10500,1000,501,19.0,0.0
21130,821111,500,7000,500,8000,1000,501,14.0,0.0
21131,203993,211,2743,211,3165,422,212,13.0,0.0
21132,117223,221,1975,221,2417,442,222,8.937,0.0
21133,10897,26,104,26,156,52,27,4.0,0.0
21134,8732,15,105,15,135,30,16,7.0,0.0
21135,8058,15,120,15,150,30,16,8.0,0.0
21136,3644,4,48,4,56,8,5,12.0,0.0
21137,595945,500,5979,500,6979,1000,501,11.958,0.0
21138,1175291,500,18590,500,19590,1000,501,37.18,0.0
21139,508188,500,6500,500,7500,1000,501,13.0,0.0
21140,142356,221,2872,221,3314,442,222,12.995,0.0
21141,160237,168,1695,168,2031,336,169,10.089,0.0
21142,1153003,217,10147,217,10581,434,218,46.76,0.0
21143,17629,19,304,19,342,38,20,16.0,0.0
21144,552395,500,10220,500,11220,1000,501,20.44,0.0
21145,1000753,500,20340,500,21409,1069,568,40.68,0.0
21146,312930,361,5054,361,5776,722,362,14.0,0.0
21147,280989,127,3966,127,4347,381,255,31.228,0.0
21149,164079,221,2846,221,3288,442,222,12.878,0.0
2115,5277,0,48,0,56,8,9,6.0,0.0
21150,167562,221,2863,221,3305,442,222,12.955,0.0
21151,801543,216,10490,216,10922,432,217,48.565,0.0
21152,377047,500,5563,500,6563,1000,501,11.126,1.0
21153,11445,15,180,15,210,30,16,12.0,0.0
21154,512057,500,8442,500,9574,1132,633,16.884,0.0
21156,645813,500,6572,500,7572,1000,501,13.144,0.0
21157,458822,500,7822,500,8822,1000,501,15.644,0.0
21158,295670,500,3999,500,4999,1000,501,7.998,0.0
21159,1514,1,16,1,18,2,2,16.0,0.0
21160,8729,15,105,15,135,30,16,7.0,0.0
21161,195661,221,2559,221,3001,442,222,11.579,0.0
21162,128115,220,2419,220,2859,440,221,10.995,0.0
21163,512550,500,9086,500,10086,1000,501,18.172,0.0
21164,55781,30,1072,30,1141,69,41,35.733,0.0
21165,8199,15,120,15,150,30,16,8.0,0.0
21166,30781,40,480,40,560,80,41,12.0,0.0
21167,256547,225,3825,225,4500,675,451,17.0,0.0
21168,202050,209,2716,209,3134,418,210,12.995,0.0
21170,299862,912,3334,912,5462,2128,1218,3.656,0.0
21171,35262,39,624,39,702,78,40,16.0,0.0
21172,153186,204,2244,204,2652,408,205,11.0,0.0
21173,570227,500,9500,500,10500,1000,501,19.0,0.0
21174,147172,217,1859,217,2293,434,218,8.567,0.0
21175,2324,1,18,1,20,2,2,18.0,0.0
21176,270477,354,3894,354,4602,708,355,11.0,0.0
21177,107041,142,1704,142,1988,284,143,12.0,0.0
21178,11081,12,156,12,180,24,13,13.0,0.0
21179,165394,221,2871,221,3313,442,222,12.991,0.0
21180,124228,216,1569,216,2001,432,217,7.264,0.0
21181,4224,4,64,4,72,8,5,16.0,0.0
21182,513699,421,7153,421,7995,842,422,16.99,0.0
21183,2277,1,23,1,25,2,2,23.0,0.0
21184,200612,216,1944,216,2376,432,217,9.0,0.0
21185,568231,500,9500,500,10500,1000,501,19.0,0.0
21186,4423,6,42,6,54,12,7,7.0,0.0
21187,321787,500,5000,500,6000,1000,501,10.0,0.0
21188,10489,13,156,13,182,26,14,12.0,0.0
21189,99366,131,1572,131,1834,262,132,12.0,0.0
2119,177233,0,2675,0,2818,143,144,18.706,0.0
21190,44883,48,672,48,768,96,49,14.0,0.0
21191,470172,500,7926,500,8926,1000,501,15.852,0.0
21192,195098,86,1926,86,2098,172,87,22.395,0.0
21193,1367,1,12,1,14,2,2,12.0,0.0
21194,793844,500,6928,500,7928,1000,501,13.856,0.0
21195,2413,2,32,2,36,4,3,16.0,0.0
21196,7359,9,108,9,126,18,10,12.0,0.0
21197,208908,216,2807,216,3239,432,217,12.995,0.0
21198,509969,500,6500,500,7500,1000,501,13.0,0.0
21199,141586,221,2849,221,3291,442,222,12.891,0.0
21200,93432,105,1365,105,1575,210,106,13.0,0.0
21201,2402,2,32,2,36,4,3,16.0,0.0
21202,168626,212,1528,212,1952,424,214,7.208,0.0
21203,133200,221,1978,221,2420,442,222,8.95,0.0
21204,8498,15,135,15,165,30,16,9.0,0.0
21206,87784,118,1416,118,1652,236,119,12.0,0.0
21207,30756,36,295,36,395,100,65,8.194,0.0
21208,210260,217,2820,217,3254,434,218,12.995,0.0
21209,185817,190,3230,190,3610,380,191,17.0,0.0
21210,270940,223,3152,223,3598,446,224,14.135,0.0
21211,485576,500,6500,500,7500,1000,501,13.0,0.0
21212,2270112,500,5500,500,6500,1000,501,11.0,0.0
21213,56637,30,1087,30,1156,69,41,36.233,0.0
21214,680032,500,7993,500,8993,1000,501,15.986,0.0
21215,153686,185,1692,185,2062,370,186,9.146,0.0
21216,39463,46,507,46,599,92,47,11.022,0.0
21217,20132,26,312,26,364,52,27,12.0,0.0
21218,40146,47,428,47,522,94,48,9.106,0.0
21219,160048,128,2048,128,2304,256,129,16.0,0.0
21220,282046,500,3430,500,4430,1000,501,6.86,0.0
21221,499413,500,4500,500,5500,1000,501,9.0,0.0
21222,24634,27,432,27,486,54,28,16.0,0.0
21223,361064,389,4570,389,5348,778,390,11.748,0.0
21225,120929,161,1610,161,1932,322,162,10.0,0.0
21226,10750,15,210,15,240,30,16,14.0,0.0
21227,1998,2,20,2,24,4,3,10.0,0.0
21228,103330,116,1148,116,1380,232,117,9.897,0.0
21229,542876,500,9703,500,10703,1000,501,19.406,0.0
2123,531287,320,9143,320,9783,640,321,28.572,0.0
21230,25097,19,457,19,511,54,36,24.053,0.0
21231,10874,15,210,15,240,30,16,14.0,0.0
21232,160776,183,1810,183,2176,366,184,9.891,0.0
21233,458482,500,6780,500,7780,1000,501,13.56,0.0
21234,36727,55,439,55,549,110,56,7.982,0.0
21235,743090,500,9000,500,10000,1000,501,18.0,0.0
21236,546657,500,10036,500,11036,1000,501,20.072,0.0
21237,30339,42,420,42,504,84,43,10.0,0.0
21238,480849,500,7323,500,8323,1000,501,14.646,0.0
21239,327724,500,5183,500,6183,1000,501,10.366,0.0
21240,311350,500,3493,500,4493,1000,501,6.986,0.0
21241,209794,216,2808,216,3240,432,217,13.0,0.0
21242,169509,222,2876,222,3320,444,223,12.955,0.0
21243,8970,15,120,15,150,30,16,8.0,0.0
21244,92527,83,1242,83,1408,166,84,14.964,0.0
21245,190338,147,1921,147,2232,311,164,13.068,0.0
21246,114395,215,1373,215,1803,430,216,6.386,0.0
21247,11423,15,180,15,210,30,16,12.0,0.0
21248,485392,500,7995,500,8995,1000,501,15.99,0.0
21249,8123,10,120,10,140,20,11,12.0,0.0
21250,262403,293,2973,293,3559,586,294,10.147,0.0
21252,956789,500,12950,500,13950,1000,501,25.9,0.0
21253,4985,10,40,10,60,20,11,4.0,0.0
21254,209862,216,2808,216,3240,432,217,13.0,0.0
21255,1070576,217,10137,217,10571,434,218,46.714,0.0
2127,85895,264,702,264,1230,528,265,2.659,0.0
2128,78005,69,1038,69,1176,138,70,15.043,0.0
2129,237524,0,3861,0,4212,351,352,11.0,0.0
2130,83744,246,738,246,1230,492,247,3.0,0.0
2138,92329,68,1285,68,1421,136,69,18.897,0.0
2139,340563,0,5467,0,5964,497,498,11.0,0.0
2140,184218,0,3014,0,3288,274,275,11.0,0.0
2141,5699,0,62,0,70,8,9,7.75,0.0
2142,340321,0,5498,0,5998,500,501,10.996,0.0
21429,13060,22,151,22,195,44,23,6.864,0.0
2143,95095,264,1088,264,1616,528,265,4.121,0.5
21432,5063,4,51,4,59,8,5,12.75,0.0
21434,247132,0,3776,0,4276,500,501,7.552,0.0
21436,15317,0,154,0,165,11,12,14.0,0.0
21439,3682,0,38,0,44,6,7,6.333,0.0
21440,212224,0,2500,0,3000,500,501,5.0,0.0
21441,7234,11,88,11,110,22,12,8.0,0.0
21442,20427,0,386,0,405,19,20,20.316,0.0
21443,54949,0,650,0,780,130,131,5.0,0.0
21444,25129,30,220,30,340,120,40,7.333,0.0
21445,112666,172,1358,172,1702,344,173,7.895,0.0
21446,212314,0,2500,0,3000,500,501,5.0,0.0
21449,2687,3,36,3,42,6,4,12.0,0.0
2145,64820,23,183,23,229,46,24,7.957,0.0
21450,1129,1,7,1,9,2,2,7.0,0.0
21452,16022,0,165,0,200,35,36,6.875,0.0
21453,18825,0,270,0,300,30,31,9.0,0.0
21455,4007,5,60,5,70,10,6,12.0,0.0
2146,341306,0,4846,0,5346,500,501,9.692,0.0
21476,583203,937,1869,937,4354,2485,1028,1.995,0.0
21479,1299126,1497,4407,1497,9610,5203,1665,2.944,0.0
2148,83722,246,738,246,1230,492,247,3.0,0.0
21486,246356,225,1245,225,2048,803,233,5.533,0.0
21487,1178643,2137,4465,2137,9415,4950,2121,7.667000000000001,0.0
2149,261888,500,3579,500,4579,1000,501,7.158,0.5
21493,929858,1198,2947,1198,6918,3971,1354,2.46,0.0
21494,340269,522,1212,522,2690,1478,652,2.322,0.0
21495,1036881,1865,3882,1865,8630,4748,2042,4.8309999999999995,0.0
21516,5196,4,64,4,72,8,5,16.0,0.0
21518,862827,907,2983,907,6964,3981,1258,9.998,0.0
21521,5196,4,64,4,72,8,5,16.0,0.0
2153,117227,0,1854,0,1944,90,91,20.6,0.0
21532,9112,14,42,14,81,39,28,3.0,1.0
21536,1049495,205,2453,205,8368,5915,1772,1.765,0.0
21537,1750588,321,3890,321,14294,10404,2685,1.767,0.0
21538,220652,43,470,43,1642,1172,397,1.836,0.0
21539,1983610,380,4500,380,16037,11537,3040,1.721,0.0
2154,541436,500,10500,500,11500,1000,501,21.0,0.0
21540,97605,25,220,25,799,579,185,1.692,0.0
21541,92993,24,195,24,722,527,171,1.585,0.0
21542,378616,84,864,84,3249,2385,675,1.591,0.0
21543,24813,11,52,11,176,124,54,1.625,0.0
21544,1472966,277,3057,277,11908,8851,2328,1.614,0.0
21545,167160,41,369,41,1377,1008,309,1.525,0.0
21557,5951546,1363,20131,1363,24362,4231,4213,14.77,0.5
21563,616525,1060,7534,1060,9950,2416,1806,7.108,0.0
2157,5666,0,61,0,69,8,9,7.625,0.0
21580,175367,290,1884,290,2464,580,444,6.497,0.0
2159,259606,0,4198,0,4698,500,501,8.396,0.0
21593,251341,284,3652,284,4220,568,434,12.859,0.0
21606,221820,262,3042,262,3566,524,402,11.611,0.0
2161,111794,0,1026,0,1197,171,172,6.0,0.0
21630,33580,30,780,30,840,60,46,26.0,0.0
21650,2353798,740,2391,740,23196,20805,20076,6.115,0.0
21654,2252563,11421,26472,11421,37893,11421,3810,6.954,0.0
21657,8322,54,125,54,197,72,39,6.944,0.0
21658,6579,24,52,24,96,44,24,4.333,0.0
21659,247548,651,434,651,2479,2045,1614,2.0,0.0
21661,5499,2,225,2,261,36,36,7.258,0.0
21662,3229,2,128,2,151,23,23,6.737,0.0
21663,3229,2,128,2,151,23,23,6.737,0.0
21664,5523,2,225,2,261,36,36,7.258,0.0
21665,5500,2,225,2,261,36,36,7.258,0.0
21666,5498,2,225,2,261,36,36,7.258,0.0
21667,5498,2,225,2,261,36,36,7.258,0.0
21668,5346,2,217,2,252,35,35,7.233,0.0
21669,5214,2,217,2,252,35,35,7.233,0.0
2167,289157,500,3000,500,4000,1000,501,6.0,0.0
21670,3218,2,127,2,150,23,23,6.684,0.0
21671,3109,2,115,2,137,22,22,6.765,0.0
21672,3105,2,115,2,137,22,22,6.765,0.0
21673,3128,2,115,2,137,22,22,6.765,0.0
21674,3218,2,128,2,151,23,23,6.737,0.0
21675,3218,2,128,2,151,23,23,6.737,0.0
21676,3229,2,128,2,151,23,23,6.737,0.0
21677,3229,2,128,2,151,23,23,6.737,0.0
21678,3252,2,128,2,151,23,23,6.737,0.0
21681,3382484,0,32508,0,32508,0,1548,21.0,0.0
21687,3956284,4433,20237,4433,37484,17247,4440,4.598,0.0
21691,5957,0,54,0,54,0,6,9.0,0.0
21692,18911,0,14,0,62,48,49,14.0,0.0
2174,467685,500,7207,500,8207,1000,501,14.414,0.0
2177,12244,24,144,24,192,48,25,6.0,0.0
2178,357421,0,5146,0,5312,166,167,31.0,0.0
2179,266623,0,3682,0,3827,145,146,25.393,0.0
2180,7388,0,82,0,92,10,11,8.2,0.0
2184,7534,0,79,0,88,9,10,8.778,0.0
2189,1664360,0,14573,0,14743,170,171,85.724,0.0
2190,2855538,500,50837,500,51837,1000,501,101.674,0.0
2192,238964,500,3542,500,4542,1000,501,7.084,0.0
2193,1645839,0,23113,0,23613,500,501,46.226,0.0
2195,1892251,500,33094,500,34094,1000,501,66.188,0.5
2198,239817,0,3643,0,3809,166,167,21.946,0.0
2199,46176,0,518,0,622,104,105,4.981,0.0
2202,3202,6,33,6,45,12,7,5.5,0.0
2204,4065,6,45,6,57,12,7,7.5,0.0
2207,807821,0,12871,0,13371,500,501,25.742,0.5
2208,9904,13,107,13,133,26,14,8.231,0.5
2209,492295,9,63,9,81,18,10,7.0,0.0
2212,248045,0,4000,0,4500,500,501,8.0,0.0
2214,175474,0,2000,0,2500,500,501,4.0,0.5
2216,480789,0,6293,0,6793,500,501,12.586,0.0
2220,240535,171,5781,171,6123,342,172,33.807,0.0
2222,348024,0,5500,0,6000,500,501,11.0,0.0
2223,289471,500,3945,500,4945,1000,501,7.89,0.5
2231,5665,0,48,0,60,12,13,4.0,0.0
2232,3795336,500,103000,500,104000,1000,501,206.0,1.0
2234,57853,179,537,179,895,358,180,3.0,0.0
2241,85571,264,689,264,1217,528,265,2.61,0.0
2242,306145,500,3494,500,4494,1000,501,6.988,0.0
2244,216492,500,3500,500,4500,1000,501,7.0,0.0
2245,5941,0,70,0,79,9,10,7.778,0.0
2249,5521,0,48,0,60,12,13,4.0,0.0
2250,3848,7,43,7,57,14,8,6.143,0.0
2255,3710564,500,102000,500,103000,1000,501,204.0,0.75
2258,2614361,203,37961,203,38367,406,204,187.0,0.0
2259,91096,67,1282,67,1416,134,68,19.134,0.0
2261,338275,0,5500,0,6000,500,501,11.0,0.0
2267,550119,0,10500,0,11000,500,501,21.0,0.0
2268,337770,0,5423,0,5916,493,494,11.0,0.0
2269,626275,0,10500,0,11000,500,501,21.0,0.0
2272,1560204,0,37352,0,37536,184,185,203.0,0.0
2273,552111,0,10500,0,11000,500,501,21.0,0.0
2276,524377,0,9110,0,9280,170,171,53.588,0.0
2278,229264,170,1530,170,1870,340,171,9.0,0.0
2281,97843,171,1196,171,1538,342,172,6.994,0.0
2283,58176,68,537,68,673,136,69,7.897,0.0
2285,557130,170,8654,170,8994,340,171,50.906,0.0
2286,1106933,0,8855,0,8893,38,39,233.026,0.0
2287,730293,500,11496,500,12496,1000,501,22.992,0.5
2288,10363,14,84,14,112,28,15,6.0,0.0
2289,526305,500,8735,500,9735,1000,501,17.47,0.0
2290,459931,500,7166,500,8166,1000,501,14.332,0.0
2291,1418996,500,18934,500,19934,1000,501,37.868,0.5
2292,8076,0,96,0,119,23,24,8.0,0.0
2293,1283897,0,12404,0,12904,500,501,24.808,0.0
2294,1180281,500,21896,500,22896,1000,501,43.792,0.0
2295,5863,11,55,11,77,22,12,5.0,0.0
2296,2355,4,16,4,24,8,5,4.0,0.0
2297,316252,455,5439,455,6349,910,456,11.954,0.5
2298,797630,500,12500,500,13500,1000,501,25.0,0.5
2300,50441,0,600,0,650,50,51,12.0,0.0
2301,658830,500,7876,500,8876,1000,501,15.752,0.0
2302,3861401,0,123258,0,123758,500,501,246.516,0.0
2303,605676,480,8662,480,9622,960,481,18.046,0.0
2305,39897,40,480,40,560,80,41,12.0,0.0
2306,405686,430,6231,430,7091,860,431,14.491,0.0
2310,44400,166,332,166,664,332,167,2.0,0.0
2312,428909,500,6494,500,7494,1000,501,12.988,0.0
2313,585790,500,9157,500,10157,1000,501,18.314,0.0
2314,18153,52,156,52,260,104,53,3.0,0.0
2315,224126,0,2000,0,2050,50,51,40.0,0.5
2316,1387858,0,20019,0,20519,500,501,40.038,0.0
2317,9264,27,81,27,135,54,28,3.0,0.0
2318,357265,500,9500,500,10500,1000,501,19.0,0.0
2320,42057,0,542,0,581,39,40,13.897,1.0
2321,607972,500,8376,500,9376,1000,501,16.752,0.0
2322,821381,500,12494,500,13494,1000,501,24.988,0.0
2323,398996,500,6000,500,7000,1000,501,12.0,0.0
2325,50090,0,440,0,451,11,12,40.0,0.5
2326,565378,500,6777,500,7777,1000,501,13.554,0.5
2327,527983,500,8824,500,9824,1000,501,17.648,0.0
23278,3677530,2000,42004,2000,46004,4000,2002,21.002,0.0
23279,11703,20,132,20,172,40,21,6.6,0.0
23281,273610,1000,1000,1000,3000,2000,1001,1.0,0.0
23284,957255,1000,9000,1000,11000,2000,1001,9.0,0.0
23285,9918687,1000,91675,1000,94570,2895,1017,91.675,0.0
23286,269609,1000,1000,1000,3000,2000,1001,1.0,0.0
23287,56617,42,567,42,651,84,44,13.5,0.0
23288,753589,536,7410,536,8482,1072,538,13.825,0.0
2329,529516,500,8853,500,9853,1000,501,17.706,0.0
23291,215305,180,2446,180,2806,360,182,13.589,0.0
23293,26756,16,232,16,264,32,18,14.5,0.0
23294,269609,1000,1000,1000,3000,2000,1001,1.0,0.0
23295,162518,134,1819,134,2087,268,136,13.575,0.0
23296,391697,268,3873,268,4409,536,270,14.451,0.0
23297,2644159,2000,27916,2000,31916,4000,2002,13.958,0.5
23298,269609,1000,1000,1000,3000,2000,1001,1.0,0.0
23299,19141,12,174,12,198,24,14,14.5,0.0
2330,1299744,500,12000,500,13500,1500,507,24.0,0.0
23300,921,1,2,1,4,2,2,2.0,0.0
23301,273610,1000,1000,1000,3000,2000,1001,1.0,0.0
23302,269609,1000,1000,1000,3000,2000,1001,1.0,0.0
23304,269609,1000,1000,1000,3000,2000,1001,1.0,0.0
23305,116614,138,1311,138,1587,276,140,9.5,0.0
23306,273610,1000,1000,1000,3000,2000,1001,1.0,0.0
23307,1611960,1932,18368,1932,22232,3864,1934,9.507,0.0
23308,137059,97,1477,97,1671,194,98,15.227,0.0
23309,273610,1000,1000,1000,3000,2000,1001,1.0,0.0
2331,241552,500,3040,500,4040,1000,501,6.08,0.0
23310,2823009,115,9047,115,9384,337,118,78.67,0.0
23311,113228,85,1114,85,1284,170,86,13.106,0.0
23312,6070,20,20,20,60,40,21,1.0,0.0
23313,2077311,1462,20491,1462,23415,2924,1464,14.016,0.0
23314,269609,1000,1000,1000,3000,2000,1001,1.0,0.0
23315,13402,19,146,19,184,38,20,7.684,0.0
23316,2609316,1000,31195,1000,33195,2000,1001,31.195,0.0
23317,5989,20,20,20,60,40,21,1.0,0.0
23318,2045067,1356,21557,1356,24269,2712,1358,15.897,0.5
23319,219194,160,2341,160,2661,320,161,14.631,0.0
2332,1302070,500,17499,500,18499,1000,501,34.998,0.5
23320,269609,1000,1000,1000,3000,2000,1001,1.0,0.0
23321,6070,20,20,20,60,40,21,1.0,0.0
23322,5989,20,20,20,60,40,21,1.0,0.0
23323,273610,1000,1000,1000,3000,2000,1001,1.0,0.0
23324,2988082,1000,34692,1000,36692,2000,1001,34.692,0.0
23325,6070,20,20,20,60,40,21,1.0,0.0
23326,5989,20,20,20,60,40,21,1.0,0.0
23327,269609,1000,1000,1000,3000,2000,1001,1.0,0.0
23328,5989,20,20,20,60,40,21,1.0,0.0
23329,5989,20,20,20,60,40,21,1.0,0.0
2333,1467588,0,6714,0,6752,38,39,176.684,0.0
23330,5989,20,20,20,60,40,21,1.0,0.0
23331,6070,20,20,20,60,40,21,1.0,0.0
23332,5989,20,20,20,60,40,21,1.0,0.0
23333,6070,20,20,20,60,40,21,1.0,0.0
23334,5989,20,20,20,60,40,21,1.0,0.0
23335,5720,19,19,19,57,38,20,1.0,0.0
23336,5989,20,20,20,60,40,21,1.0,0.0
23337,805738,638,8930,638,10206,1276,640,13.997,0.0
23338,6070,20,20,20,60,40,21,1.0,0.0
23339,26698,34,170,34,238,68,35,5.0,0.0
2334,303665,500,4000,500,5000,1000,501,8.0,0.0
23340,6070,20,20,20,60,40,21,1.0,0.0
23341,5989,20,20,20,60,40,21,1.0,0.0
23342,5989,20,20,20,60,40,21,1.0,0.0
23343,5989,20,20,20,60,40,21,1.0,0.0
23345,2701885,2000,31461,2000,35461,4000,2002,15.73,0.5
23346,5989,20,20,20,60,40,21,1.0,0.0
23347,2753192,2000,31067,2000,35067,4000,2002,15.534,0.0
23348,5989,20,20,20,60,40,21,1.0,0.0
23349,5720,19,19,19,57,38,20,1.0,0.0
23350,5989,20,20,20,60,40,21,1.0,0.0
23351,107587,88,1159,88,1335,176,89,13.17,0.0
23352,52902,34,586,34,654,68,36,17.235,0.0
23353,269609,1000,1000,1000,3000,2000,1001,1.0,0.0
23354,5720,19,19,19,57,38,20,1.0,0.0
23355,5720,19,19,19,57,38,20,1.0,0.0
23356,5989,20,20,20,60,40,21,1.0,0.0
23357,5720,19,19,19,57,38,20,1.0,0.0
23358,5720,19,19,19,57,38,20,1.0,0.0
23359,5720,19,19,19,57,38,20,1.0,0.0
2336,8525568,492,94512,492,95496,984,493,192.098,0.0
23360,5720,19,19,19,57,38,20,1.0,0.0
23361,5797,19,19,19,57,38,20,1.0,0.0
23363,247587,1000,1000,1000,3000,2000,1001,1.0,0.0
23364,813915,1000,12957,1000,14957,2000,1001,12.957,1.0
23366,783714,0,12940,0,13940,1000,1001,12.94,0.0
23367,247587,1000,1000,1000,3000,2000,1001,1.0,0.0
23368,251588,1000,1000,1000,3000,2000,1001,1.0,0.0
2337,510180,500,6882,500,7882,1000,501,13.764,0.0
23370,972534,0,16601,0,17601,1000,1001,16.601,0.0
23371,1493,2,14,2,18,4,3,7.0,0.0
23374,822046,0,12000,0,13000,1000,1001,12.0,0.0
23375,247587,1000,1000,1000,3000,2000,1001,1.0,0.0
23376,247587,1000,1000,1000,3000,2000,1001,1.0,0.0
23377,586772,0,7987,0,8987,1000,1001,7.987,0.0
2338,522488,0,5458,0,5958,500,501,10.916,0.0
23382,5150,14,42,14,70,28,15,3.0,0.0
2339,105928,108,1728,108,1944,216,109,16.0,0.0
23400,4828,0,54,0,63,9,10,6.0,0.0
23402,251588,1000,1000,1000,3000,2000,1001,1.0,0.0
23403,247587,1000,1000,1000,3000,2000,1001,1.0,0.5
23404,5470,12,72,12,96,24,13,6.0,0.0
23405,22515,46,230,46,322,92,47,5.0,0.0
23407,12633,0,144,0,180,36,37,4.0,0.0
23408,6140,0,64,0,80,16,17,4.0,0.0
23409,4094,10,40,10,60,20,11,4.0,0.0
23411,1834,4,12,4,20,8,5,3.0,0.0
23413,1081,2,2,2,6,4,3,1.0,0.0
2342,1181982,500,16926,500,17926,1000,501,33.852,0.0
23420,1081,2,2,2,6,4,3,1.0,0.0
2344,1548,1,21,1,23,2,2,21.0,0.0
2345,358892,0,3993,0,4493,500,501,7.986,0.0
2346,1299936,0,31439,0,31939,500,501,62.878,0.0
2347,882695,480,11499,480,12459,960,481,23.956,0.0
2348,860703,500,12635,500,13635,1000,501,25.27,0.0
2351,1100701,0,8634,0,9028,394,395,21.914,0.0
2353,484349,500,5966,500,6966,1000,501,11.932,0.5
2355,373840,500,4948,500,5948,1000,501,9.896,0.5
2356,11629,0,132,0,143,11,12,12.0,0.5
2358,4117,11,33,11,55,22,12,3.0,0.0
2360,701573,500,7502,500,8502,1000,501,15.004,0.0
2361,3030518,0,88125,0,88625,500,501,176.25,0.0
2362,293724,0,4500,0,5000,500,501,9.0,0.0
2363,372592,517,4656,517,5690,1034,519,9.006,0.0
2364,112164,177,885,177,1239,354,178,5.0,0.0
2370,2514,3,21,3,27,6,4,7.0,0.0
2371,190572,500,1500,500,2500,1000,501,3.0,0.0
2373,1566,0,14,0,16,2,3,7.0,0.0
2378,366941,500,3208,500,4223,1015,516,6.416,0.0
23787,63436,170,680,170,1020,340,171,4.0,1.0
2379,634924,500,9098,500,10098,1000,501,18.196,0.0
23794,606155,1000,8000,1000,10000,2000,1001,8.0,0.0
2381,472150,0,8500,0,9000,500,501,17.0,0.0
23858,1190179,169,21970,169,22308,338,170,130.0,0.0
2387,9046,10,69,10,97,28,19,6.9,0.0
23894,994538,0,18545,0,19545,1000,1001,18.545,0.0
23896,962904,0,16997,0,17997,1000,1001,16.997,1.0
23899,871315,1000,10119,1000,12119,2000,1001,10.119,0.5
23901,12326,0,111,0,149,38,39,5.842,0.0
23903,983490,0,18421,0,19421,1000,1001,18.421,0.0
23905,383975,905,4525,905,6335,1810,906,5.0,0.0
2391,628021,500,8488,500,9488,1000,501,16.976,0.0
23915,922912,0,16843,0,17843,1000,1001,16.843,0.0
23917,476871,1000,6000,1000,8000,2000,1001,6.0,0.0
23918,18009,0,245,0,280,35,36,7.0,0.0
23919,5960,0,70,0,79,9,10,7.778,0.0
2392,421159,0,6285,0,6785,500,501,12.57,0.0
23920,997136,0,18203,0,19203,1000,1001,18.203,0.0
23923,2043675,0,33925,0,34925,1000,1001,33.925,0.0
23925,975764,0,17264,0,18264,1000,1001,17.264,0.0
23928,117227,0,1854,0,1944,90,91,20.6,0.0
23929,680263,0,12405,0,13133,728,729,17.04,0.0
2393,58719,138,414,138,749,335,198,3.0,0.5
23933,968365,0,17872,0,18872,1000,1001,17.872,0.0
23938,720626,1000,10000,1000,12000,2000,1001,10.0,0.0
23940,894957,0,16218,0,17218,1000,1001,16.218,0.0
23941,496805,1000,5000,1000,7000,2000,1001,5.0,0.0
23944,873012,0,15757,0,16757,1000,1001,15.757,0.0
23951,1726850,1000,35933,1000,37933,2000,1001,35.933,0.0
2396,47119,17,113,17,159,46,30,6.647,0.0
2397,343326,0,5500,0,6000,500,501,11.0,0.5
23972,1824592,0,28968,0,29968,1000,1001,28.968,0.0
23975,204130,170,5949,170,6289,340,171,34.994,0.0
23979,1189598,0,17720,0,18540,820,821,21.61,0.0
2398,216816,170,1530,170,1870,340,171,9.0,0.5
23981,1142183,169,21125,169,21463,338,170,125.0,0.0
23983,703534,1000,9999,1000,11999,2000,1001,9.999,0.0
23986,496101,0,8000,0,9000,1000,1001,8.0,1.0
2399,1031024,500,18023,500,19023,1000,501,36.046,0.0
2400,5673,0,62,0,70,8,9,7.75,0.0
2404,77811,69,1039,69,1177,138,70,15.058,0.0
24043,1468952,1000,25136,1000,27136,2000,1001,25.136,0.0
24048,6820111,0,164836,0,165648,812,813,203.0,0.0
24051,1618033,0,25795,0,26795,1000,1001,25.795,0.5
24052,832323,908,15420,908,17236,1816,909,16.982,0.0
24058,650220,599,7918,599,9116,1198,600,13.219,0.0
2406,11547,18,126,18,162,36,19,7.0,1.0
24063,1334059,1000,13268,1000,15268,2000,1001,13.268,0.0
2407,542140,500,10500,500,11500,1000,501,21.0,0.0
24070,162582,179,3759,179,4117,358,180,21.0,0.0
24073,6824130,812,164836,812,166460,1624,813,203.0,0.0
24076,1300180,0,20467,0,21467,1000,1001,20.467,0.0
24082,593022,1000,7922,1000,9922,2000,1001,7.922,0.0
24085,428758,1000,6000,1000,8000,2000,1001,6.0,0.5
24086,12656,34,102,34,170,68,35,3.0,0.5
24088,7388,0,82,0,92,10,11,8.2,0.0
2409,8163,0,87,0,99,12,13,7.25,0.0
24090,1526007,793,31587,793,34173,2586,1795,17.617,0.0
24095,1142183,169,21125,169,21463,338,170,125.0,0.0
24096,991648,0,14000,0,15000,1000,1001,14.0,0.0
24097,357421,0,5146,0,5312,166,167,31.0,0.0
24117,46397,0,518,0,622,104,105,4.981,0.0
24120,1032781,0,18795,0,19795,1000,1001,18.795,0.0
24122,312399,0,3839,0,4322,483,484,7.948,0.0
2413,1256163,184,29752,184,30120,368,185,161.696,0.0
24135,288750,0,4271,0,4477,206,207,20.733,0.0
2414,217125,0,2500,0,3000,500,501,5.0,0.0
24142,111794,0,1026,0,1197,171,172,6.0,0.0
2416,86536,264,726,264,1254,528,265,2.75,0.0
24160,87447,264,720,264,1248,528,265,2.727,0.0
24168,6819867,0,164836,0,165648,812,813,203.0,1.0
24169,250223,0,3939,0,4110,171,172,23.035,0.0
24171,6810970,812,164836,812,166460,1624,813,203.0,0.0
24175,12383,34,102,34,170,68,35,3.0,0.5
24177,83744,246,738,246,1230,492,247,3.0,0.0
24179,2378136,200,29600,200,30000,400,201,148.0,0.0
2418,77813,69,1039,69,1177,138,70,15.058,0.0
24185,1560,3,9,3,15,6,4,3.0,0.5
24187,511961,0,4998,0,5998,1000,1001,4.998,0.0
24188,95095,264,1088,264,1616,528,265,4.121,0.0
2419,210110,0,3170,0,3487,317,318,10.0,0.0
24191,96558,264,1097,264,1625,528,265,4.155,0.0
24193,46176,0,518,0,622,104,105,4.981,0.0
2420,730722,0,10888,0,11388,500,501,21.776,0.0
24200,87008,264,704,264,1232,528,265,2.667,0.0
24211,624616,0,9878,0,10776,898,899,11.0,0.0
24216,355232,881,3524,881,5286,1762,882,4.0,0.0
24217,5960,0,70,0,79,9,10,7.778,0.0
24233,5437,0,57,0,65,8,9,7.125,0.0
24239,445193,0,4948,0,5948,1000,1001,4.948,0.0
24285,18052,20,229,20,269,40,21,11.45,0.0
2429,2628727,204,38148,204,38556,408,205,187.0,0.0
24293,6027688,812,165648,812,167272,1624,813,204.0,0.5
24309,208710,536,2144,536,3216,1072,537,4.0,0.0
2431,358882,500,5680,500,6680,1000,501,11.36,0.0
24313,14637,28,192,28,248,56,29,6.857,0.0
2432,11468,0,109,0,120,11,12,9.909,0.5
24321,9003,0,90,0,102,12,13,7.5,0.0
24324,7534,0,79,0,88,9,10,8.778,0.0
24327,1082549,1000,21000,1000,23000,2000,1001,21.0,0.0
24329,1050562,966,20286,966,22218,1932,967,21.0,0.0
24333,2614361,203,37961,203,38367,406,204,187.0,0.0
24335,560041,0,9000,0,10000,1000,1001,9.0,0.0
24340,34540,48,335,48,431,96,49,6.979,0.0
2435,7192,18,68,18,104,36,19,3.778,0.0
24350,278575,1000,2000,1000,4000,2000,1001,2.0,0.0
24353,3174,0,36,0,42,6,7,6.0,0.0
24354,158474,199,1785,199,2183,398,200,8.97,0.0
24358,210110,0,3170,0,3487,317,318,10.0,0.0
2436,302187,500,4000,500,5000,1000,501,8.0,0.0
24360,5495,0,58,0,67,9,10,6.444,0.0
24362,520145,1000,7000,1000,9000,2000,1001,7.0,0.0
24363,328214,17,85,17,119,34,18,5.0,0.5
24366,298176,270,2419,270,2959,540,271,8.959,0.0
2437,288750,0,4271,0,4477,206,207,20.733,0.0
24374,2628727,204,38148,204,38556,408,205,187.0,0.0
24377,560596,1000,8000,1000,10000,2000,1001,8.0,0.0
2438,55309,0,603,0,651,48,49,12.562,0.0
2439,4198494,0,101500,0,102000,500,501,203.0,0.5
24391,160706,670,670,670,2010,1340,671,1.0,0.0
24398,55309,0,603,0,651,48,49,12.562,0.0
24404,1102053,0,21000,0,22000,1000,1001,21.0,0.0
24406,3406,0,45,0,50,5,6,9.0,0.0
24411,11468,0,109,0,120,11,12,9.909,0.5
24412,1429335,1000,16708,1000,18708,2000,1001,16.708,0.5
24417,424702,845,6760,845,8450,1690,846,8.0,0.0
24418,817858,589,15824,589,17002,1178,590,26.866,0.0
24420,86103,0,1467,0,1632,165,166,8.891,0.0
24427,274512,292,4816,292,5400,584,293,16.493,0.0
2443,2498,2,16,2,24,8,6,8.0,0.0
24432,5665,0,48,0,60,12,13,4.0,0.0
24435,1750,5,5,5,15,10,6,1.0,0.0
2444,282675,0,4937,0,5432,495,496,9.974,0.5
24440,629844,0,8742,0,8912,170,171,51.424,0.0
24442,454592,1000,7000,1000,9000,2000,1001,7.0,0.0
24446,17495,72,72,72,216,144,73,1.0,0.0
2445,1269505,500,19404,500,20404,1000,501,38.808,0.5
24450,676105,0,10932,0,11926,994,995,10.998,0.0
24454,101881,177,1526,177,1880,354,178,8.621,0.0
24464,398760,549,5490,549,6588,1098,550,10.0,0.0
24471,16350,66,66,66,198,132,67,1.0,0.0
24473,5261,12,48,12,72,24,13,4.0,0.0
24478,5521,0,48,0,60,12,13,4.0,0.0
24481,8965,13,65,13,106,41,29,5.0,0.0
24482,5713540,1000,101713,1000,103713,2000,1001,101.713,0.0
24488,235575,1000,1000,1000,3000,2000,1001,1.0,0.0
2449,1334683,500,19198,500,20198,1000,501,38.396,0.0
24491,1985,6,6,6,18,12,7,1.0,0.0
24497,418935,1000,4995,1000,6995,2000,1001,4.995,0.0
24498,6450,25,25,25,75,50,26,1.0,0.0
2450,365785,0,4494,0,4994,500,501,8.988,0.5
24502,348612,570,3984,570,5124,1140,571,6.989,0.0
24505,170983,713,713,713,2139,1426,714,1.0,0.0
24506,13014,18,144,18,180,36,19,8.0,0.0
24507,239576,1000,1000,1000,3000,2000,1001,1.0,0.0
2451,50425,61,226,61,455,229,139,3.705,0.0
24513,9972,0,110,0,125,15,16,7.333,0.0
24514,138124,177,1516,177,1870,354,178,8.565,0.0
24521,91096,67,1282,67,1416,134,68,19.134,0.0
24526,2220,7,7,7,21,14,8,1.0,0.0
24527,13454,8,112,8,128,16,9,14.0,0.0
24528,711056,1000,9000,1000,11000,2000,1001,9.0,0.0
24529,7951,15,87,15,117,30,16,5.8,0.0
2453,785271,500,12500,500,13500,1000,501,25.0,0.5
24530,18502,0,221,0,241,20,21,11.05,0.0
24539,498068,1000,8000,1000,10000,2000,1001,8.0,0.0
24542,780695,1000,12610,1000,14610,2000,1001,12.61,0.0
24543,3202,6,33,6,45,12,7,5.5,0.0
24546,426047,0,6930,0,7560,630,631,11.0,0.0
24549,5212,9,60,9,78,18,10,6.667,0.0
2455,783904,500,12479,500,13479,1000,501,24.958,0.5
24550,12500,25,125,25,175,50,26,5.0,0.0
24553,51762,46,690,46,782,92,47,15.0,0.0
24555,28070,117,117,117,351,234,118,1.0,0.0
24556,2455,8,8,8,24,16,9,1.0,0.0
2456,86591,60,1179,60,1299,120,61,19.65,0.0
24572,99441,173,1203,173,1549,346,174,6.954,0.0
24574,1715699,0,14553,0,14723,170,171,85.606,0.0
24575,491620,72,1152,72,1296,144,73,16.0,0.0
24576,520493,726,8242,726,9694,1452,727,11.353,0.0
24583,2591,5,20,5,30,10,6,4.0,0.0
24584,146755,306,1836,306,2448,612,307,6.0,0.0
24586,3848,7,43,7,57,14,8,6.143,0.0
2459,335723,500,5463,500,6463,1000,501,10.926,0.0
24596,642851,0,10340,0,11280,940,941,11.0,0.0
24599,216816,170,1530,170,1870,340,171,9.0,0.5
2460,1180348,500,21896,500,22896,1000,501,43.792,0.0
24600,371126,0,6072,0,6624,552,553,11.0,0.0
24608,11354,0,108,0,127,19,20,5.684,0.0
24612,352788,0,5698,0,6216,518,519,11.0,0.0
24614,184218,0,3014,0,3288,274,275,11.0,0.0
24616,227023,169,1521,169,1859,338,170,9.0,0.0
24618,7192,18,68,18,104,36,19,3.778,0.0
2462,70448,117,1247,117,1481,234,118,10.658,0.0
24620,104008,171,1193,171,1535,342,172,6.977,0.0
24623,64820,23,183,23,229,46,24,7.957,0.0
24625,12244,24,144,24,192,48,25,6.0,0.0
24627,72485,306,306,306,918,612,307,1.0,0.0
2463,377472,500,5840,500,6840,1000,501,11.68,0.5
24630,20939,25,236,25,286,50,26,9.44,0.0
24631,1046740,1000,14893,1000,16893,2000,1001,14.893,0.0
24636,229264,170,1530,170,1870,340,171,9.0,0.0
2464,16296,0,192,0,240,48,49,4.0,1.0
24640,762249,1000,11970,1000,13970,2000,1001,11.97,0.0
24641,75775,320,320,320,960,640,321,1.0,0.0
24643,9044,18,83,18,119,36,19,4.611,0.0
24644,77813,69,1039,69,1177,138,70,15.058,0.0
24645,6690,13,78,13,104,26,14,6.0,1.0
24646,235575,1000,1000,1000,3000,2000,1001,1.0,0.0
2465,1900,2,10,2,14,4,3,5.0,0.0
24657,53060,47,705,47,799,94,48,15.0,0.0
24658,75775,320,320,320,960,640,321,1.0,0.0
24659,75775,320,320,320,960,640,321,1.0,0.0
2466,56814,0,826,0,885,59,60,14.0,0.0
24660,75775,320,320,320,960,640,321,1.0,0.0
24661,4066459,0,72417,0,73129,712,713,101.709,0.0
24663,92107,68,1282,68,1418,136,69,18.853,0.0
24664,4084615,0,72758,0,73474,716,717,101.617,0.0
24667,75775,320,320,320,960,640,321,1.0,0.0
24668,77056,320,320,320,960,640,321,1.0,0.0
24673,696297,1000,10000,1000,12000,2000,1001,10.0,0.0
24674,23520,96,96,96,288,192,97,1.0,0.0
24676,75775,320,320,320,960,640,321,1.0,0.0
24677,75775,320,320,320,960,640,321,1.0,0.0
24686,75775,320,320,320,960,640,321,1.0,0.0
24688,75775,320,320,320,960,640,321,1.0,0.0
24689,646611,1000,8000,1000,10000,2000,1001,8.0,0.0
2469,639588,0,6893,0,7393,500,501,13.786,0.0
24691,694713,1000,9000,1000,11000,2000,1001,9.0,0.0
24693,75775,320,320,320,960,640,321,1.0,0.0
24694,75775,320,320,320,960,640,321,1.0,0.0
24695,121197,178,1317,178,1673,356,179,7.399,0.5
2470,290991,500,4464,500,5464,1000,501,8.928,0.5
24700,75775,320,320,320,960,640,321,1.0,0.0
24702,75775,320,320,320,960,640,321,1.0,0.0
24704,700279,1000,9000,1000,11000,2000,1001,9.0,0.0
24706,75775,320,320,320,960,640,321,1.0,0.0
24708,690130,1000,8000,1000,10000,2000,1001,8.0,0.0
24709,75775,320,320,320,960,640,321,1.0,0.0
2471,822702,500,12500,500,13500,1000,501,25.0,0.0
24710,75775,320,320,320,960,640,321,1.0,0.0
24711,715420,1000,9000,1000,11000,2000,1001,9.0,0.0
24712,75775,320,320,320,960,640,321,1.0,0.0
24716,77811,69,1039,69,1177,138,70,15.058,0.0
24721,124468,178,1324,178,1680,356,179,7.438,0.5
24724,92329,68,1285,68,1421,136,69,18.897,0.0
24727,709124,1000,9000,1000,11000,2000,1001,9.0,0.0
24729,619293,899,11676,899,13474,1798,900,12.988,0.0
24732,123945,181,2351,181,2713,362,182,12.989,0.0
24736,563565,899,8091,899,9889,1798,900,9.0,0.0
24738,373861,1000,3869,1000,5869,2000,1001,3.869,0.0
24739,360983,1000,3997,1000,5997,2000,1001,3.997,0.0
24742,352701,899,4495,899,6293,1798,900,5.0,0.0
24743,137197,181,1991,181,2353,362,182,11.0,0.0
24744,68552,181,905,181,1267,362,182,5.0,0.0
24745,271849,182,4529,182,4893,364,183,24.885,0.0
24746,112106,181,1629,181,1991,362,182,9.0,0.0
2475,77525,62,992,62,1116,124,63,16.0,0.0
2476,346992,500,9000,500,10000,1000,501,18.0,0.0
2478,598509,409,15014,409,15832,818,410,36.709,0.0
24782,6609,9,99,9,117,18,10,11.0,0.0
2479,12499588,500,60000,500,61000,1000,501,120.0,0.0
2480,374947,500,6198,500,7198,1000,501,12.396,0.0
24800,1653,3,9,3,15,6,4,3.0,0.0
24802,937411,2000,13000,2000,17000,4000,2002,6.5,0.0
24815,5167,13,39,13,65,26,14,3.0,0.0
2482,1325353,0,17800,0,18300,500,501,35.6,0.5
24830,1073,1,5,1,7,2,2,5.0,0.0
24834,1599,3,9,3,15,6,4,3.0,0.0
24835,18640,36,180,36,252,72,37,5.0,0.0
2484,2124020,0,53226,0,53726,500,501,106.452,0.0
24844,6065,0,50,0,62,12,13,4.167,0.0
24845,1339,2,6,2,10,4,3,3.0,0.0
2485,435532,160,4369,160,4689,320,161,27.306,0.0
24853,2800,0,18,0,24,6,7,3.0,0.0
24854,5575,0,47,0,59,12,13,3.917,0.0
2486,3117,4,36,4,44,8,5,9.0,0.0
24863,28481,106,106,106,318,212,107,1.0,0.0
24864,9717,17,136,17,170,34,18,8.0,0.0
24865,3007,9,9,9,27,18,10,1.0,0.0
24866,647793,1000,7998,1000,9998,2000,1001,7.998,0.0
2487,886046,500,14500,500,15500,1000,501,29.0,0.5
24873,3303,4,28,4,36,8,5,7.0,0.0
24876,18495,36,180,36,252,72,37,5.0,0.0
24877,2527,3,27,3,33,6,4,9.0,0.0
24878,866,1,1,1,3,2,2,1.0,0.0
2488,266099,191,3449,191,3831,382,192,18.058,0.0
24880,1778,3,9,3,15,6,4,3.0,0.0
24881,5127,13,39,13,65,26,14,3.0,0.0
24886,22104,35,278,35,348,70,36,7.943,0.0
24887,3720,6,36,6,48,12,7,6.0,0.0
2489,653363,500,6927,500,7927,1000,501,13.854,0.0
24890,9278,10,100,10,120,20,11,10.0,0.5
24893,1671,3,9,3,15,6,4,3.0,0.0
24896,5337,18,18,18,54,36,19,1.0,0.0
24898,1405,3,3,3,9,6,4,1.0,0.0
24899,3496,11,11,11,33,22,12,1.0,0.0
24901,5574,12,47,12,71,24,13,3.917,0.0
24902,2029,4,12,4,20,8,5,3.0,0.5
24904,5858,11,55,11,77,22,12,5.0,0.5
24905,2970,9,9,9,27,18,10,1.0,0.0
24907,1685,2,12,2,16,4,3,6.0,0.0
24913,2181,6,6,6,18,12,7,1.0,0.0
24917,1655,4,4,4,12,8,5,1.0,0.0
2492,18746,18,126,18,213,87,69,7.0,0.0
24927,144905,316,2166,316,2798,632,318,6.854,0.0
2493,18815,0,240,0,252,12,13,20.0,0.5
24934,1655,4,4,4,12,8,5,1.0,0.0
24937,2181,6,6,6,18,12,7,1.0,0.0
2494,29333,0,264,0,396,132,102,8.0,0.0
24945,4022,13,13,13,39,26,14,1.0,0.0
24946,741288,1000,10982,1000,12982,2000,1001,10.982,0.0
2495,232735,256,3805,256,4573,768,482,14.863,0.0
24956,5559,14,42,14,70,28,15,3.0,0.0
24957,2527,3,27,3,33,6,4,9.0,0.0
24966,5094,11,44,11,66,22,12,4.0,0.0
2497,1302070,500,17499,500,18499,1000,501,34.998,0.5
2498,21733,35,315,35,385,70,36,9.0,0.0
2500,25945,39,468,39,546,78,40,12.0,0.0
2501,356074,0,4932,0,5432,500,501,9.864,0.0
2502,2714128,500,26101,500,27101,1000,501,52.202,0.0
2504,483034,500,7480,500,8480,1000,501,14.96,0.0
2505,1500244,0,20159,0,20659,500,501,40.318,0.5
2506,248603,500,3408,500,4408,1000,501,6.816,0.0
2507,4714,3,69,3,75,6,4,23.0,0.0
2508,328222,120,4104,120,4344,240,121,34.2,0.0
2509,86044,0,1002,0,1103,101,102,9.921,0.5
2510,794823,500,12500,500,13500,1000,501,25.0,1.0
2511,807338,500,12401,500,13401,1000,501,24.802,0.0
2514,90190,187,1122,187,1496,374,188,6.0,0.0
2515,584158,500,9960,500,10960,1000,501,19.92,0.5
2516,313696,500,5000,500,6000,1000,501,10.0,0.0
2517,1317823,500,11265,500,12765,1500,511,22.53,0.0
2518,342423,0,4271,0,4771,500,501,8.542,0.0
25202,219704,216,2528,216,2960,432,217,11.704,0.0
25204,227042,300,2495,300,3095,600,302,8.317,0.0
25207,227042,300,2495,300,3095,600,302,8.317,0.0
25209,227042,300,2495,300,3095,600,302,8.317,0.0
2521,266103,500,3815,500,4815,1000,501,7.63,0.0
25211,663677,1000,8991,1000,10991,2000,1001,8.991,0.0
25213,471641,565,3915,565,5045,1130,566,6.929,0.0
25214,4551936,370,52572,370,53312,740,371,142.086,0.0
25217,1050394,1000,14973,1000,16973,2000,1001,14.973,0.0
2522,141028,111,767,111,990,223,113,6.91,0.5
25228,1625432,1832,25794,1832,29458,3664,1834,14.08,0.0
25229,1579165,2000,23998,2000,27998,4000,2002,11.999,0.0
25237,1819709,2000,33241,2000,38241,5000,3002,11.08,0.0
25257,1050394,1000,14973,1000,16973,2000,1001,14.973,0.0
2526,396786,500,5776,500,6776,1000,501,11.552,0.0
25277,276791,419,3352,419,4190,838,420,8.0,0.0
25278,268412,419,2933,419,3771,838,420,7.0,0.0
25286,2326175,395,70430,395,71220,790,396,178.304,0.0
25301,16639,0,330,0,345,15,16,22.0,0.0
25306,237918,0,1274,0,1611,337,338,3.78,0.0
25312,525044,0,10608,0,10947,339,340,31.292,0.0
25321,1452668,3000,22000,3000,29000,7000,4002,5.5,0.0
25341,72828,0,1114,0,1246,132,133,8.439,0.0
25356,2874143,2996,47001,2996,53993,6992,3998,11.762,1.0
2536,4785,6,38,6,50,12,7,6.333,0.0
2540,499247,500,3264,500,5775,2511,544,6.528,0.5
25404,37725,73,420,73,566,146,74,5.753,0.0
25406,774332,0,14994,0,15890,896,897,16.734,0.0
25408,51279,0,729,0,817,88,89,8.284,0.5
2544,397235,500,5786,500,6786,1000,501,11.572,0.0
2546,3085,3,20,3,28,8,6,6.667,0.0
25460,1241,0,6,0,8,2,3,3.0,0.0
2549,16260,0,195,0,220,25,26,7.8,0.0
25498,4465,6,60,6,72,12,7,10.0,0.0
2551,336039,434,4121,434,5285,1164,732,9.495,0.0
25543,12145,13,182,13,208,26,14,14.0,0.5
2555,16496,35,140,35,210,70,36,4.0,0.0
25551,29672,12,506,12,530,24,13,42.167,0.5
25584,35236,0,570,0,608,38,39,15.0,0.0
2560,424109,0,6354,0,6854,500,501,12.708,0.0
2561,112040,72,1633,72,1777,144,73,22.681,0.5
2565,328214,17,85,17,119,34,18,5.0,0.0
2566,1190179,169,21970,169,22308,338,170,130.0,0.0
2570,51762,46,690,46,782,92,47,15.0,0.0
2571,83748,246,738,246,1230,492,247,3.0,0.0
2572,86323,264,718,264,1246,528,265,2.72,0.0
25722,168687,649,649,649,1947,1298,650,1.0,0.0
2574,2981541,0,37200,0,37400,200,201,186.0,0.0
25743,6970,25,25,25,75,50,26,1.0,0.0
2575,243164,0,4000,0,4500,500,501,8.0,0.5
2576,86103,0,1467,0,1632,165,166,8.891,0.0
25771,119935,468,468,468,1404,936,469,1.0,0.0
2578,211261,0,2500,0,3000,500,501,5.0,0.5
2579,121197,178,1317,178,1673,356,179,7.399,0.5
25792,255595,1000,1000,1000,3000,2000,1001,1.0,0.0
25806,255595,1000,1000,1000,3000,2000,1001,1.0,0.0
25818,107440,419,419,419,1257,838,420,1.0,0.0
2582,1715699,0,14553,0,14723,170,171,85.606,0.0
25823,255595,1000,1000,1000,3000,2000,1001,1.0,0.0
2583,216785,0,2491,0,2991,500,501,4.982,0.0
25833,259596,1000,1000,1000,3000,2000,1001,1.0,0.0
25835,98005,382,382,382,1146,764,383,1.0,0.0
25836,5485,7,105,7,119,14,8,15.0,0.5
2584,69242,0,676,0,845,169,170,4.0,0.0
2585,296927,187,4993,187,5367,374,188,26.701,0.0
25855,35275,136,136,136,408,272,137,1.0,0.0
2587,541628,500,10500,500,11500,1000,501,21.0,0.0
25875,255595,1000,1000,1000,3000,2000,1001,1.0,0.0
2588,9003,0,90,0,102,12,13,7.5,0.0
2589,3211978,500,90500,500,91500,1000,501,181.0,0.5
2590,58966,68,534,68,670,136,69,7.853,0.0
25901,675397,0,8933,0,9933,1000,1001,8.933,0.0
2591,355589,500,4500,500,5500,1000,501,9.0,0.0
2592,162582,179,3759,179,4117,358,180,21.0,0.0
25927,263605,0,1000,0,2000,1000,1001,1.0,0.0
2593,354018,500,5621,500,6621,1000,501,11.242,0.5
25932,94771,0,792,0,1056,264,265,3.0,0.0
25935,263605,0,1000,0,2000,1000,1001,1.0,0.0
25944,4784,0,36,0,48,12,13,3.0,0.0
25949,27901,0,103,0,206,103,104,1.0,0.0
2595,491620,72,1152,72,1296,144,73,16.0,0.0
25959,265605,1000,1000,1000,3000,2000,1001,1.0,0.0
2596,260517,500,3500,500,4500,1000,501,7.0,0.0
25960,265605,1000,1000,1000,3000,2000,1001,1.0,0.0
2597,101881,177,1526,177,1880,354,178,8.621,0.0
25971,8185,9,52,9,74,22,14,5.778,0.0
25972,265605,1000,1000,1000,3000,2000,1001,1.0,0.0
25975,5517,0,50,0,60,10,11,5.0,0.0
2598,6690,13,78,13,104,26,14,6.0,0.5
25983,15104,0,192,0,216,24,25,8.0,0.0
25986,51179,0,512,0,640,128,129,4.0,0.0
26004,12342,34,101,34,169,68,35,2.971,0.0
2601,95750,264,1094,264,1622,528,265,4.144,0.5
26018,272914,24,192,24,240,48,25,8.0,0.0
26032,263605,0,1000,0,2000,1000,1001,1.0,0.0
26037,269606,1000,1000,1000,3000,2000,1001,1.0,0.0
26040,1707,1,9,1,12,3,3,9.0,0.0
26041,265605,1000,1000,1000,3000,2000,1001,1.0,0.0
26042,265605,1000,1000,1000,3000,2000,1001,1.0,0.0
26049,265605,1000,1000,1000,3000,2000,1001,1.0,0.0
2605,138124,177,1516,177,1870,354,178,8.565,0.0
26050,269606,1000,1000,1000,3000,2000,1001,1.0,0.0
26055,265605,1000,1000,1000,3000,2000,1001,1.0,0.0
26057,265605,1000,1000,1000,3000,2000,1001,1.0,0.0
26059,8085,8,104,8,120,16,9,13.0,0.0
2606,228325,500,3500,500,4500,1000,501,7.0,0.0
26071,249589,1000,1000,1000,3000,2000,1001,1.0,0.0
26075,249589,1000,1000,1000,3000,2000,1001,1.0,0.0
2608,18009,0,245,0,280,35,36,7.0,0.0
26088,249589,1000,1000,1000,3000,2000,1001,1.0,0.0
2609,631801,409,15057,409,15875,818,410,36.814,0.0
2610,43938,137,274,137,548,274,138,2.0,0.0
26101,28726,113,113,113,339,226,114,1.0,0.0
26104,596388,1000,8996,1000,10996,2000,1001,8.996,0.0
2611,590755,500,6618,500,7618,1000,501,13.236,0.0
2612,6810,13,65,13,91,26,14,5.0,0.0
2613,411773,500,4990,500,5990,1000,501,9.98,0.0
26136,64084,255,255,255,765,510,256,1.0,0.0
26137,253590,1000,1000,1000,3000,2000,1001,1.0,0.0
26139,29653,0,396,0,440,44,45,9.0,0.6666666666666666
2614,1322100,0,12000,0,13000,1000,508,24.0,0.5
26144,249589,1000,1000,1000,3000,2000,1001,1.0,0.0
2615,34602,106,310,106,522,212,107,2.925,0.0
26150,1459671,1000,8959,1000,10959,2000,1001,8.959,0.0
26152,26435,41,321,41,403,82,42,7.829,0.0
26153,2083,6,6,6,18,12,7,1.0,0.0
26155,32045,91,271,91,453,182,92,2.978,0.0
26159,142620,0,1200,0,1440,240,241,5.0,0.0
26163,26236,103,103,103,309,206,104,1.0,0.0
26164,10300,39,39,39,117,78,40,1.0,0.0
26165,45160,179,179,179,537,358,180,1.0,0.0
26169,137119,222,1105,222,1549,444,223,4.977,0.0
2617,573150,500,8500,500,9500,1000,501,17.0,0.0
26170,457816,0,5662,0,6229,567,568,9.986,0.0
26172,380577,644,4508,644,5796,1288,645,7.0,1.0
26177,249589,1000,1000,1000,3000,2000,1001,1.0,0.0
2618,7476,5,65,5,75,10,6,13.0,0.0
26184,249589,1000,1000,1000,3000,2000,1001,1.0,0.0
26189,70309,280,280,280,840,560,281,1.0,0.0
2619,968,0,3,0,4,1,2,3.0,0.0
26199,3331,10,20,10,40,20,11,2.0,0.0
2620,5778,10,50,10,79,29,20,5.0,0.0
2621,11771,12,120,12,144,24,13,10.0,0.5
26213,5264,13,51,13,77,26,14,3.923,0.0
2622,60463,62,868,62,992,124,63,14.0,0.0
26224,3120,8,24,8,40,16,9,3.0,0.0
26226,884078,1000,16000,1000,18000,2000,1001,16.0,0.5
26227,249586,1000,1000,1000,3000,2000,1001,1.0,0.0
26228,928395,0,18000,0,19000,1000,1001,18.0,0.0
2623,1267777,500,18126,500,19126,1000,501,36.252,0.0
26230,550313,0,11000,0,12000,1000,1001,11.0,0.0
26231,552268,1000,11000,1000,13000,2000,1001,11.0,0.0
26233,245585,1000,1000,1000,3000,2000,1001,1.0,0.0
26234,2827169,0,47088,0,48088,1000,1001,47.088,0.0
26235,1039095,364,15024,364,15752,728,365,41.275,0.0
26236,331585,1000,3000,1000,5000,2000,1001,3.0,0.0
26237,456715,0,6081,0,7081,1000,1001,6.081,0.0
2624,1180519,500,21896,500,22896,1000,501,43.792,0.0
26244,245585,1000,1000,1000,3000,2000,1001,1.0,0.0
26246,27939,0,336,0,392,56,57,6.0,0.0
2625,1096536,0,26716,0,27216,500,501,53.432,0.0
26251,129488,0,1100,0,1320,220,221,5.0,0.0
26252,245585,1000,1000,1000,3000,2000,1001,1.0,0.0
26254,738411,1000,20000,1000,22000,2000,1001,20.0,0.0
26255,3694,9,35,9,53,18,10,3.889,0.0
26256,610656,0,9702,0,10293,591,592,16.416,0.0
26259,743829,1000,20000,1000,22000,2000,1001,20.0,0.0
2626,1493198,0,20072,0,20572,500,501,40.144,0.5
26260,554937,1000,11000,1000,13000,2000,1001,11.0,0.0
26261,3536,8,32,8,48,16,9,4.0,0.0
26262,15582,43,169,43,255,86,44,3.93,0.0
26266,3283,10,20,10,40,20,11,2.0,0.0
26268,747435,1000,20000,1000,22000,2000,1001,20.0,0.0
2627,275870,500,4087,500,5087,1000,501,8.174,0.0
26271,20447,0,270,0,300,30,31,9.0,0.0
26274,954005,1000,18000,1000,20000,2000,1001,18.0,0.5
26276,249586,1000,1000,1000,3000,2000,1001,1.0,0.0
26277,249586,1000,1000,1000,3000,2000,1001,1.0,0.0
26278,245585,1000,1000,1000,3000,2000,1001,1.0,0.0
26279,245585,1000,1000,1000,3000,2000,1001,1.0,0.0
2628,4189,6,30,6,42,12,7,5.0,0.0
26280,249586,1000,1000,1000,3000,2000,1001,1.0,0.0
26281,249586,1000,1000,1000,3000,2000,1001,1.0,0.0
26283,245585,1000,1000,1000,3000,2000,1001,1.0,0.0
26284,245585,1000,1000,1000,3000,2000,1001,1.0,0.0
26286,741060,1000,20000,1000,22000,2000,1001,20.0,0.0
2629,735092,500,10684,500,11684,1000,501,21.368,0.0
26291,25209,50,300,50,400,100,51,6.0,0.0
2630,527492,500,8806,500,9806,1000,501,17.612,0.0
2631,278679,500,3000,500,4000,1000,501,6.0,0.0
26314,119601,498,498,498,1494,996,499,1.0,0.0
26317,862250,1000,14000,1000,16000,2000,1001,14.0,0.0
2632,51668,39,1014,39,1092,78,40,26.0,0.0
26325,817981,853,13581,853,15287,1706,854,15.921,0.0
2633,389386,500,5902,500,6926,1024,513,11.804,0.5
26339,529296,1000,6351,1000,8351,2000,1001,6.351,0.0
2634,25697,72,274,72,418,144,73,3.806,0.0
26343,1289020,1000,21994,1000,23994,2000,1001,21.994,0.0
26344,24629,66,198,66,330,132,67,3.0,0.0
26348,435637,592,8288,592,9472,1184,593,14.0,0.0
2635,6227,9,65,9,90,25,17,7.222,0.0
26360,1068849,2000,19771,2000,23771,4000,2002,9.886,0.0
26369,1445472,2000,22982,2000,27982,5000,3002,7.661,0.0
26373,540772,1000,4988,1000,7968,2980,1242,4.988,0.0
2638,1178271,500,21894,500,22894,1000,501,43.788,0.0
26380,434453,0,8288,0,8880,592,593,14.0,0.0
26389,67475,116,1160,116,1392,232,117,10.0,0.0
2640,185086,350,2800,350,3500,700,351,8.0,0.0
26409,1662557,1438,30227,1438,33103,2876,1440,21.02,0.0
26417,15254104,820,156620,820,158260,1640,821,191.0,0.0
2642,775335,500,11973,500,12973,1000,501,23.946,0.0
26426,126233,27,1798,27,1852,54,28,66.593,0.0
26429,15227065,0,67149,0,67738,589,590,114.005,0.0
2643,191164,281,3653,281,4215,562,282,13.0,0.0
26438,5840995,0,132000,0,133000,1000,1001,132.0,0.0
26440,65438,103,778,103,984,206,104,7.553,0.0
26443,237579,0,1000,0,2000,1000,1001,1.0,0.0
26444,1211777,579,19185,579,20343,1158,580,33.135,0.0
26448,239579,1000,1000,1000,3000,2000,1001,1.0,0.0
2645,1211,1,8,1,11,3,3,8.0,0.0
2646,70537,196,588,196,980,392,197,3.0,0.0
2647,890809,0,20765,0,21265,500,501,41.53,0.0
2648,2824,4,20,4,28,8,5,5.0,0.8333333333333334
26484,851604,1000,12000,1000,14000,2000,1001,12.0,0.0
26487,7545032,579,79902,579,81060,1158,580,138.0,0.0
26501,1761394,1000,31716,1000,33716,2000,1001,31.716,0.0
26505,2448599,0,28056,0,28557,501,502,56.0,0.0
26509,62596,87,744,87,1004,260,174,8.552,0.5
2651,50273,96,768,96,960,192,97,8.0,0.5
26512,956260,1000,13979,1000,15979,2000,1001,13.979,0.0
26515,637561,1000,7952,1000,9952,2000,1001,7.952,0.5
2652,55887,176,358,176,711,353,178,2.034,0.0
2653,351834,500,9500,500,10500,1000,501,19.0,0.0
2654,777421,500,12407,500,13407,1000,501,24.814,0.0
26555,1211778,0,19185,0,19764,579,580,33.135,0.0
2657,11484,13,77,13,127,50,37,5.923,0.0
2658,1709182,0,50000,0,50500,500,501,100.0,0.0
2659,85827,0,1004,0,1106,102,103,9.843,0.0
2660,1894,3,12,3,18,6,4,4.0,0.0
2661,287178,0,5000,0,5500,500,501,10.0,0.0
2662,1178055,500,21896,500,22896,1000,501,43.792,0.0
2663,199176,223,2918,223,3364,446,224,13.085,0.0
26631,2183726,0,17034,0,17535,501,502,34.0,0.0
2664,88634,0,1002,0,1103,101,102,9.921,0.0
2665,528520,500,8832,500,9832,1000,501,17.664,0.0
2667,454373,468,6552,468,7488,936,469,14.0,0.0
2668,544424,500,7270,500,8270,1000,501,14.54,0.0
2669,381832,500,5000,500,6000,1000,501,10.0,1.0
2671,182095,476,1828,476,2780,952,477,3.84,0.0
2672,9699,0,98,0,121,23,24,4.261,0.0
2673,810974,500,12417,500,13417,1000,501,24.834,0.0
2674,7388,11,99,11,121,22,12,9.0,0.0
2675,535125,346,10347,346,11039,692,347,29.905,0.5
2676,404874,335,5934,335,6604,670,336,17.713,0.0
26788,27936,37,481,37,555,74,38,13.0,0.0
26790,37962,102,408,102,612,204,103,4.0,0.0
2680,815886,500,12439,500,13439,1000,501,24.878,0.0
26800,551041,572,8577,572,9721,1144,573,14.995,0.0
26819,8852,0,80,0,101,21,22,3.81,0.0
2682,343856,500,5000,500,6000,1000,501,10.0,0.0
26826,296970,302,4520,302,5124,604,303,14.967,0.0
2683,7870,8,104,8,120,16,9,13.0,0.0
26837,10198,10,100,10,120,20,11,10.0,0.0
26838,1180847,1000,21879,1000,23879,2000,1001,21.879,0.5
2684,9853,18,107,18,143,36,19,5.944,0.0
26860,688429,1000,10000,1000,12000,2000,1001,10.0,0.0
2687,115040,0,1392,0,1494,102,103,13.647,0.0
2688,7392,0,66,0,77,11,12,6.0,0.0
26888,4605,6,40,6,52,12,7,6.667,0.0
2691,220277,500,2500,500,3500,1000,501,5.0,0.0
2692,198014,150,1500,150,1800,300,151,10.0,0.0
26922,12737,18,174,18,210,36,19,9.667,0.0
2694,69501,124,496,124,872,376,253,4.0,0.0
26952,162334,249,1669,249,2167,498,250,6.703,0.0
2696,7903,13,80,13,115,35,23,6.154,1.0
26979,10178,0,100,0,110,10,11,10.0,0.0
26986,551041,572,8577,572,9721,1144,573,14.995,0.0
2699,281204,500,2000,500,3501,1501,1002,4.0,0.0
26997,135151,224,1946,224,2394,448,225,8.688,0.0
2700,137882,146,1020,146,1312,292,147,6.986,0.0
27008,290461,424,4780,424,5628,848,426,11.274,0.0
27014,7333,10,58,10,78,20,11,5.8,0.0
2703,450058,351,2310,351,3054,744,394,6.581,0.5
27033,3541,9,27,9,45,18,10,3.0,0.0
27062,6193,12,52,12,76,24,13,4.333,0.0
27076,4832,0,35,0,40,5,6,7.0,0.0
2708,12951,11,68,11,92,24,14,6.182,0.75
27082,1170,0,7,0,8,1,2,7.0,0.0
27087,12458,17,136,17,187,51,36,4.0,1.0
27088,3518,6,36,6,48,12,7,6.0,0.0
27089,4339,10,50,10,70,20,11,5.0,0.0
27097,846782,1000,14000,1000,16000,2000,1001,14.0,0.0
2710,15328,23,161,23,207,46,24,7.0,0.0
27108,2884,6,30,6,42,12,7,5.0,0.6666666666666666
2712,6655,13,52,13,78,26,14,4.0,0.0
27125,2641,5,20,5,30,10,6,4.0,0.0
2714,574769,0,11390,0,11890,500,501,22.78,0.0
27159,5419,11,66,11,88,22,12,6.0,0.0
2718,25386,37,74,37,148,74,38,2.0,0.5
2720,423072,0,6376,0,6876,500,501,12.752,0.0
27225,31799,42,378,42,462,84,43,9.0,0.0
27249,2542,5,25,5,35,10,6,5.0,0.0
2725,303053,454,4570,454,5478,908,455,10.066,0.0
27279,239579,1000,1000,1000,3000,2000,1001,1.0,0.0
2729,930,1,3,1,5,2,2,3.0,0.0
27291,15014,30,105,30,165,60,31,3.5,0.0
2730,1866,2,14,2,18,4,3,7.0,0.0
2731,130941,211,2045,211,2467,422,212,9.692,0.0
2733,393692,500,5790,500,6790,1000,501,11.58,0.0
2734,11309,17,109,17,158,49,33,6.412,1.0
27341,406621,271,5683,271,6225,542,272,20.97,0.75
27353,32863,66,396,66,528,132,67,6.0,0.0
27355,3421,6,30,6,42,12,7,5.0,0.0
2738,17593,48,158,48,254,96,49,3.292,0.0
27385,16652,0,308,0,330,22,23,14.0,0.0
27395,16336,8,295,8,311,16,9,36.875,0.0
27409,1119460,1000,19000,1000,21000,2000,1001,19.0,0.0
27414,1858,3,12,3,18,6,4,4.0,0.0
2742,215204,333,3186,333,3852,666,334,9.568,0.0
27421,99683,58,3072,58,3188,116,59,52.966,0.0
2743,10082,9,58,9,79,21,13,6.444,0.5
27438,20246,0,260,0,270,10,11,26.0,0.0
27445,201025,64,3390,64,3518,128,65,52.969,0.0
2745,434461,500,6393,500,7393,1000,501,12.786,0.0
27453,129700,58,4348,58,4464,116,59,74.966,0.0
27463,29759,67,402,67,536,134,68,6.0,0.0
27473,2532,0,25,0,30,5,6,5.0,0.0
27483,16652,0,308,0,330,22,23,14.0,0.0
27486,434453,0,8288,0,8880,592,593,14.0,0.0
27487,1096865,1000,18000,1000,20000,2000,1001,18.0,0.0
27493,2938,7,21,7,35,14,8,3.0,0.0
27494,1094912,1000,18000,1000,20000,2000,1001,18.0,0.0
27495,2452,5,15,5,25,10,6,3.0,0.0
27500,21163,0,270,0,280,10,11,27.0,0.0
27540,1587,2,10,2,14,4,3,5.0,0.0
27556,13329,33,165,33,231,66,34,5.0,0.0
27564,243580,1000,1000,1000,3000,2000,1001,1.0,0.0
27579,5775,12,54,12,78,24,13,4.5,0.0
27583,858826,1000,13986,1000,15986,2000,1001,13.986,0.0
27592,2851,6,24,6,36,12,7,4.0,0.5
27600,2356,5,15,5,25,10,6,3.0,0.0
2761,14417,18,116,18,167,51,34,6.444,0.0
2764,94146,35,1094,35,1164,70,36,31.257,0.0
27659,388598,0,6061,0,6612,551,552,11.0,0.0
2766,49461,40,604,40,684,80,41,15.1,0.0
27660,5417741,574,80934,574,82082,1148,575,141.0,0.0
2767,287873,500,2001,500,3501,1500,999,4.002,0.0
27671,239579,1000,1000,1000,3000,2000,1001,1.0,0.0
2768,4251,5,35,5,49,14,10,7.0,0.0
27702,237579,0,1000,0,2000,1000,1001,1.0,0.0
27708,239579,1000,1000,1000,3000,2000,1001,1.0,0.0
27729,1100679,1000,18000,1000,20000,2000,1001,18.0,0.0
2774,140936,0,1554,0,1591,37,38,42.0,0.0
27746,239579,1000,1000,1000,3000,2000,1001,1.0,0.0
27751,239579,1000,1000,1000,3000,2000,1001,1.0,0.0
27756,239579,1000,1000,1000,3000,2000,1001,1.0,0.0
27761,239579,1000,1000,1000,3000,2000,1001,1.0,0.0
27762,239579,1000,1000,1000,3000,2000,1001,1.0,0.0
27766,243580,1000,1000,1000,3000,2000,1001,1.0,0.0
27767,239579,1000,1000,1000,3000,2000,1001,1.0,0.0
27769,239579,1000,1000,1000,3000,2000,1001,1.0,0.0
27772,239579,1000,1000,1000,3000,2000,1001,1.0,0.0
27776,239579,1000,1000,1000,3000,2000,1001,1.0,0.0
27777,239579,1000,1000,1000,3000,2000,1001,1.0,0.0
27779,239579,1000,1000,1000,3000,2000,1001,1.0,0.0
27780,239579,1000,1000,1000,3000,2000,1001,1.0,0.0
27781,239579,1000,1000,1000,3000,2000,1001,1.0,0.0
27783,243580,1000,1000,1000,3000,2000,1001,1.0,0.0
27784,15351,5,155,5,165,10,6,31.0,0.0
27785,6800,5,50,5,60,10,6,10.0,0.0
27786,10375,5,45,5,55,10,6,9.0,0.0
27787,4014,5,25,5,35,10,6,5.0,0.0
27789,15000,5,99,5,109,10,6,19.8,0.0
2779,9997,16,76,16,108,32,17,4.75,0.0
27790,10525,5,43,5,53,10,6,8.6,0.0
27793,7882,5,75,5,85,10,6,15.0,0.0
27794,8004,5,45,5,55,10,6,9.0,0.0
27795,5997,5,50,5,60,10,6,10.0,0.0
27796,10546,5,43,5,53,10,6,8.6,0.0
27797,6531,5,50,5,60,10,6,10.0,0.0
27798,8670,5,70,5,80,10,6,14.0,0.0
27799,4643,5,35,5,45,10,6,7.0,0.0
27800,10525,5,43,5,53,10,6,8.6,0.0
27801,6403,5,50,5,60,10,6,10.0,0.0
27802,10546,5,43,5,53,10,6,8.6,0.0
27803,11505,5,79,5,89,10,6,15.8,0.0
27804,13855,5,110,5,120,10,6,22.0,0.0
27805,5383,5,40,5,50,10,6,8.0,0.0
27807,10525,5,43,5,53,10,6,8.6,0.0
2781,235892,500,2906,500,3906,1000,501,5.812,0.0
27810,6843,5,65,5,75,10,6,13.0,0.0
27812,4014,5,25,5,35,10,6,5.0,0.0
27813,5103,5,39,5,49,10,6,7.8,0.0
27814,8371,5,65,5,75,10,6,13.0,0.0
27815,7380,5,55,5,65,10,6,11.0,0.0
27816,7406,5,50,5,60,10,6,10.0,0.0
27817,10832,5,75,5,85,10,6,15.0,0.0
27819,8333,5,65,5,75,10,6,13.0,0.0
2782,225562,500,2617,500,3617,1000,501,5.234,0.0
27820,9007,5,75,5,85,10,6,15.0,0.0
27823,4207,5,35,5,45,10,6,7.0,0.0
27824,4014,5,25,5,35,10,6,5.0,0.0
27825,8371,5,65,5,75,10,6,13.0,0.0
27828,6783,5,45,5,55,10,6,9.0,0.0
2783,563288,0,7409,0,7909,500,501,14.818,0.0
27830,10624,5,78,5,88,10,6,15.6,0.0
2784,488081,500,11500,500,12500,1000,501,23.0,0.0
27841,8004,5,45,5,55,10,6,9.0,0.0
27843,4014,5,25,5,35,10,6,5.0,0.0
27844,8025,5,45,5,55,10,6,9.0,0.0
27845,8379,5,65,5,75,10,6,13.0,0.0
27847,7292,5,35,5,45,10,6,7.0,0.0
27848,7292,5,35,5,45,10,6,7.0,0.0
2785,2214,4,16,4,24,8,5,4.0,0.0
27851,5080,5,45,5,55,10,6,9.0,0.0
27856,5594,5,45,5,55,10,6,9.0,0.0
2786,19556,0,308,0,319,11,12,28.0,0.0
27874,9642,5,70,5,80,10,6,14.0,0.0
27877,4188,5,33,5,43,10,6,6.6,0.0
27879,7767,5,65,5,75,10,6,13.0,0.0
2788,1135997,500,16380,500,17380,1000,501,32.76,1.0
27880,5869,5,45,5,55,10,6,9.0,0.0
27881,10832,5,75,5,85,10,6,15.0,0.0
27884,10525,5,43,5,53,10,6,8.6,0.0
27885,9927,5,60,5,70,10,6,12.0,0.0
27887,8083,5,80,5,90,10,6,16.0,0.0
27888,5208,5,45,5,55,10,6,9.0,0.0
27889,6833,5,50,5,60,10,6,10.0,0.0
2789,20209,0,163,0,178,15,16,10.867,0.0
27891,8768,0,85,0,90,5,6,17.0,0.0
27892,4009,5,27,5,37,10,6,5.4,0.0
27893,14231,5,110,5,120,10,6,22.0,0.0
27894,6917,6,63,6,75,12,7,10.5,0.0
27895,5428,5,40,5,50,10,6,8.0,0.0
27896,9341,5,65,5,75,10,6,13.0,0.0
27897,6815,5,55,5,65,10,6,11.0,0.0
27898,9005,5,75,5,85,10,6,15.0,0.0
27899,8979,5,65,5,75,10,6,13.0,0.0
27900,5698,5,45,5,55,10,6,9.0,0.0
27901,5251,5,39,5,49,10,6,7.8,0.0
27903,4145,8,40,8,56,16,9,5.0,0.0
2791,16741,0,236,0,267,31,32,7.613,0.0
27911,20478,50,150,50,250,100,51,3.0,0.0
27912,5639,5,45,5,55,10,6,9.0,0.0
27914,6894,0,55,0,60,5,6,11.0,1.0
27915,12017,5,87,5,97,10,6,17.4,0.0
2792,230653,500,2761,500,3761,1000,501,5.522,0.0
27924,9341,5,65,5,75,10,6,13.0,0.0
27927,8852,5,80,5,90,10,6,16.0,0.0
27929,7324,5,60,5,70,10,6,12.0,0.0
2793,35019,0,400,0,427,27,28,14.815,0.0
27939,9083,5,80,5,90,10,6,16.0,0.0
2794,367352,500,4999,500,5999,1000,501,9.998,0.0
27945,8545,0,70,0,75,5,6,14.0,0.0
27946,7292,5,35,5,45,10,6,7.0,0.0
2795,13576,0,302,0,318,16,17,18.875,0.0
27950,7485,5,55,5,65,10,6,11.0,0.0
27954,2083,5,5,5,15,10,6,1.0,0.0
27955,5375,5,50,5,60,10,6,10.0,0.0
27956,4461,5,35,5,45,10,6,7.0,0.0
27957,3634,9,18,9,36,18,10,2.0,0.0
27958,7746,5,65,5,75,10,6,13.0,0.0
27959,5327,5,25,5,35,10,6,5.0,0.0
2796,38516,0,605,0,643,38,39,15.921,0.0
27960,7380,5,55,5,65,10,6,11.0,0.0
27962,19870,50,150,50,250,100,51,3.0,0.0
27963,365627,1000,3000,1000,5000,2000,1001,3.0,0.0
27964,2892,5,20,5,30,10,6,4.0,0.0
2797,1478618,0,18607,0,19607,1000,718,37.214,0.0
2798,53678,55,601,55,711,110,56,10.927,0.0
27981,15351,5,155,5,165,10,6,31.0,0.0
27984,5082,5,39,5,49,10,6,7.8,0.0
27986,7227,5,50,5,60,10,6,10.0,0.0
27987,4207,5,35,5,45,10,6,7.0,0.0
27988,10525,5,43,5,53,10,6,8.6,0.0
27989,1989,3,12,3,18,6,4,4.0,0.0
2799,34017,21,588,21,630,42,22,28.0,0.0
27990,6552,5,57,5,67,10,6,11.4,0.0
27991,6996,5,50,5,60,10,6,10.0,0.0
27992,1070,1,4,1,6,2,2,4.0,0.0
27993,10525,5,43,5,53,10,6,8.6,0.0
27994,7042,5,60,5,70,10,6,12.0,0.0
27995,401627,1000,3000,1000,5000,2000,1001,3.0,0.0
27996,8379,5,65,5,75,10,6,13.0,0.0
27997,9159,5,48,5,58,10,6,9.6,0.0
27998,9017,5,81,5,91,10,6,16.2,0.0
27999,20827,50,150,50,250,100,51,3.0,0.0
2800,550086,500,8888,500,9888,1000,501,17.776,0.0
28000,403589,1000,3000,1000,5000,2000,1001,3.0,0.0
28001,7307,5,53,5,63,10,6,10.6,0.0
28002,5254,5,55,5,65,10,6,11.0,0.0
28004,19977,50,150,50,250,100,51,3.0,0.0
28009,8354,5,65,5,75,10,6,13.0,0.0
2801,120262,0,1276,0,1334,58,59,22.0,0.0
28012,20476,50,150,50,250,100,51,3.0,0.0
2802,3961,6,54,6,66,12,7,9.0,0.0
28021,20562,50,150,50,250,100,51,3.0,0.0
2803,227619,500,3500,500,4500,1000,501,7.0,0.0
28037,9608,5,65,5,75,10,6,13.0,0.0
2804,5686,0,131,0,138,7,8,18.714,0.0
28046,10375,5,45,5,55,10,6,9.0,0.0
2805,51953,66,856,66,988,132,67,12.97,0.0
2806,3550,7,28,7,42,14,8,4.0,0.5
2807,486110,0,11500,0,12000,500,501,23.0,0.0
28070,12413,0,105,0,110,5,6,21.0,0.0
28072,9159,5,48,5,58,10,6,9.6,0.0
28073,7419,5,60,5,70,10,6,12.0,0.0
28074,6307,0,45,0,50,5,6,9.0,0.0
2808,125134,126,1008,126,1260,252,127,8.0,0.5
28081,6321,5,45,5,55,10,6,9.0,0.0
28082,5404,5,40,5,50,10,6,8.0,0.0
28083,5785,5,45,5,55,10,6,9.0,0.0
28084,5428,5,40,5,50,10,6,8.0,0.0
28085,403581,1000,3000,1000,5000,2000,1001,3.0,0.0
28086,404177,1000,3000,1000,5000,2000,1001,3.0,0.0
28087,167845,414,1242,414,2070,828,415,3.0,0.0
28088,9005,5,75,5,85,10,6,15.0,0.0
28089,287627,1000,1000,1000,3000,2000,1001,1.0,0.0
2809,243586,500,2895,500,3895,1000,501,5.79,0.0
28090,5873,5,50,5,60,10,6,10.0,0.0
28091,5750,5,50,5,60,10,6,10.0,0.0
28092,5658,0,45,0,50,5,6,9.0,0.0
28093,5336,0,42,0,47,5,6,8.4,0.0
28094,1077,1,4,1,6,2,2,4.0,0.0
28095,8819,5,70,5,80,10,6,14.0,0.0
28096,5869,5,45,5,55,10,6,9.0,0.0
28097,7084,5,70,5,80,10,6,14.0,0.0
28099,6011,0,45,0,50,5,6,9.0,0.0
2810,18009,11,308,11,330,22,12,28.0,0.0
28100,11382,5,78,5,88,10,6,15.6,0.0
28101,5608,5,51,5,61,10,6,10.2,0.0
28102,9993,5,65,5,75,10,6,13.0,0.0
28105,4902,5,40,5,50,10,6,8.0,0.0
28106,9927,5,60,5,70,10,6,12.0,0.0
2811,2187,1,28,1,30,2,2,28.0,0.0
2812,12378,8,240,8,256,16,9,30.0,0.5
28122,7918,5,65,5,75,10,6,13.0,0.0
28131,5834,5,50,5,60,10,6,10.0,0.0
28134,6791,5,40,5,50,10,6,8.0,0.0
2814,2214,4,16,4,24,8,5,4.0,0.0
28141,7647,5,50,5,60,10,6,10.0,0.0
2815,15965,0,130,0,140,10,11,13.0,0.5
28154,11046,0,80,0,85,5,6,16.0,0.0
2816,11419,0,170,0,182,12,13,14.167,1.0
28162,6355,5,45,5,55,10,6,9.0,0.0
28167,5568,5,45,5,55,10,6,9.0,0.0
28168,2062,5,5,5,15,10,6,1.0,0.0
28169,6629,5,65,5,75,10,6,13.0,0.0
2817,2214,4,16,4,24,8,5,4.0,0.0
28170,8592,5,70,5,80,10,6,14.0,0.0
28171,6815,5,55,5,65,10,6,11.0,0.0
28176,18049,0,130,0,135,5,6,26.0,0.0
28177,2062,5,5,5,15,10,6,1.0,0.0
28178,287627,1000,1000,1000,3000,2000,1001,1.0,0.0
2818,421804,0,6000,0,6500,500,501,12.0,0.0
28181,2083,5,5,5,15,10,6,1.0,0.0
2819,23937,0,375,0,400,25,26,15.0,0.0
28191,2062,5,5,5,15,10,6,1.0,0.0
28197,6151,0,60,0,65,5,6,12.0,0.0
28199,13308,0,85,0,90,5,6,17.0,0.0
28207,2062,5,5,5,15,10,6,1.0,0.0
2821,22715,0,350,0,375,25,26,14.0,0.0
28212,2062,5,5,5,15,10,6,1.0,0.0
28213,3497,10,10,10,30,20,11,1.0,0.0
28215,2062,5,5,5,15,10,6,1.0,0.0
28216,2083,5,5,5,15,10,6,1.0,0.0
2822,2147,4,15,4,23,8,5,3.75,0.0
2823,2214,4,16,4,24,8,5,4.0,0.0
28239,17757,0,120,0,125,5,6,24.0,0.0
2824,38900,0,342,0,456,114,115,3.0,0.0
28240,2062,5,5,5,15,10,6,1.0,0.0
28247,2062,5,5,5,15,10,6,1.0,0.0
28248,2062,5,5,5,15,10,6,1.0,0.0
2825,27731,28,240,28,296,56,29,8.571,1.0
28251,2062,5,5,5,15,10,6,1.0,0.0
28255,2062,5,5,5,15,10,6,1.0,0.0
28256,2083,5,5,5,15,10,6,1.0,0.0
28258,2062,5,5,5,15,10,6,1.0,0.0
2826,6898,11,55,11,77,22,12,5.0,1.0
28260,5890,5,65,5,75,10,6,13.0,0.0
28261,9993,0,65,0,70,5,6,13.0,0.0
28262,9000,5,65,5,75,10,6,13.0,0.0
28263,291628,1000,1000,1000,3000,2000,1001,1.0,0.0
28265,2062,5,5,5,15,10,6,1.0,0.0
28267,2083,5,5,5,15,10,6,1.0,0.0
28269,2062,5,5,5,15,10,6,1.0,0.0
2827,498332,0,8639,0,9139,500,501,17.278,0.5
28270,2062,5,5,5,15,10,6,1.0,0.0
28273,2083,5,5,5,15,10,6,1.0,0.0
28276,2062,5,5,5,15,10,6,1.0,0.0
2828,19051,0,332,0,344,12,13,27.667,0.0
28283,2062,5,5,5,15,10,6,1.0,0.0
28289,16801,5,110,5,120,10,6,22.0,0.0
2829,11916,0,136,0,153,17,18,8.0,0.0
28297,4104,9,27,9,45,18,10,3.0,0.5
2830,122974,250,1500,250,2000,500,251,6.0,0.0
28303,267607,1000,1000,1000,3000,2000,1001,1.0,0.0
28318,80879,222,666,222,1110,444,223,3.0,0.0
28319,45085,127,381,127,635,254,128,3.0,0.0
28320,133898,360,1080,360,1800,720,361,3.0,0.0
28321,5275,13,39,13,65,26,14,3.0,0.0
28326,5171,0,39,0,52,13,14,3.0,0.0
2833,231074,500,2766,500,3766,1000,501,5.532,0.0
28331,5222,13,39,13,65,26,14,3.0,0.0
28332,45085,127,381,127,635,254,128,3.0,0.0
28339,5222,13,39,13,65,26,14,3.0,0.0
2834,25763,0,275,0,300,25,26,11.0,0.0
28340,8657,19,76,19,114,38,20,4.0,0.0
28344,56064,0,474,0,632,158,159,3.0,0.0
28345,3709,7,35,7,49,14,8,5.0,0.0
28349,1593,1,5,1,8,3,3,5.0,0.0
2835,21613,0,224,0,270,46,47,4.87,0.0
28350,1304,2,6,2,10,4,3,3.0,0.0
28352,2652,6,18,6,30,12,7,3.0,0.0
2836,234077,500,2938,500,3938,1000,501,5.876,1.0
28364,2917,7,21,7,35,14,8,3.0,0.0
28365,6783,15,60,15,90,30,16,4.0,0.0
28366,4370,6,40,6,52,12,7,6.667,0.0
28369,8375,17,85,17,119,34,18,5.0,0.0
28371,6647,14,56,14,84,28,15,4.0,0.0
2838,62388,55,600,55,710,110,56,10.909,0.0
2839,241861,500,2880,500,3880,1000,501,5.76,0.0
2840,233927,500,2667,500,3667,1000,501,5.334,0.0
2841,472896,0,7225,0,7725,500,501,14.45,0.0
2842,20088,25,202,25,252,50,26,8.08,0.0
2844,66524,0,1176,0,1188,12,13,98.0,0.0
2845,19467,0,394,0,426,32,33,12.312,0.0
2846,30199,55,319,55,429,110,56,5.8,0.0
2847,22373,0,350,0,375,25,26,14.0,0.0
2848,20142,27,268,27,322,54,28,9.926,0.0
2849,13568,7,84,7,105,21,15,12.0,1.0
2850,17548,0,250,0,275,25,26,10.0,0.0
2851,26721,0,448,0,464,16,17,28.0,0.0
28516,1268620,2000,27188,2000,31188,4000,2002,13.594,0.6666666666666666
28518,614756,1999,5985,1999,9983,3998,2001,2.994,0.0
28519,251591,1000,1000,1000,3000,2000,1001,1.0,1.0
2852,218194,458,2686,458,3602,916,459,5.865,0.5
28520,576852,1000,10293,1000,12293,2000,1001,10.293,0.0
28523,137590,119,1793,119,2031,238,120,15.067,1.0
28526,1124077,2000,23462,2000,27462,4000,2002,11.731,0.5
28527,1068787,2000,21501,2000,25501,4000,2002,10.751,0.5
28529,2272,5,15,5,25,10,6,3.0,0.0
2853,1107855,500,11140,500,12140,1000,501,22.28,0.0
28531,251591,1000,1000,1000,3000,2000,1001,1.0,0.0
28532,251591,1000,1000,1000,3000,2000,1001,1.0,0.0
28533,3475,6,59,6,71,12,8,9.833,0.0
28537,184340,95,2280,95,2470,190,96,24.0,0.0
2854,33450,21,588,21,630,42,22,28.0,0.0
28543,789686,1000,12135,1000,14135,2000,1001,12.135,0.5
28544,148562,171,1854,171,2448,594,425,4.383,0.0
28551,1118791,2000,23245,2000,27245,4000,2002,11.623,0.0
28552,710128,1000,10000,1000,12000,2000,1001,10.0,0.0
28553,759785,2000,8999,2000,12999,4000,2002,4.5,0.0
28554,784562,2000,10992,2000,14992,4000,2002,5.496,0.0
28558,640410,0,8945,0,9945,1000,1001,8.945,0.0
2856,1517206,0,18888,0,19888,1000,533,37.776,0.0
28560,251591,1000,1000,1000,3000,2000,1001,1.0,0.0
28562,251591,1000,1000,1000,3000,2000,1001,1.0,0.0
28565,645415,1000,9988,1000,11988,2000,1001,9.988,0.0
2857,67059,24,1008,24,1056,48,25,42.0,0.5
28570,73314,200,900,200,1300,400,202,4.5,0.0
28571,7047,0,56,0,64,8,9,7.0,0.0
28572,710583,1000,8000,1000,10000,2000,1001,8.0,0.0
2858,15791,0,223,0,250,27,28,8.259,0.0
28582,187200,366,3093,366,3825,732,367,8.451,0.0
28584,189106,366,3109,366,3841,732,367,8.495,0.0
28585,6207,12,70,12,100,30,20,3.889,0.0
28587,6162,0,56,0,64,8,9,7.0,0.0
2859,26546,28,292,28,348,56,29,10.429,0.0
28590,139816,273,2286,273,2832,546,274,8.374,0.0
28592,696817,1000,8992,1000,11992,3000,2002,4.496,0.0
28596,80607,104,1040,104,1248,208,105,10.0,0.0
28598,235951,0,2588,0,3235,647,648,4.0,0.0
28599,4722,4,68,4,76,8,5,17.0,0.0
28603,125465,132,1317,132,1713,396,266,4.989,0.5
2861,1527716,500,19357,500,20357,1000,501,38.714,1.0
28611,6190,8,56,8,72,16,9,7.0,0.0
28614,255592,1000,1000,1000,3000,2000,1001,1.0,0.0
28616,148213,273,2525,273,3071,546,274,9.249,0.0
28617,6637,7,74,7,97,23,18,4.625,0.5
28619,150520,276,2570,276,3122,552,277,9.312,0.0
2862,234150,500,2793,500,3793,1000,501,5.586,0.0
28620,223437,0,1931,0,2419,488,489,3.957,0.0
28626,1041901,1000,17000,1000,19000,2000,1001,17.0,0.0
28627,5695,9,54,9,81,27,20,3.0,0.0
28628,984970,1000,15000,1000,17000,2000,1001,15.0,0.0
28633,39448,0,345,0,460,115,116,3.0,0.0
28634,497809,563,6953,563,8642,1689,1128,6.175,0.0
28635,53863,68,688,68,824,136,69,10.118,0.5
28638,327232,0,3616,0,4520,904,905,4.0,0.0
2864,18538,0,308,0,319,11,12,28.0,0.0
28643,325423,0,3616,0,4520,904,905,4.0,0.0
28645,8110,0,129,0,134,5,6,25.8,0.0
28647,1302926,1000,20287,1000,22287,2000,1001,20.287,0.5
28648,148963,273,2542,273,3088,546,274,9.311,0.0
2865,6660,0,48,0,58,10,11,4.8,0.0
28651,590527,0,7985,0,8985,1000,1001,7.985,0.0
28656,375342,0,3148,0,3935,787,788,4.0,0.0
28657,147086,270,2510,270,3050,540,271,9.296,0.0
2866,1197352,0,12817,0,12916,99,100,129.465,0.0
28662,598910,0,9000,0,10000,1000,1001,9.0,0.0
28666,10697,0,98,0,112,14,15,7.0,0.0
28667,377989,0,4000,0,5000,1000,1001,4.0,0.0
2867,8332,12,124,12,148,24,13,10.333,0.5
28670,9060,0,83,0,95,12,13,6.917,0.0
28672,4705,6,48,6,66,18,14,4.0,0.0
28676,758157,1999,8970,1999,12968,3998,2001,4.487,0.0
28677,36236,44,439,44,527,88,45,9.977,0.0
28678,5031,0,42,0,48,6,7,7.0,0.0
2868,57658,0,756,0,840,84,85,9.0,0.5
28680,5517,0,49,0,56,7,8,7.0,0.0
28682,13201,0,208,0,234,26,27,8.0,0.0
28683,1935933,0,26152,0,27152,1000,1001,26.152,0.0
28685,177526,244,2973,244,3461,488,245,12.184,0.0
28686,9533,13,91,13,117,26,14,7.0,0.0
2869,494611,0,8638,0,9138,500,501,17.276,0.5
28690,8422,0,77,0,88,11,12,7.0,0.0
28691,590065,1000,8449,1000,10449,2000,1001,8.449,0.0
28692,182355,0,1542,0,1921,379,380,4.069,0.0
28693,114752,174,1770,174,2118,348,175,10.172,0.0
28694,15562,24,240,24,288,48,25,10.0,0.0
28696,8120,5,129,5,139,10,6,25.8,0.0
28697,413686,846,6768,846,8460,1692,847,8.0,0.0
2870,23683,0,375,0,400,25,26,15.0,0.0
28700,501428,1000,5000,1000,7000,2000,1001,5.0,0.0
28701,141433,216,1944,216,2376,432,217,9.0,1.0
28702,24365,27,430,27,484,54,28,15.926,0.0
28704,496682,563,6953,563,8642,1689,1128,6.175,0.0
2871,26933,0,448,0,464,16,17,28.0,0.0
28711,5536,15,45,15,75,30,16,3.0,0.0
2873,21668,0,364,0,377,13,14,28.0,1.0
28738,985037,1000,15000,1000,17000,2000,1001,15.0,0.0
2874,10998,11,84,11,106,22,12,7.636,1.0
28740,49025,90,720,90,900,180,91,8.0,0.0
28741,149521,273,2525,273,3071,546,274,9.249,0.0
28742,65967,30,900,30,960,60,31,30.0,0.0
28743,9495,0,91,0,104,13,14,7.0,0.0
28745,5714,9,54,9,81,27,20,3.0,0.0
28747,7981,0,77,0,88,11,12,7.0,0.0
28748,543326,1000,7713,1000,9713,2000,1001,7.713,0.0
28749,26230,0,192,0,240,48,49,4.0,0.0
2875,4093,0,50,0,55,5,6,10.0,0.0
28759,24365,27,430,27,484,54,28,15.926,1.0
2876,17342,0,222,0,239,17,18,13.059,0.0
28764,5559,9,72,9,90,18,10,8.0,0.0
28766,38879,37,479,37,553,74,38,12.946,0.0
28768,61521,92,1104,92,1288,184,93,12.0,0.5
2877,3345,0,24,0,30,6,7,4.0,0.0
28770,2983,7,28,7,42,14,8,4.0,0.0
28772,4226,0,39,0,47,8,9,4.875,0.0
2878,259290,410,3727,410,4547,820,411,9.09,0.0
28798,1845096,0,21551,0,22551,1000,1001,21.551,0.0
28799,425276,1000,4000,1000,6000,2000,1001,4.0,0.0
28800,881288,0,10189,0,10619,430,431,23.695,0.0
28801,33835,68,408,68,544,136,69,6.0,0.0
28802,6972,0,90,0,103,13,14,6.923,0.0
28803,743771,416,9545,416,10377,832,417,22.945,0.0
28804,363625,363,3993,363,4719,726,364,11.0,0.5
28805,14501,26,286,26,338,52,27,11.0,0.0
28808,7988,0,104,0,116,12,13,8.667,1.0
28809,9498,0,130,0,143,13,14,10.0,0.0
28811,6168,8,56,8,72,16,9,7.0,0.0
28812,5480,7,49,7,63,14,8,7.0,0.0
28813,9878,37,37,37,111,74,38,1.0,0.0
28815,3250,7,28,7,42,14,8,4.0,0.0
28819,3971,9,36,9,54,18,10,4.0,0.0
28825,964945,1000,8000,1000,10000,2000,1001,8.0,0.0
28826,894838,1000,15868,1000,17868,2000,1001,15.868,0.0
28828,21218,48,192,48,288,96,49,4.0,0.0
28837,4737,12,48,12,72,24,13,4.0,0.0
28838,5338,11,55,11,77,22,12,5.0,0.0
28840,248077,986,986,986,2958,1972,987,1.0,0.0
28841,8281,9,135,9,153,18,10,15.0,0.0
28846,737741,0,12000,0,13000,1000,1001,12.0,0.0
2886,9987,17,34,17,119,85,53,2.0,0.0
28863,591492,1000,10000,1000,12000,2000,1001,10.0,0.0
2887,305352,500,2500,500,4011,1511,1012,5.0,0.0
2888,46559,27,719,27,773,54,28,26.63,0.5
2890,154675,223,2399,223,2845,446,224,10.758,0.0
28902,23934,93,93,93,279,186,94,1.0,0.0
28904,241813,314,2512,314,3140,628,315,8.0,0.0
2891,38272,18,86,18,124,38,21,4.778,1.0
28913,216322,846,846,846,2538,1692,847,1.0,0.0
28917,5616,9,72,9,90,18,10,8.0,0.0
2892,4931,0,28,0,35,7,8,7.0,0.0
28920,5556,7,49,7,63,14,8,7.0,0.0
28922,6033,0,44,0,55,11,12,4.0,0.0
28926,184340,95,2280,95,2470,190,96,24.0,0.0
28927,8676,12,84,12,108,24,13,7.0,0.0
2893,3899,5,33,5,48,15,10,6.6,0.0
28931,5240,9,72,9,90,18,10,8.0,0.0
28932,6615,24,24,24,72,48,25,1.0,0.0
28933,1940853,1000,26177,1000,28177,2000,1001,26.177,0.0
28935,8669,11,88,11,110,22,12,8.0,0.0
28938,1997,4,12,4,20,8,5,3.0,0.0
28939,111533,442,442,442,1326,884,443,1.0,0.0
28940,2850,9,9,9,27,18,10,1.0,0.0
28943,12639,48,48,48,144,96,49,1.0,0.0
28945,255592,1000,1000,1000,3000,2000,1001,1.0,0.0
28951,9310,4,60,4,68,8,5,15.0,0.0
28954,483641,1000,7000,1000,9000,2000,1001,7.0,0.5
28956,251591,1000,1000,1000,3000,2000,1001,1.0,0.0
28957,251591,1000,1000,1000,3000,2000,1001,1.0,0.0
28961,2556,5,15,5,25,10,6,3.0,0.0
28963,4082,7,28,7,42,14,8,4.0,0.0
28965,250500,744,2232,744,3720,1488,745,3.0,0.0
28966,5561,7,49,7,63,14,8,7.0,0.0
28968,3603,12,12,12,36,24,13,1.0,0.0
28969,10294,13,104,13,130,26,14,8.0,0.0
28970,251591,1000,1000,1000,3000,2000,1001,1.0,0.0
28971,251591,1000,1000,1000,3000,2000,1001,1.0,0.0
28973,44962,174,174,174,522,348,175,1.0,0.0
28974,5619,0,72,0,81,9,10,8.0,0.0
28975,2845791,1000,7000,1000,9000,2000,1001,7.0,0.0
28977,62812,244,244,244,732,488,245,1.0,0.0
28979,722980,1000,8963,1000,10963,2000,1001,8.963,0.0
28985,44962,174,174,174,522,348,175,1.0,0.0
28988,1678,2,8,2,12,4,3,4.0,0.0
2899,212786,327,3173,327,3827,654,328,9.703,0.0
2900,232439,500,2000,500,3000,1000,501,4.0,0.0
2901,98472,56,1563,56,1675,112,57,27.911,0.0
29012,217455,864,864,864,2592,1728,865,1.0,0.0
29025,20169,78,78,78,234,156,79,1.0,0.0
2906,17462,32,143,32,207,64,33,4.469,0.0
2907,20058,0,190,0,243,53,54,6.552,0.0
29084,1940,4,12,4,20,8,5,3.0,0.0
29088,3825,9,27,9,45,18,10,3.0,0.0
29089,44962,174,174,174,522,348,175,1.0,0.0
2909,57509,52,354,52,461,107,55,6.808,0.0
29090,251591,1000,1000,1000,3000,2000,1001,1.0,0.0
29096,11239,7,84,7,98,14,8,12.0,0.0
29098,2402,5,25,5,35,10,6,5.0,0.0
29099,44265,174,174,174,522,348,175,1.0,0.0
29106,4806005,204,2444,204,2852,408,205,11.98,0.0
29112,2403,5,15,5,25,10,6,3.0,0.0
29113,209336,314,2198,314,2826,628,315,7.0,0.0
29119,3650,7,28,7,42,14,8,4.0,0.0
29126,3788,7,28,7,42,14,8,4.0,0.0
29129,242144,603,3015,603,4221,1206,604,5.0,0.0
2913,1003,0,6,0,7,1,2,6.0,1.0
29133,251591,1000,1000,1000,3000,2000,1001,1.0,0.0
29135,255592,1000,1000,1000,3000,2000,1001,1.0,0.0
29141,44265,174,174,174,522,348,175,1.0,0.0
29148,1659,3,12,3,18,6,4,4.0,0.0
29151,220775,314,2198,314,2826,628,315,7.0,0.0
29155,589401,1000,9000,1000,11000,2000,1001,9.0,0.0
29157,1846,5,5,5,15,10,6,1.0,0.0
2916,198040,500,2500,500,3500,1000,501,5.0,0.0
29165,251591,1000,1000,1000,3000,2000,1001,1.0,0.0
29166,251591,1000,1000,1000,3000,2000,1001,1.0,0.0
29167,255592,1000,1000,1000,3000,2000,1001,1.0,0.0
2917,571013,500,11172,500,12172,1000,501,22.344,0.0
29176,187595,314,1884,314,2512,628,315,6.0,0.0
29187,111533,442,442,442,1326,884,443,1.0,0.0
29205,2994,6,24,6,36,12,7,4.0,0.0
29207,2836,4,32,4,40,8,5,8.0,0.0
2921,68506,123,492,123,863,371,249,4.0,0.0
29217,1846,5,5,5,15,10,6,1.0,0.0
29220,105007,416,416,416,1248,832,417,1.0,0.0
29227,1846,5,5,5,15,10,6,1.0,0.0
29228,2599,8,8,8,24,16,9,1.0,0.0
29229,91704,363,363,363,1089,726,364,1.0,0.0
29230,3101,10,10,10,30,20,11,1.0,0.0
29231,2361,3,18,3,24,6,4,6.0,0.0
29233,255592,1000,1000,1000,3000,2000,1001,1.0,0.0
29235,9232,13,91,13,117,26,14,7.0,0.0
29236,3101,10,10,10,30,20,11,1.0,0.0
29240,2097,6,6,6,18,12,7,1.0,0.0
29241,8325,18,72,18,108,36,19,4.0,0.0
29242,251591,1000,1000,1000,3000,2000,1001,1.0,0.0
29248,23181,90,90,90,270,180,91,1.0,0.0
2925,191548,219,1446,219,1887,441,223,6.603,0.75
29252,2632,8,8,8,24,16,9,1.0,0.0
29256,2533,4,24,4,32,8,5,6.0,0.0
29261,1867,5,5,5,15,10,6,1.0,0.0
29264,251591,1000,1000,1000,3000,2000,1001,1.0,0.0
29267,3603,12,12,12,36,24,13,1.0,0.0
29268,2348,7,7,7,21,14,8,1.0,0.0
29269,1846,5,5,5,15,10,6,1.0,0.0
29274,251591,1000,1000,1000,3000,2000,1001,1.0,0.0
29275,3504,8,24,8,40,16,9,3.0,0.0
2928,64684,35,755,35,825,70,36,21.571,0.0
29282,251591,1000,1000,1000,3000,2000,1001,1.0,0.0
29289,251591,1000,1000,1000,3000,2000,1001,1.0,0.0
29294,2348,7,7,7,21,14,8,1.0,0.0
29295,6007,8,56,8,72,16,9,7.0,0.0
29297,2348,7,7,7,21,14,8,1.0,0.0
29304,251591,1000,1000,1000,3000,2000,1001,1.0,0.0
29308,251591,1000,1000,1000,3000,2000,1001,1.0,0.0
29310,1846,5,5,5,15,10,6,1.0,0.0
29318,251591,1000,1000,1000,3000,2000,1001,1.0,1.0
2932,395704,500,5790,500,6790,1000,501,11.58,0.0
29323,46837,108,648,108,864,216,109,6.0,0.0
29324,251591,1000,1000,1000,3000,2000,1001,1.0,0.0
29325,2632,8,8,8,24,16,9,1.0,0.0
29328,284546,548,2740,548,3836,1096,549,5.0,0.0
29329,28132,108,108,108,324,216,109,1.0,0.0
2933,5814,7,45,7,62,17,11,6.429,0.0
29331,255592,1000,1000,1000,3000,2000,1001,1.0,0.0
29334,251591,1000,1000,1000,3000,2000,1001,1.0,0.0
29335,2632,8,8,8,24,16,9,1.0,0.0
29338,251591,1000,1000,1000,3000,2000,1001,1.0,0.0
2934,8238,0,35,0,60,25,26,5.0,0.0
29343,251591,1000,1000,1000,3000,2000,1001,1.0,0.0
29345,251591,1000,1000,1000,3000,2000,1001,1.0,0.0
29346,496442,770,5385,770,6925,1540,771,6.994,0.0
2935,4951,8,52,8,69,17,10,6.5,0.75
29361,42304,67,375,67,509,134,68,5.597,0.0
29369,634271,0,9908,0,10908,1000,1001,9.908,0.5
29376,207301,0,2460,0,2870,410,411,6.0,0.5
29382,1420980,945,27445,945,30335,2890,1947,14.111,0.0
29384,13191,20,40,20,100,60,41,2.0,0.0
29386,257597,1000,1000,1000,3000,2000,1001,1.0,0.0
29389,148281,77,2296,77,2450,154,78,29.818,0.0
29390,563505,0,6348,0,7348,1000,1001,6.348,0.0
29397,1541972,1000,22721,1000,25721,3000,2002,11.361,0.0
29408,680028,1000,7845,1000,9845,2000,1001,7.845,0.0
29409,257597,1000,1000,1000,3000,2000,1001,1.0,0.0
29414,531372,1000,5630,1000,7630,2000,1001,5.63,0.0
29415,261598,1000,1000,1000,3000,2000,1001,1.0,0.0
29420,495666,0,7000,0,8000,1000,1001,7.0,0.0
29421,1361960,1984,19909,1984,23877,3968,1986,10.035,0.0
29422,2944445,1000,48028,1000,50028,2000,1001,48.028,0.0
29424,456159,1000,6000,1000,8000,2000,1001,6.0,0.0
2943,2085,0,21,0,24,3,4,7.0,1.0
29438,1097890,1000,16108,1000,18108,2000,1001,16.108,0.0
29439,725707,0,12981,0,13981,1000,1001,12.981,0.0
29449,1418269,1000,5683,1000,7683,2000,1001,5.683,0.0
29450,792727,0,14191,0,15191,1000,1001,14.191,0.0
29459,1776094,1000,28328,1000,30328,2000,1001,28.328,0.0
2946,103326,86,1106,86,1536,430,263,12.86,0.0
29467,261598,1000,1000,1000,3000,2000,1001,1.0,0.0
29468,476545,1000,6000,1000,8000,2000,1001,6.0,0.0
2949,11121,13,87,13,115,28,16,6.692,0.0
29496,1105715,0,17901,0,18901,1000,1001,17.901,0.0
29497,565691,1000,5651,1000,7651,2000,1001,5.651,0.0
2954,21318,15,255,15,285,30,16,17.0,0.0
29558,450522,0,6000,0,7000,1000,1001,6.0,0.0
2956,337169,162,1888,162,2336,448,287,11.654,0.0
29577,1213094,847,22470,847,25164,2694,1849,12.166,0.0
2958,28897,27,342,27,396,54,28,12.667,0.0
29580,1167792,760,21600,760,24120,2520,1762,12.273,0.0
29583,1211660,849,22490,849,25188,2698,1851,12.163,0.0
29592,934786,0,17053,0,18053,1000,1001,17.053,0.8333333333333334
29593,1454811,0,22527,0,23527,1000,1001,22.527,0.0
2960,30320,37,324,37,398,74,38,8.757,0.0
29616,824727,1000,17000,1000,19000,2000,1001,17.0,0.0
29632,189749,736,736,736,2208,1472,737,1.0,0.5
29634,25920,69,276,69,414,138,70,4.0,0.0
29639,84161,135,773,135,1043,270,136,5.726,0.0
29643,257597,1000,1000,1000,3000,2000,1001,1.0,0.0
29647,2545743,0,30000,0,31468,1468,1469,30.0,0.0
2966,231966,178,1240,178,1596,356,179,6.966,0.0
2967,791321,500,12190,500,13190,1000,501,24.38,0.0
29673,276644,199,1093,199,1491,398,200,5.492,0.0
2968,91914,103,685,103,960,275,173,6.65,0.5
29687,242673,0,2381,0,2795,414,415,5.751,0.0
29693,217248,843,843,843,2529,1686,844,1.0,0.0
29696,1490913,1000,22531,1000,24531,2000,1001,22.531,0.0
29697,726682,1000,10000,1000,12000,2000,1001,10.0,0.0
29698,1046570,1000,13000,1000,15000,2000,1001,13.0,0.5
29699,31606,68,340,68,476,136,69,5.0,0.5
29704,257597,1000,1000,1000,3000,2000,1001,1.0,0.0
29709,144774,561,561,561,1683,1122,562,1.0,0.0
2971,422545,0,6400,0,6900,500,501,12.8,0.0
29711,563454,1000,7700,1000,9700,2000,1001,7.7,0.0
29713,655570,0,11444,0,12444,1000,1001,11.444,0.0
29715,257597,1000,1000,1000,3000,2000,1001,1.0,0.0
29727,517954,0,5794,0,6794,1000,1001,5.794,0.0
29728,261598,1000,1000,1000,3000,2000,1001,1.0,0.0
29729,989261,0,17127,0,17516,389,390,44.028,0.0
29731,257597,1000,1000,1000,3000,2000,1001,1.0,0.0
29736,1267354,1000,15018,1000,17018,2000,1001,15.018,0.0
2974,5992,13,55,13,81,26,14,4.231,0.0
29741,315137,79,4298,79,4456,158,80,54.405,0.0
29744,257597,1000,1000,1000,3000,2000,1001,1.0,0.0
2975,290403,0,4000,0,4500,500,501,8.0,0.5
29752,11638,21,103,21,145,42,22,4.905,0.6
29754,257597,1000,1000,1000,3000,2000,1001,1.0,0.0
2976,56286,47,303,47,402,99,53,6.447,0.5
29761,257597,1000,1000,1000,3000,2000,1001,1.0,0.0
29771,672445,0,8000,0,9000,1000,1001,8.0,0.0
29773,496784,1000,7000,1000,9000,2000,1001,7.0,0.0
2978,5723,12,36,12,72,36,25,3.0,0.0
29784,261598,1000,1000,1000,3000,2000,1001,1.0,0.0
29786,257597,1000,1000,1000,3000,2000,1001,1.0,0.0
29788,210004,0,2808,0,2886,78,79,36.0,0.0
29793,257597,1000,1000,1000,3000,2000,1001,1.0,0.0
29796,306412,79,4238,79,4396,158,80,53.646,0.0
29797,1132626,0,17300,0,18300,1000,1001,17.3,0.0
29800,910300,1000,11000,1000,13000,2000,1001,11.0,0.5
29801,1458661,1000,22477,1000,24477,2000,1001,22.477,0.0
29805,66963,79,1422,79,1580,158,80,18.0,0.0
29806,51153,98,686,98,882,196,99,7.0,0.0
29817,80472,0,682,0,796,114,115,5.982,0.0
2982,41995,92,552,92,736,184,93,6.0,0.0
29820,3466200,654,44688,654,45996,1308,655,68.33,0.0
29822,1134627,0,17300,0,18300,1000,1001,17.3,0.0
29827,1051218,1000,12999,1000,14999,2000,1001,12.999,0.0
2983,122002,187,1824,187,2198,374,188,9.754,0.0
29834,339767,551,3856,551,4958,1102,552,6.998,0.0
29835,1212567,0,19000,0,20000,1000,1001,19.0,0.0
29837,295166,377,2245,377,2999,754,378,5.955,0.0
29839,257597,1000,1000,1000,3000,2000,1001,1.0,0.0
2984,4175,5,35,5,49,14,10,7.0,0.0
29840,445323,1000,4000,1000,6000,2000,1001,4.0,0.75
29841,496926,0,7000,0,8000,1000,1001,7.0,0.0
29846,671801,1000,9000,1000,11000,2000,1001,9.0,0.0
29849,4144544,0,60000,0,61000,1000,1001,60.0,0.0
2985,161783,169,1038,169,1439,401,233,6.142,0.0
29853,14703,35,105,35,175,70,36,3.0,0.0
29856,68901,83,1485,83,1651,166,84,17.892,0.0
29859,15767,25,125,25,200,75,51,5.0,0.0
29861,961114,0,16010,0,17010,1000,1001,16.01,0.0
29862,257597,1000,1000,1000,3000,2000,1001,1.0,0.0
29865,257597,1000,1000,1000,3000,2000,1001,1.0,0.0
29867,261598,1000,1000,1000,3000,2000,1001,1.0,0.0
29875,257597,1000,1000,1000,3000,2000,1001,1.0,0.0
29876,802970,0,11000,0,12000,1000,1001,11.0,0.0
29877,62534,241,241,241,723,482,242,1.0,0.0
29878,33365,0,330,0,385,55,56,6.0,0.0
29879,532781,0,8106,0,8685,579,580,14.0,1.0
29883,257597,1000,1000,1000,3000,2000,1001,1.0,0.0
29887,125343,342,1026,342,1710,684,343,3.0,1.0
29890,269318,347,3943,347,4637,694,348,11.363,0.0
29894,392324,235,6050,235,6520,470,236,25.745,0.0
29895,261598,1000,1000,1000,3000,2000,1001,1.0,0.0
29897,12846,34,102,34,170,68,35,3.0,0.0
29898,68897,83,1485,83,1651,166,84,17.892,0.0
29901,361219,1000,3000,1000,5000,2000,1001,3.0,0.0
29903,257597,1000,1000,1000,3000,2000,1001,1.0,0.0
29915,20005,0,215,0,258,43,44,5.0,0.0
2992,1099819,500,15614,500,16614,1000,501,31.228,0.0
29921,69782,83,1485,83,1651,166,84,17.892,0.0
29925,21968,28,252,28,308,56,29,9.0,0.0
29928,46732,67,402,67,536,134,68,6.0,0.0
2993,19899,32,206,32,270,64,33,6.438,0.0
29930,499250,1000,7000,1000,9000,2000,1001,7.0,0.0
29935,412295,829,5803,829,7461,1658,830,7.0,0.0
29936,4903,7,51,7,65,14,8,7.286,0.0
29942,4742706,1000,53239,1000,55239,2000,1001,53.239,0.0
29943,104330,125,938,125,1313,375,200,7.504,0.0
29945,257597,1000,1000,1000,3000,2000,1001,1.0,0.0
29946,14713,35,105,35,175,70,36,3.0,0.0
29947,67375,81,1419,81,1581,162,82,17.519,0.0
29950,179983,698,698,698,2094,1396,699,1.0,0.0
29952,499622,1000,7000,1000,9000,2000,1001,7.0,0.0
29953,1125908,0,16349,0,17349,1000,1001,16.349,0.0
29955,35240,0,404,0,456,52,53,7.769,0.0
29957,257597,1000,1000,1000,3000,2000,1001,1.0,0.0
29958,57716,80,1186,80,1346,160,81,14.825,0.0
29959,179983,698,698,698,2094,1396,699,1.0,0.0
2996,394551,500,5748,500,6748,1000,501,11.496,0.0
29962,32304,58,344,58,460,116,59,5.931,0.0
29963,57245,79,1185,79,1343,158,80,15.0,0.0
29965,51728,61,714,61,836,122,62,11.705,0.0
29966,359828,624,3744,624,4992,1248,625,6.0,0.0
29967,1547539,2000,22724,2000,26724,4000,2002,11.362,0.0
29968,609382,0,7671,0,8630,959,960,7.999,0.0
2997,1629,3,11,3,17,6,4,3.667,1.0
29970,126176,210,1965,210,2385,420,211,9.357,0.0
29972,1135647,0,17345,0,18345,1000,1001,17.345,0.0
29978,68032,0,1467,0,1549,82,83,17.89,0.0
29979,88342,159,795,159,1113,318,160,5.0,0.0
2998,240684,500,2945,500,3945,1000,501,5.89,0.0
2999,487344,0,7526,0,8026,500,501,15.052,0.5
29998,11036,15,102,15,132,30,16,6.8,0.0
30006,65745,0,661,0,805,144,145,4.59,0.0
3001,12979,7,166,7,180,14,8,23.714,0.0
30011,13158,19,145,19,183,38,20,7.632,0.0
30013,257597,1000,1000,1000,3000,2000,1001,1.0,0.0
30018,22783,62,248,62,372,124,63,4.0,0.0
3002,15327,0,213,0,241,28,29,7.607,0.0
30027,1135647,0,17345,0,18345,1000,1001,17.345,0.0
30029,14483,0,105,0,140,35,36,3.0,0.0
3003,28052,28,280,28,336,56,29,10.0,0.0
30031,5119,0,80,0,85,5,6,16.0,0.0
30036,727854,1000,10000,1000,12000,2000,1001,10.0,0.0
30037,723853,1000,10000,1000,12000,2000,1001,10.0,0.0
30038,429099,304,6616,304,7528,912,610,10.882,0.0
30045,336975,79,4684,79,4842,158,80,59.291,0.0
30046,77084,188,940,188,1316,376,189,5.0,0.0
3005,15572,0,220,0,242,22,23,10.0,0.0
30050,10486401,827,129012,827,130666,1654,828,156.0,0.0
30057,213136,827,827,827,2481,1654,828,1.0,0.0
3007,44315,54,535,54,643,108,55,9.907,0.0
30072,14460,36,108,36,180,72,37,3.0,0.0
30077,257598,0,1000,0,2000,1000,1001,1.0,0.0
30078,18826,55,165,55,275,110,56,3.0,0.0
30079,1920,4,12,4,20,8,5,3.0,0.0
3008,359536,500,5238,500,6238,1000,501,10.476,0.0
30080,59984,83,1245,83,1411,166,84,15.0,0.0
30085,39160,58,348,58,464,116,59,6.0,0.0
30086,67263,81,1458,81,1620,162,82,18.0,0.0
30088,13051,34,102,34,170,68,35,3.0,1.0
3009,9462,0,87,0,102,15,16,5.8,0.0
30090,5127,0,80,0,85,5,6,16.0,0.0
30098,259209,385,3080,385,3850,770,386,8.0,0.0
30099,14894,36,108,36,180,72,37,3.0,0.0
3010,586709,500,8999,500,10499,1500,1002,8.999,0.0
30103,255597,0,1000,0,2000,1000,1001,1.0,0.0
30104,3168,0,20,0,25,5,6,4.0,0.0
30107,66532,80,1440,80,1600,160,81,18.0,0.0
30109,21845,28,248,28,304,56,29,8.857,0.0
3011,18734,0,158,0,204,46,47,3.435,0.0
30111,14538,0,108,0,144,36,37,3.0,0.0
30115,723853,1000,10000,1000,12000,2000,1001,10.0,0.0
30119,58407,81,1215,81,1377,162,82,15.0,0.0
3012,21707,0,224,0,270,46,47,4.87,0.0
3013,228749,500,2612,500,3612,1000,501,5.224,1.0
30132,5420,0,60,0,72,12,13,5.0,0.0
30133,12122,25,125,25,175,50,26,5.0,0.0
30137,66158,80,1440,80,1600,160,81,18.0,0.0
30138,5058,0,48,0,60,12,13,4.0,0.0
30140,257598,0,1000,0,2000,1000,1001,1.0,0.0
30141,264467,388,3104,388,3880,776,389,8.0,0.0
30142,266569,388,3104,388,3880,776,389,8.0,0.0
30144,79609,0,1144,0,1268,124,67,18.452,0.0
30145,1528784,0,20878,0,21878,1000,1001,20.878,0.0
30146,15529,0,172,0,201,29,30,5.931,0.0
30147,1133832,0,17656,0,18656,1000,1001,17.656,0.0
30149,111267,0,434,0,868,434,435,1.0,0.0
3015,18246,0,275,0,300,25,26,11.0,0.0
30150,12348,25,125,25,175,50,26,5.0,0.0
30151,257597,1000,1000,1000,3000,2000,1001,1.0,0.0
30154,15906,0,172,0,201,29,30,5.931,0.0
30155,1523671,0,20889,0,21889,1000,1001,20.889,0.0
3016,29595,0,453,0,497,44,45,10.295,0.0
30160,67337,82,1470,82,1634,164,83,17.927,0.0
30161,269270,393,3144,393,3930,786,394,8.0,0.0
30162,23325,32,212,32,276,64,33,6.625,0.75
30163,257597,1000,1000,1000,3000,2000,1001,1.0,0.0
3017,125944,269,1613,269,2151,538,270,5.996,0.0
30173,58610,81,1215,81,1377,162,82,15.0,0.0
30178,14940,36,108,36,180,72,37,3.0,0.0
3018,244052,500,3000,500,4000,1000,501,6.0,1.0
30180,15037,0,167,0,195,28,29,5.964,0.0
30184,264037,390,3120,390,3900,780,391,8.0,0.0
30187,15503,0,172,0,201,29,30,5.931,0.0
30188,14810,27,133,27,187,54,28,4.926,0.6
30189,1215530,0,19000,0,20000,1000,1001,19.0,0.0
3019,4718,0,30,0,40,10,11,3.0,0.0
30190,260926,386,3088,386,3860,772,387,8.0,0.0
30192,5084,0,48,0,60,12,13,4.0,0.0
30193,268740,394,3152,394,3940,788,395,8.0,0.0
30195,15961,0,178,0,208,30,31,5.933,0.0
30199,1135439,0,17340,0,18340,1000,1001,17.34,0.0
3020,23003,0,354,0,381,27,28,13.111,0.0
30203,265086,393,3144,393,3930,786,394,8.0,0.0
30205,1135439,0,17340,0,18340,1000,1001,17.34,0.0
30206,15345,0,172,0,201,29,30,5.931,0.0
30208,15484,0,167,0,195,28,29,5.964,0.0
3021,2197,4,16,4,24,8,5,4.0,0.0
30210,261598,1000,1000,1000,3000,2000,1001,1.0,0.0
30212,1512312,698,21725,698,23121,1396,699,31.125,0.0
30217,14791,0,161,0,188,27,28,5.963,0.0
3022,22297,0,350,0,375,25,26,14.0,0.0
3023,232101,500,2832,500,3832,1000,501,5.664,0.0
30236,728247,1000,10000,1000,12000,2000,1001,10.0,0.0
30237,24168,12,300,12,324,24,13,25.0,0.0
30238,15073,0,167,0,195,28,29,5.964,0.0
3024,8450,0,135,0,140,5,6,27.0,0.0
30241,14624,0,161,0,188,27,28,5.963,0.0
30244,15313,0,161,0,188,27,28,5.963,0.0
3025,234513,0,3334,0,3707,373,374,8.938,0.0
30252,649186,1000,8000,1000,10000,2000,1001,8.0,0.6666666666666666
30254,167610,248,1984,248,2480,496,249,8.0,0.0
30255,14445,0,161,0,188,27,28,5.963,0.0
3026,98372,200,1200,200,1600,400,201,6.0,1.0
30261,14563,0,161,0,188,27,28,5.963,0.0
30262,5085,0,48,0,60,12,13,4.0,0.0
30263,14563,0,161,0,188,27,28,5.963,0.0
30264,257597,1000,1000,1000,3000,2000,1001,1.0,0.0
30265,15703,0,172,0,201,29,30,5.931,0.0
3027,5738,0,60,0,67,7,8,8.571,1.0
30270,14582,0,161,0,188,27,28,5.963,0.0
30271,14559,0,161,0,188,27,28,5.963,0.0
30276,15807,0,178,0,208,30,31,5.933,0.0
30277,277778,393,3144,393,3930,786,394,8.0,0.0
3028,923273,500,13073,500,14073,1000,501,26.146,0.0
30282,168675,654,654,654,1962,1308,655,1.0,0.0
30283,14834,0,111,0,148,37,38,3.0,0.0
30287,14551,0,161,0,188,27,28,5.963,0.0
3029,1475344,0,19130,0,19630,500,501,38.26,0.0
30291,14413,0,161,0,188,27,28,5.963,0.0
30293,14350,35,105,35,175,70,36,3.0,0.0
30295,14477,0,161,0,188,27,28,5.963,0.0
30297,15348,0,161,0,188,27,28,5.963,0.0
3030,345828,0,4500,0,5000,500,501,9.0,0.0
30300,732248,1000,10000,1000,12000,2000,1001,10.0,0.0
30301,15434,0,172,0,201,29,30,5.931,0.0
30304,14380,0,161,0,188,27,28,5.963,0.0
30307,14523,0,161,0,188,27,28,5.963,0.0
30308,15323,0,161,0,188,27,28,5.963,0.0
30309,14452,0,161,0,188,27,28,5.963,0.0
3031,529853,156,5304,156,5616,312,157,34.0,0.0
30311,120497,175,1400,175,1750,350,176,8.0,0.0
30313,15421,0,172,0,201,29,30,5.931,0.0
30314,14464,27,161,27,215,54,28,5.963,0.0
30315,1135439,0,17340,0,18340,1000,1001,17.34,0.0
30316,15602,0,172,0,201,29,30,5.931,0.0
30319,14523,27,161,27,215,54,28,5.963,0.0
3032,4276,0,27,0,36,9,10,3.0,0.0
30320,747602,0,12136,0,12908,772,773,15.72,0.0
30321,15529,0,172,0,201,29,30,5.931,0.0
30323,15240,0,167,0,195,28,29,5.964,0.0
30324,14485,0,161,0,188,27,28,5.963,0.0
30325,14977,0,161,0,188,27,28,5.963,0.0
30327,15559,0,172,0,201,29,30,5.931,0.0
30328,16352,0,184,0,215,31,32,5.935,0.0
30329,14596,0,161,0,188,27,28,5.963,0.0
3033,15450,28,161,28,217,56,29,5.75,0.0
30330,66713,81,1458,81,1620,162,82,18.0,0.0
30331,15461,0,172,0,201,29,30,5.931,0.0
30332,14905,0,161,0,188,27,28,5.963,0.0
30333,14391,0,161,0,188,27,28,5.963,0.0
30334,15597,0,172,0,201,29,30,5.931,0.0
30335,14499,0,161,0,188,27,28,5.963,0.0
30338,15189,0,161,0,188,27,28,5.963,0.0
3034,35296,0,887,0,911,24,25,36.958,0.0
30340,934724,0,15832,0,16832,1000,1001,15.832,0.0
30341,15778,0,172,0,201,29,30,5.931,0.0
30342,14550,0,159,0,186,27,28,5.889,0.0
30343,14472,0,161,0,188,27,28,5.963,0.0
30344,14540,0,161,0,188,27,28,5.963,0.0
30345,16045,0,178,0,208,30,31,5.933,0.0
30346,14572,0,161,0,188,27,28,5.963,0.0
30348,14661,0,161,0,188,27,28,5.963,0.0
3035,552181,0,9369,0,9869,500,501,18.738,0.5
30350,14508,0,161,0,188,27,28,5.963,0.0
30352,14741,0,161,0,188,27,28,5.963,0.0
30353,14886,0,161,0,188,27,28,5.963,0.0
30354,15306,0,161,0,188,27,28,5.963,0.0
30356,14646,0,161,0,188,27,28,5.963,0.0
30357,247324,359,2872,359,3590,718,360,8.0,0.0
30358,14497,0,161,0,188,27,28,5.963,0.0
30359,14521,0,161,0,188,27,28,5.963,0.0
3036,23999,54,216,54,324,108,55,4.0,0.0
30360,14880,0,161,0,188,27,28,5.963,0.0
30361,112567,429,429,429,1287,858,430,1.0,0.0
30362,14877,0,161,0,188,27,28,5.963,0.0
30363,14564,0,161,0,188,27,28,5.963,0.0
30364,15430,0,172,0,201,29,30,5.931,0.0
30365,14690,0,161,0,188,27,28,5.963,0.0
30366,15945,0,178,0,208,30,31,5.933,0.0
30367,14691,36,108,36,180,72,37,3.0,0.0
30368,14551,0,161,0,188,27,28,5.963,0.0
30369,14411,0,161,0,188,27,28,5.963,0.0
3037,7450,0,84,0,96,12,13,7.0,0.0
30371,14558,0,161,0,188,27,28,5.963,0.0
30374,15005,0,167,0,195,28,29,5.964,0.0
30375,14545,0,161,0,188,27,28,5.963,0.0
30377,14989,0,167,0,195,28,29,5.964,0.0
30378,16054,0,178,0,208,30,31,5.933,0.0
3038,26567,0,448,0,464,16,17,28.0,0.0
30380,17033,0,172,0,201,29,30,5.931,0.0
30381,14956,0,161,0,188,27,28,5.963,0.0
30382,15817,0,178,0,208,30,31,5.933,0.0
30383,85017,124,992,124,1240,248,125,8.0,0.0
30384,129623,189,1512,189,1890,378,190,8.0,0.0
30385,14678,0,161,0,188,27,28,5.963,0.0
30386,14419,0,161,0,188,27,28,5.963,0.0
30388,15974,0,172,0,201,29,30,5.931,0.0
30389,14518,0,161,0,188,27,28,5.963,0.0
3039,15339,38,114,38,190,76,39,3.0,0.0
30390,14493,0,161,0,188,27,28,5.963,0.0
30391,14490,0,161,0,188,27,28,5.963,0.0
30392,15148,0,167,0,195,28,29,5.964,0.0
30393,1983469,2000,25647,2000,29647,4000,2002,12.823,0.0
30396,57935,82,1230,82,1394,164,83,15.0,0.0
30397,14545,0,161,0,188,27,28,5.963,0.0
30398,15195,0,161,0,188,27,28,5.963,0.0
30399,11803,32,96,32,160,64,33,3.0,0.0
3040,43484,0,507,0,532,25,26,20.28,0.0
30400,14758,0,161,0,188,27,28,5.963,0.0
3041,104355,0,1418,0,1568,150,151,9.453,0.0
30412,257597,1000,1000,1000,3000,2000,1001,1.0,0.0
30413,15444,37,111,37,185,74,38,3.0,0.0
30416,15480,0,172,0,201,29,30,5.931,0.0
30417,5701,4,12,4,20,8,5,3.0,0.0
30419,14455,0,161,0,188,27,28,5.963,0.0
3042,465885,500,6996,500,8496,1500,1002,6.996,0.0
30422,257597,1000,1000,1000,3000,2000,1001,1.0,0.0
30423,14980,0,167,0,195,28,29,5.964,0.0
30424,15570,0,172,0,201,29,30,5.931,0.0
30425,14609,0,161,0,188,27,28,5.963,0.0
30426,67269,83,1488,83,1654,166,84,17.928,0.0
30427,851002,0,20,0,24,4,5,5.0,0.0
30428,57640,82,1230,82,1394,164,83,15.0,0.0
30429,5065,0,48,0,60,12,13,4.0,0.0
3043,19346,0,336,0,348,12,13,28.0,0.0
30430,14475,0,161,0,188,27,28,5.963,0.0
30432,15579,0,172,0,201,29,30,5.931,0.0
30436,14647,0,161,0,188,27,28,5.963,0.0
30437,14496,0,161,0,188,27,28,5.963,0.0
3044,300385,0,3500,0,4000,500,501,7.0,0.0
30442,256272,276,2477,276,3085,608,312,8.975,0.75
30443,257597,1000,1000,1000,3000,2000,1001,1.0,0.0
30444,1510217,0,20600,0,21600,1000,1001,20.6,0.0
30446,4605775,0,56145,0,57145,1000,1001,56.145,0.0
30447,257597,1000,1000,1000,3000,2000,1001,1.0,0.0
30449,109672,111,990,111,1257,267,146,8.919,0.5
3045,240435,500,3000,500,4000,1000,501,6.0,0.5
30453,14555,0,105,0,140,35,36,3.0,0.0
30455,261598,1000,1000,1000,3000,2000,1001,1.0,0.0
3046,112168,225,1350,225,1800,450,226,6.0,0.75
30463,261598,1000,1000,1000,3000,2000,1001,1.0,0.0
30466,32854,33,296,33,383,87,41,8.97,0.0
3047,38915,0,643,0,681,38,39,16.921,0.0
3048,2197,4,16,4,24,8,5,4.0,0.0
30482,257597,1000,1000,1000,3000,2000,1001,1.0,0.0
30486,303418,24,192,24,240,48,25,8.0,0.0
30488,257597,1000,1000,1000,3000,2000,1001,1.0,0.0
3049,409617,500,5978,500,6978,1000,501,11.956,0.0
30492,257597,1000,1000,1000,3000,2000,1001,1.0,0.0
30493,261598,1000,1000,1000,3000,2000,1001,1.0,0.0
30494,195891,207,1856,207,2329,473,253,8.966,0.5
30495,197816,221,1987,221,2429,442,222,8.991,0.0
30497,1642,4,4,4,12,8,5,1.0,0.0
3050,30087,0,220,0,242,22,23,10.0,0.0
3051,56084,89,445,89,623,178,90,5.0,0.5
30511,9916763,512,3072,512,4096,1024,513,6.0,0.0
30519,1535142,0,24640,0,25640,1000,1001,24.64,0.0
3052,21881,0,494,0,520,26,27,19.0,0.0
30521,257597,1000,1000,1000,3000,2000,1001,1.0,0.0
30524,353112,262,5693,262,6479,786,526,10.865,0.0
30525,4452,15,15,15,45,30,16,1.0,0.0
30526,257597,1000,1000,1000,3000,2000,1001,1.0,0.0
30527,14218,53,53,53,159,106,54,1.0,0.0
30528,257597,1000,1000,1000,3000,2000,1001,1.0,0.0
30529,190084,726,726,726,2178,1452,727,1.0,0.0
3053,394064,325,8767,325,9417,650,326,26.975,0.0
30530,122158,473,473,473,1419,946,474,1.0,0.0
30531,36616,138,138,138,414,276,139,1.0,0.0
30533,14431,53,53,53,159,106,54,1.0,0.0
30535,4307974,0,2492,0,2848,356,357,7.0,0.0
30536,255597,0,1000,0,2000,1000,1001,1.0,0.0
30537,255597,0,1000,0,2000,1000,1001,1.0,0.0
30539,167648,0,650,0,1300,650,651,1.0,0.0
30540,1937553,0,371,0,424,53,54,7.0,0.0
30542,257598,0,1000,0,2000,1000,1001,1.0,0.0
30543,408490,0,105,0,120,15,16,7.0,0.0
30544,302051,0,168,0,192,24,25,7.0,0.0
30545,4452,15,15,15,45,30,16,1.0,0.0
30547,257598,0,1000,0,2000,1000,1001,1.0,0.0
30548,92089,356,356,356,1068,712,357,1.0,0.0
3055,19632,12,336,12,360,24,13,28.0,0.0
30550,1534121,0,23602,0,24602,1000,1001,23.602,0.0
30554,1258659,1000,19305,1000,21305,2000,1001,19.305,1.0
30555,595278,0,7213,0,7398,185,186,38.989,0.5
30558,595278,0,7213,0,7398,185,186,38.989,0.5
3056,10310,13,65,13,91,26,14,5.0,1.0
30560,595649,0,7213,0,7398,185,186,38.989,0.0
30562,575563,0,10000,0,11000,1000,1001,10.0,0.0
30564,1071995,0,13150,0,15543,2393,2394,13.15,0.0
3057,43605,0,460,0,575,115,116,4.0,1.0
30570,931866,0,15002,0,16002,1000,1001,15.002,0.0
30571,819389,0,11813,0,12813,1000,1001,11.813,0.5
30574,247587,1000,1000,1000,3000,2000,1001,1.0,0.0
30575,1540661,1000,23575,1000,25575,2000,1001,23.575,0.0
30577,1536649,1000,23541,1000,25541,2000,1001,23.541,0.0
30579,891138,0,19000,0,20000,1000,1001,19.0,0.0
3058,71184,0,820,0,932,112,113,7.321,0.0
30580,1299942,0,30000,0,31000,1000,1001,30.0,0.0
30583,4498563,0,69576,0,70576,1000,1001,69.576,0.0
30589,866490,1000,13489,1000,15489,2000,1001,13.489,0.0
3059,86153,175,1050,175,1400,350,176,6.0,0.0
30591,236234,321,4183,321,4990,807,474,13.031,0.0
30593,909966,1000,15146,1000,17146,2000,1001,15.146,0.0
30594,335353,0,4648,0,5346,698,698,13.318,0.5
30598,932928,1000,12683,1000,14683,2000,1001,12.683,0.0
30599,802147,1000,15187,1000,17187,2000,1001,15.187,0.0
3060,231971,500,2603,500,3603,1000,501,5.206,0.0
30602,1512768,1000,23234,1000,25234,2000,1001,23.234,0.0
30604,1536677,1000,23541,1000,25541,2000,1001,23.541,0.0
30605,2321440,1000,35000,1000,37000,2000,1001,35.0,0.0
3061,215466,0,824,0,854,30,31,27.467,0.0
30614,857621,1000,14801,1000,16801,2000,1001,14.801,0.0
30616,514670,1000,8000,1000,10000,2000,1001,8.0,0.0
30617,3613,0,32,0,40,8,9,4.0,0.0
30618,754751,0,13265,0,14265,1000,1001,13.265,0.0
3062,1395,2,8,2,12,4,3,4.0,0.0
30620,1249607,0,18411,0,19411,1000,1001,18.411,0.0
30621,365315,1000,4000,1000,6000,2000,1001,4.0,0.0
30625,676117,1000,7991,1000,9991,2000,1001,7.991,0.0
30629,770645,0,15240,0,16240,1000,1001,15.24,0.5
3063,41694,0,420,0,490,70,71,6.0,0.0
30631,23622,64,214,64,342,128,65,3.344,0.0
30632,1416514,0,26778,0,27778,1000,1001,26.778,0.0
30633,1512265,0,31505,0,32505,1000,1001,31.505,0.5
30641,2643948,1000,27953,1000,30953,3000,2001,27.953,0.0
30646,43554,0,558,0,628,70,71,7.971,0.0
30647,894835,1000,14113,1000,16120,2007,1008,14.113,0.0
30648,890602,1000,13616,1000,15616,2000,1001,13.616,0.0
30649,736778,1000,11738,1000,13738,2000,1001,11.738,0.5
3065,1549982,0,18870,0,19870,1000,655,37.74,0.0
30650,1404277,1000,21448,1000,23448,2000,1001,21.448,0.0
30651,762993,0,8992,0,9992,1000,1001,8.992,0.0
30652,336995,1000,2999,1000,4999,2000,1001,2.999,0.0
30653,1534955,1000,23413,1000,25413,2000,1001,23.413,0.0
30654,903255,0,5999,0,6999,1000,1001,5.999,0.5
30657,1536649,1000,23541,1000,25541,2000,1001,23.541,0.0
3066,239694,500,2854,500,3854,1000,501,5.708,0.0
30662,361314,1000,4000,1000,6000,2000,1001,4.0,0.0
30663,680712,1000,10000,1000,12000,2000,1001,10.0,0.5
30666,3574249,1000,43866,1000,45866,2000,1001,43.866,0.0
30667,1375129,1000,20381,1000,22381,2000,1001,20.381,0.5
30669,1315448,1000,14649,1000,16649,2000,1001,14.649,0.0
3067,244401,500,2999,500,3999,1000,501,5.998,0.0
30672,1827894,0,30297,0,31297,1000,1001,30.297,0.5
30673,2846,0,31,0,36,5,6,6.2,0.0
30675,2756042,0,83872,0,84872,1000,1001,83.872,0.0
30677,84765,0,1066,0,1218,152,153,7.013,0.0
30680,4895,9,33,9,51,18,10,3.667,0.0
30682,1501268,1000,23146,1000,25146,2000,1001,23.146,0.0
30684,1105803,1000,20847,1000,22847,2000,1001,20.847,0.0
30685,1104288,1000,20844,1000,22844,2000,1001,20.844,0.0
30686,401709,1000,4000,1000,6000,2000,1001,4.0,0.0
30692,1342515,1000,19525,1000,21525,2000,1001,19.525,0.0
30694,144267,0,1920,0,2304,384,385,5.0,0.0
30696,36908,0,492,0,556,64,65,7.688,0.0
30698,684996,1000,9000,1000,11000,2000,1001,9.0,0.0
3070,207216,443,2658,443,3544,886,444,6.0,1.0
30700,787024,0,15000,0,16000,1000,1001,15.0,0.0
30702,45801,0,693,0,726,33,34,21.0,0.0
30708,550135,0,6956,0,7956,1000,1001,6.956,0.0
3071,549185,0,9500,0,10000,500,501,19.0,0.5
30715,47496,0,896,0,970,74,75,12.108,0.0
30716,888726,1000,13009,1000,15009,2000,1001,13.009,0.5
30721,458135,1000,6993,1000,8993,2000,1001,6.993,0.0
30725,261946,301,3889,301,4491,602,302,12.92,0.0
3073,24132,28,297,28,353,56,29,10.607,0.0
30737,29361,0,329,0,381,52,53,6.327,0.0
3074,5339,0,60,0,69,9,10,6.667,0.0
30749,372780,1000,3953,1000,5953,2000,1001,3.953,0.0
30753,1683620,0,29204,0,30204,1000,1001,29.204,0.0
30755,23881,56,224,56,336,112,57,4.0,0.0
30765,1718724,0,29204,0,30204,1000,1001,29.204,0.0
3077,139038,125,805,125,1067,262,138,6.44,0.0
3078,302820,500,4500,500,5500,1000,501,9.0,0.5
30780,4251513,1000,63675,1000,65675,2000,1001,63.675,0.0
30782,669235,1000,10588,1000,12588,2000,1001,10.588,0.0
30789,14579,0,128,0,160,32,33,4.0,0.0
3079,21719,0,320,0,356,36,37,8.889,0.0
30797,455746,0,6310,0,7310,1000,1001,6.31,1.0
30798,595278,0,7213,0,7398,185,186,38.989,0.0
30799,1384356,0,13875,0,14060,185,186,75.0,0.0
3080,2251,3,17,3,25,8,6,5.667,0.0
30801,875459,0,10999,0,11999,1000,1001,10.999,0.5
30802,247587,1000,1000,1000,3000,2000,1001,1.0,0.5
30804,1684033,0,41925,0,42925,1000,1001,41.925,0.0
30808,371180,1000,3983,1000,5983,2000,1001,3.983,0.0
3081,321096,500,3545,500,4545,1000,501,7.09,0.0
30810,415016,486,8748,486,9720,972,487,18.0,0.0
30811,1384727,0,13875,0,14060,185,186,75.0,0.0
30814,517330,1000,8000,1000,10000,2000,1001,8.0,0.0
30816,138320,398,1194,398,1990,796,399,3.0,0.0
30818,1092978,0,18845,0,19591,746,747,25.261,0.0
3082,600421,0,12045,0,12545,500,501,24.09,0.0
30825,1592598,1000,24444,1000,26444,2000,1001,24.444,0.0
30826,2748,0,25,0,30,5,6,5.0,0.0
30828,1033411,1000,22000,1000,24000,2000,1001,22.0,0.0
30832,63005,0,785,0,923,138,139,11.377,0.0
30834,1618101,0,27741,0,28741,1000,1001,27.741,0.0
30836,768016,1000,10124,1000,12124,2000,1001,10.124,0.0
30839,515944,1000,8000,1000,10000,2000,1001,8.0,0.0
30841,736898,1000,12379,1000,14379,2000,1002,12.379,0.0
30842,1023618,0,11224,0,11408,184,185,61.0,0.0
30845,1001494,0,29000,0,30000,1000,1001,29.0,0.0
30846,1384356,0,13875,0,14060,185,186,75.0,0.0
30847,1796995,0,29042,0,30042,1000,1001,29.042,0.0
30848,1086077,0,24159,0,25159,1000,1001,24.159,0.0
30851,1384356,0,13875,0,14060,185,186,75.0,1.0
30852,45801,0,693,0,726,33,34,21.0,0.0
30855,705521,1000,10836,1000,12836,2000,1001,10.836,0.0
30859,462031,0,6382,0,7382,1000,1001,6.382,0.0
30866,899324,0,15450,0,16092,642,643,24.065,0.0
3087,87274,103,651,103,871,220,118,6.32,1.0
30872,1384356,0,13875,0,14060,185,186,75.0,0.0
30876,1023249,0,11224,0,11408,184,185,61.0,0.0
30877,123693,122,2416,122,2660,244,123,19.803,0.5
30879,4978,13,39,13,65,26,14,3.0,0.0
30881,1384356,0,13875,0,14060,185,186,75.0,0.0
30883,912107,1000,13179,1000,15179,2000,1001,13.179,0.5
30885,22569,31,310,31,372,62,32,10.0,0.0
30888,1023249,0,11224,0,11408,184,185,61.0,0.0
30889,1695221,1000,24051,1000,26051,2000,1001,24.051,0.5
30890,857535,0,14000,0,15000,1000,1001,14.0,0.5
30891,595278,0,7213,0,7398,185,186,38.989,0.0
30892,14115,0,140,0,145,5,6,28.0,0.0
30893,353524,0,3763,0,4516,753,754,4.997,0.0
30894,390705,1000,4440,1000,6440,2000,1001,4.44,0.0
30895,1384727,0,13875,0,14060,185,186,75.0,0.0
30896,1384356,0,13875,0,14060,185,186,75.0,0.0
30897,1384356,0,13875,0,14060,185,186,75.0,1.0
30899,446536,0,6218,0,7218,1000,1001,6.218,1.0
30900,1384727,0,13875,0,14060,185,186,75.0,0.0
30903,595649,0,7213,0,7398,185,186,38.989,0.5
30904,1384356,0,13875,0,14060,185,186,75.0,0.0
30905,5141,8,56,8,72,16,9,7.0,0.0
30906,462811,0,6571,0,7571,1000,1001,6.571,0.5
30908,2613,0,25,0,30,5,6,5.0,0.0
30919,1023249,0,11224,0,11408,184,185,61.0,0.0
30929,45868,0,693,0,726,33,34,21.0,0.0
30935,1023249,0,11224,0,11408,184,185,61.0,0.0
30939,1384356,0,13875,0,14060,185,186,75.0,0.0
30942,1023249,0,11224,0,11408,184,185,61.0,0.0
30944,2408,0,24,0,28,4,5,6.0,0.0
30945,143653,0,2345,0,2525,180,181,13.028,0.0
30966,45801,0,693,0,726,33,34,21.0,0.0
30967,187982,119,2889,119,3127,238,120,24.277,0.0
30969,500179,0,6000,0,7000,1000,1001,6.0,0.0
30970,247587,1000,1000,1000,3000,2000,1001,1.0,0.5
30971,157502,0,2330,0,2584,254,255,9.173,0.0
30972,851192,1000,13944,1000,15944,2000,1001,13.944,0.5
30976,2971,0,28,0,35,7,8,4.0,0.0
30977,473978,1000,6000,1000,8000,2000,1001,6.0,0.0
30981,1384356,0,13875,0,14060,185,186,75.0,0.0
30984,162043,0,2455,0,2659,204,205,12.034,0.0
30985,247587,1000,1000,1000,3000,2000,1001,1.0,0.0
30987,355433,492,5661,492,6645,984,493,11.506,0.0
30989,1384356,0,13875,0,14060,185,186,75.0,0.0
30991,45801,0,693,0,726,33,34,21.0,0.0
30993,708568,1000,9611,1000,11611,2000,1001,9.611,0.0
30994,527977,1000,7000,1000,9000,2000,1001,7.0,0.0
30999,566978,0,9000,0,10000,1000,1001,9.0,0.5
31000,1400331,1000,21325,1000,23325,2000,1001,21.325,0.0
31002,2523,0,20,0,25,5,6,4.0,0.0
31003,431005,1000,5000,1000,7000,2000,1001,5.0,0.0
31007,1690490,0,29207,0,30207,1000,1001,29.207,0.0
31009,135414,314,1570,314,2198,628,315,5.0,0.0
31011,467391,368,8180,368,8916,736,369,22.228,0.0
31012,21013,58,232,58,348,116,59,4.0,0.0
31017,1384356,0,13875,0,14060,185,186,75.0,0.0
31030,1384356,0,13875,0,14060,185,186,75.0,0.0
31032,3169,8,24,8,40,16,9,3.0,0.0
31036,10807,11,176,11,198,22,12,16.0,0.0
31041,13064,0,168,0,189,21,22,8.0,0.0
31042,2615,0,25,0,30,5,6,5.0,0.0
31045,1003829,0,29000,0,30000,1000,1001,29.0,0.0
3105,1299,1,7,1,10,3,3,7.0,0.0
31050,498192,0,9000,0,10000,1000,1001,9.0,0.0
31051,55002,61,819,61,941,122,62,13.426,0.0
31054,9936,23,122,23,168,46,24,5.304,0.0
31057,107155,114,1562,114,1790,228,115,13.702,0.0
31058,507707,0,5147,0,6147,1000,1001,5.147,0.0
31062,2937,7,21,7,35,14,8,3.0,0.0
31064,10322,0,204,0,216,12,13,17.0,0.0
31069,2694,0,25,0,30,5,6,5.0,0.5
31071,45801,0,693,0,726,33,34,21.0,0.0
31072,636848,0,10000,0,11000,1000,1001,10.0,1.0
31073,36672,41,488,41,570,82,42,11.902,0.0
31074,863853,1000,14477,1000,16477,2000,1001,14.477,0.0
31075,1000100,0,29000,0,30000,1000,1001,29.0,0.0
31078,2647548,1000,76978,1000,78978,2000,1001,76.978,0.0
31080,45801,0,693,0,726,33,34,21.0,0.0
31082,41992,0,303,0,505,202,203,3.0,0.0
31088,178200,0,2380,0,2856,476,477,5.0,1.0
31089,978360,0,16000,0,17000,1000,1001,16.0,0.5
3109,394450,500,5739,500,6739,1000,501,11.478,0.0
31096,905019,1000,13063,1000,15063,2000,1001,13.063,0.0
31097,1506517,1000,23169,1000,25169,2000,1001,23.169,0.0
31098,1335080,1000,19670,1000,21670,2000,1001,19.67,0.0
31099,6193,15,60,15,90,30,16,4.0,0.0
31108,770917,1000,10256,1000,12256,2000,1001,10.256,0.0
31116,530693,1000,7000,1000,9000,2000,1001,7.0,0.0
31117,363357,1000,4000,1000,6000,2000,1001,4.0,0.0
31120,636552,1000,8935,1000,10935,2000,1001,8.935,0.0
31125,453245,1000,5876,1000,7876,2000,1001,5.876,0.5
31126,531232,1000,6942,1000,8942,2000,1001,6.942,0.5
31132,2643765,29,551,29,609,58,30,19.0,0.0
31135,1005207,0,29000,0,30000,1000,1001,29.0,0.0
31139,1138016,1000,12938,1000,16844,3906,2907,12.938,0.5
3114,60193,32,671,32,735,64,33,20.969,0.0
31140,437929,1000,4000,1000,6000,2000,1001,4.0,0.0
31143,905,1,3,1,5,2,2,3.0,0.0
31145,447853,0,6000,0,7000,1000,1001,6.0,0.0
31147,2333,0,30,0,31,1,2,30.0,0.0
3115,7619,0,54,0,65,11,12,6.0,1.0
31151,655927,1000,8645,1000,10645,2000,1001,8.645,0.0
31152,1908,1,20,1,22,2,2,20.0,0.0
3116,111149,166,995,166,1327,332,167,5.994,0.0
31162,6244,0,61,0,62,1,2,61.0,0.0
31165,263151,301,3889,301,4491,602,302,12.92,0.0
31170,5967,8,40,8,64,24,17,5.0,0.0
3118,805252,500,3106,500,4190,1084,585,6.212,0.5
31184,23477,36,288,36,360,72,37,8.0,0.0
31185,625993,1000,8349,1000,10349,2000,1001,8.349,0.0
31186,22669,61,244,61,366,122,62,4.0,0.0
31187,1137411,1000,13356,1000,17079,3723,2720,13.356,0.0
31188,250961,408,3349,408,4165,816,409,8.208,0.0
3119,45473,35,230,35,309,79,45,6.571,0.0
31190,480524,1000,6000,1000,8000,2000,1001,6.0,0.0
31199,2407442,1000,25844,1000,28844,3000,2001,25.844,0.0
31200,5412265,1000,109425,1000,111425,2000,1001,109.425,0.0
3121,3597,3,19,3,25,6,4,6.333,0.5
3122,1090,1,7,1,9,2,2,7.0,0.0
31233,912077,1000,14495,1000,16495,2000,1001,14.495,0.0
31237,1503068,0,22953,0,23953,1000,1001,22.953,0.0
31238,22547,61,244,61,366,122,62,4.0,1.0
31242,445615,0,5998,0,6998,1000,1001,5.998,0.0
31243,117771,0,1600,0,1920,320,321,5.0,0.0
31244,1516781,1000,23156,1000,25156,2000,1001,23.156,0.0
31247,64807,260,260,260,780,520,261,1.0,0.0
31248,23654,33,297,33,363,66,34,9.0,0.0
31250,796833,0,10320,0,11320,1000,1001,10.32,0.0
31252,145823,588,588,588,1764,1176,589,1.0,0.0
31258,95356,0,1468,0,1530,62,63,23.677,0.0
3126,101105,195,970,195,1360,390,196,4.974,0.0
31274,1875051,1000,28975,1000,30975,2000,1001,28.975,0.0
31276,36020,0,675,0,720,45,46,15.0,0.0
31277,16133,24,192,24,240,48,25,8.0,0.0
31279,1519424,0,23276,0,24276,1000,1001,23.276,0.0
31280,144267,0,1920,0,2304,384,385,5.0,0.0
31281,770831,1000,10578,1000,12578,2000,1001,10.578,0.0
31288,67749,38,1392,38,1468,76,39,36.632,0.0
31289,462958,0,8000,0,9000,1000,1001,8.0,0.0
3129,6863,16,64,16,96,32,17,4.0,0.0
31290,1014788,1000,12763,1000,16003,3240,2230,12.763,0.5
31293,10346,0,140,0,160,20,21,7.0,0.0
31294,1692863,1000,26016,1000,28016,2000,1001,26.016,0.0
31298,1154601,0,15847,0,16847,1000,1001,15.847,0.0
31299,3551,12,12,12,36,24,13,1.0,0.0
31300,665256,1000,9656,1000,11656,2000,1001,9.656,0.0
31302,2382718,1000,34000,1000,36000,2000,1001,34.0,0.0
31303,247587,1000,1000,1000,3000,2000,1001,1.0,0.0
31305,106887,0,1633,0,1704,71,72,23.0,0.0
31306,38791,0,576,0,640,64,65,9.0,0.0
31310,40335,49,539,49,637,98,50,11.0,0.0
31312,698139,0,9000,0,10000,1000,1001,9.0,1.0
3132,3088,0,21,0,24,3,4,7.0,0.0
31320,902852,1000,16009,1000,18009,2000,1001,16.009,0.0
31321,18063,15,312,15,372,60,47,10.4,0.0
31323,150573,94,3348,94,3536,188,95,35.617,0.0
31324,1022429,1000,29000,1000,31000,2000,1001,29.0,0.0
31325,101928,67,1551,67,1685,134,68,23.149,0.0
31328,11102,0,149,0,171,22,23,6.773,0.0
31329,1542600,0,24179,0,25179,1000,1001,24.179,0.0
3133,10523,14,90,14,118,28,15,6.429,0.75
31334,225056,298,3387,298,3983,596,299,11.366,0.0
31336,20840,61,183,61,305,122,62,3.0,0.0
3134,449530,500,6005,500,7005,1000,501,12.01,0.0
31345,1548729,1000,23396,1000,25396,2000,1001,23.396,0.0
31349,22861,21,322,21,364,42,22,15.333,0.0
31350,23978,22,329,22,373,44,23,14.955,0.0
31353,3372066,1000,71587,1000,73587,2000,1001,71.587,0.0
31357,1424783,0,21433,0,22433,1000,1001,21.433,0.0
31359,717844,0,9000,0,10000,1000,1001,9.0,0.75
31371,513610,0,7000,0,8000,1000,1001,7.0,0.0
31372,1594034,1000,24724,1000,26724,2000,1001,24.724,0.0
31373,489554,998,5825,998,7821,1996,999,5.837,0.0
31376,7750,29,29,29,87,58,30,1.0,0.0
31377,31460,24,472,24,520,48,25,19.667,0.0
31381,1525798,1000,23273,1000,25273,2000,1001,23.273,0.0
31383,999332,0,14317,0,15317,1000,1001,14.317,0.0
31384,1594354,1000,35283,1000,37283,2000,1001,35.283,0.0
31385,423863,1000,4000,1000,6000,2000,1001,4.0,0.5
31397,630612,0,9119,0,9602,483,484,18.88,0.0
31398,5305781,1000,109467,1000,111467,2000,1001,109.467,0.0
31401,489817,560,7548,560,8668,1120,561,13.479,0.0
31404,335427,1000,4000,1000,6000,2000,1001,4.0,0.0
31407,194342,180,2368,180,2986,618,439,13.156,0.0
31409,33932,135,135,135,405,270,136,1.0,0.0
3141,201567,320,2905,320,3545,640,321,9.078,0.0
31411,7930608,1000,157838,1000,159838,2000,1001,157.838,0.0
3148,32337,9,63,9,83,20,12,7.0,0.0
3149,66187,86,1008,86,1180,172,87,11.721,0.0
3151,66675,54,869,54,977,108,55,16.093,0.0
31515,151843,0,1792,0,2048,256,257,7.0,0.0
3152,329334,500,4770,500,5770,1000,501,9.54,0.0
3158,294129,500,4000,500,5000,1000,501,8.0,0.0
31587,20915,40,301,40,401,100,60,7.525,0.0
31588,1941,1,21,1,23,2,2,21.0,0.0
3159,391539,500,5801,500,6801,1000,501,11.602,0.0
31592,251588,1000,1000,1000,3000,2000,1001,1.0,0.0
31593,3571,3,45,3,51,6,4,15.0,0.0
31594,247587,1000,1000,1000,3000,2000,1001,1.0,0.0
31595,1406585,1999,26407,1999,30405,3998,2001,13.21,0.0
31597,513898,1000,8000,1000,10000,2000,1001,8.0,0.0
31598,289494,319,5401,319,6199,798,481,16.931,0.0
3160,508278,500,9707,500,10707,1000,501,19.414,0.0
31600,113713,458,458,458,1374,916,459,1.0,0.0
31601,247587,1000,1000,1000,3000,2000,1001,1.0,0.0
31604,247587,1000,1000,1000,3000,2000,1001,1.0,0.0
31605,247587,1000,1000,1000,3000,2000,1001,1.0,0.0
31606,447190,1000,5000,1000,7000,2000,1001,5.0,0.0
31608,1511338,0,23335,0,24335,1000,1001,23.335,0.0
31610,890973,1000,13519,1000,15519,2000,1001,13.519,0.0
31612,6268,23,23,23,69,46,24,1.0,0.0
31613,13167,14,187,14,215,28,15,13.357,0.0
31614,247587,1000,1000,1000,3000,2000,1001,1.0,0.0
31615,247587,1000,1000,1000,3000,2000,1001,1.0,0.0
31616,247587,1000,1000,1000,3000,2000,1001,1.0,0.0
31619,645148,305,11855,305,13075,1220,888,19.434,0.0
31620,247587,1000,1000,1000,3000,2000,1001,1.0,0.0
31621,3506697,1000,33000,1000,35000,2000,1001,33.0,0.0
31622,247587,1000,1000,1000,3000,2000,1001,1.0,0.0
31624,18454,35,211,35,281,70,36,6.029,0.0
31625,11358,18,139,18,184,45,29,7.722,0.0
31626,247587,1000,1000,1000,3000,2000,1001,1.0,0.0
31627,247587,1000,1000,1000,3000,2000,1001,1.0,0.0
31628,251588,1000,1000,1000,3000,2000,1001,1.0,0.0
31629,251588,1000,1000,1000,3000,2000,1001,1.0,0.0
3163,311909,474,4518,474,5466,948,475,9.532,0.0
31630,1531661,0,23575,0,24575,1000,1001,23.575,0.0
31631,1515141,0,23463,0,24463,1000,1001,23.463,0.0
31632,247587,1000,1000,1000,3000,2000,1001,1.0,0.0
31633,5887,0,85,0,88,3,4,28.333,0.0
31634,1317494,1000,20119,1000,22119,2000,1001,20.119,0.0
31635,342245,455,4543,455,5453,910,456,9.985,0.0
31637,67337,66,1294,66,1459,165,101,19.606,0.0
31638,247587,1000,1000,1000,3000,2000,1001,1.0,0.0
31639,1746995,0,27974,0,28974,1000,1001,27.974,0.0
31640,1958417,1000,18854,1000,20854,2000,1001,18.854,0.0
31641,1013117,1000,12759,1000,15986,3227,2218,12.759,0.0
31642,247587,1000,1000,1000,3000,2000,1001,1.0,0.0
31643,247587,1000,1000,1000,3000,2000,1001,1.0,0.0
31644,251588,1000,1000,1000,3000,2000,1001,1.0,0.5
31645,3304,11,11,11,33,22,12,1.0,0.0
31646,473387,0,6000,0,7000,1000,1001,6.0,0.0
31647,247587,1000,1000,1000,3000,2000,1001,1.0,0.0
31648,251588,1000,1000,1000,3000,2000,1001,1.0,0.0
31649,10495,23,92,23,138,46,24,4.0,0.0
31650,1028419,2000,15000,2000,19000,4000,2002,7.5,0.0
31653,2165960,1000,30202,1000,32202,2000,1001,30.202,0.0
31655,854140,1000,11322,1000,13322,2000,1001,11.322,0.0
3166,57636,129,813,129,1071,258,131,6.302,0.0
31660,711173,0,8929,0,9929,1000,1001,8.929,0.0
31665,1685,2,12,2,16,4,3,6.0,0.0
3167,2032,2,14,2,20,6,5,7.0,0.0
31671,15594,21,166,21,208,42,22,7.905,0.0
31676,548151,1000,7000,1000,9000,2000,1001,7.0,0.0
31692,153191,0,1710,0,1995,285,286,6.0,0.0
31695,443081,0,5992,0,6992,1000,1001,5.992,0.0
3170,127139,0,2298,0,2507,209,210,10.995,0.0
31702,448590,0,6000,0,7000,1000,1001,6.0,1.0
31706,405621,0,5001,0,6001,1000,1001,5.001,0.0
31721,1359028,1000,23996,1000,25996,2000,1001,23.996,0.0
31722,239421,338,3380,338,4056,676,339,10.0,0.0
31725,569070,0,10111,0,11111,1000,1001,10.111,0.0
31726,168008,321,2247,321,2889,642,322,7.0,0.0
3173,396521,500,5777,500,6777,1000,501,11.554,0.0
31730,472766,201,2814,201,3216,402,202,14.0,0.0
31736,14139,0,150,0,175,25,26,6.0,0.0
31737,822366,0,14086,0,15086,1000,1001,14.086,0.0
31738,36445,144,144,144,432,288,145,1.0,0.0
31739,594436,0,8683,0,9683,1000,1001,8.683,0.0
3175,22076,19,95,19,183,88,70,5.0,0.0
31758,21453920,358,7864,358,8580,716,359,21.966,0.0
31766,150014,0,1674,0,1953,279,280,6.0,0.0
31767,5884,12,76,12,100,24,13,6.333,0.0
31769,5477,6,72,6,84,12,7,12.0,0.0
3177,439610,337,2414,337,3111,697,361,7.163,0.75
31774,422174,411,4182,411,5414,1232,795,10.175,0.5
31777,172044,0,2343,0,2463,120,121,19.525,0.0
31779,247589,0,1000,0,2000,1000,1001,1.0,0.0
31781,901880,0,15835,0,16835,1000,1001,15.835,0.0
31782,76906,155,928,155,1238,310,156,5.987,0.0
31786,814139,408,9462,408,10278,816,409,23.191,0.0
31788,18668,14,253,14,295,42,30,9.036,0.0
31795,249589,1000,1000,1000,3000,2000,1001,1.0,0.0
31797,12979189,1000,9000,1000,11000,2000,1001,9.0,0.0
31800,441802,1000,5000,1000,7000,2000,1001,5.0,0.0
31802,14732,0,178,0,190,12,13,14.833,0.0
31813,8044,8,88,8,104,16,9,11.0,0.0
31814,249589,1000,1000,1000,3000,2000,1001,1.0,0.0
31819,1092057,2000,17369,2000,21369,4000,2002,8.684,0.5
3182,614472,0,3255,0,3781,526,527,6.51,0.5
31820,156251,135,2023,135,2428,405,272,7.493,0.0
3183,2383,0,23,0,27,4,5,5.75,1.0
31830,26572,48,336,48,432,96,49,7.0,0.0
31834,1585,4,4,4,12,8,5,1.0,0.0
3184,8495,0,140,0,145,5,6,28.0,0.0
31845,43851,0,464,0,580,116,117,4.0,0.0
31847,2613,4,20,4,28,8,5,5.0,0.0
3185,240579,500,2968,500,3968,1000,501,5.936,0.0
31850,16187,44,176,44,264,88,45,4.0,0.5
31854,24548,0,275,0,330,55,56,5.0,0.0
31855,224156,0,2740,0,3288,548,549,5.0,0.0
31856,24563,35,315,35,385,70,36,9.0,0.0
31858,21472,29,232,29,290,58,30,8.0,0.0
3186,67272,0,880,0,960,80,81,11.0,0.5
31860,627386,0,10205,0,11205,1000,1001,10.205,0.5
31861,189424,430,1290,430,2150,860,431,3.0,0.0
31863,651035,0,12000,0,13000,1000,1001,12.0,0.0
31864,479994,0,6000,0,7000,1000,1001,6.0,0.5
31865,79113,0,924,0,1078,154,155,6.0,0.0
31868,660174,0,12000,0,13000,1000,1001,12.0,0.0
31869,800279,0,14067,0,15067,1000,1001,14.067,0.0
31870,35084,82,488,82,652,164,83,5.951,0.0
31872,4963,0,48,0,60,12,13,4.0,0.0
31874,872046,1000,9879,1000,12879,3000,1908,9.879,0.0
31876,94784,122,1506,122,1750,244,123,12.344,0.0
31877,177924,0,3071,0,3193,122,123,25.172,0.5
31879,6830,18,54,18,90,36,19,3.0,0.0
3188,444435,0,6174,0,6674,500,501,12.348,0.5
31881,11545,44,44,44,132,88,45,1.0,0.5
31882,42105,0,440,0,528,88,89,5.0,0.0
31883,485635,0,6050,0,7050,1000,1001,6.05,0.0
31884,467329,0,6256,0,7256,1000,1001,6.256,0.0
31888,1060050,0,18365,0,19365,1000,1001,18.365,0.5
31889,247589,0,1000,0,2000,1000,1001,1.0,0.0
3189,1404,2,8,2,12,4,3,4.0,0.0
31890,486114,0,6000,0,7000,1000,1001,6.0,0.0
31891,76367,187,743,187,1117,374,188,3.973,0.0
31892,39393,0,420,0,504,84,85,5.0,0.0
31893,249589,1000,1000,1000,3000,2000,1001,1.0,0.0
31894,367914,501,5002,501,6004,1002,502,9.984,0.0
31895,853757,1000,11982,1000,13982,2000,1001,11.982,1.0
31897,523213,0,7292,0,8292,1000,1001,7.292,0.0
31898,652023,0,12000,0,13000,1000,1001,12.0,0.0
31899,16857,0,90,0,126,36,20,5.0,0.0
3190,45607,55,601,55,711,110,56,10.927,0.0
31900,221643,0,3056,0,3512,456,457,6.702,0.0
31905,73312,139,1175,139,1524,349,209,8.453,0.0
31906,31963,126,126,126,378,252,127,1.0,0.0
31907,805752,0,14961,0,15961,1000,1001,14.961,0.0
3191,4976,0,55,0,60,5,6,11.0,0.0
3192,21732,0,318,0,355,37,38,8.595,0.0
31922,936522,0,11456,0,12456,1000,1001,11.456,0.0
31924,87965,134,1088,134,1356,268,136,8.119,0.0
31925,52455,205,205,205,615,410,206,1.0,0.0
31927,522178,1000,5973,1000,7973,2000,1001,5.973,0.0
31928,153784,279,2221,279,2779,558,280,7.961,0.0
3193,3895,0,44,0,49,5,6,8.8,0.0
31933,875213,0,16982,0,17982,1000,1001,16.982,0.0
31934,662248,0,12000,0,13000,1000,1001,12.0,0.0
31936,253590,1000,1000,1000,3000,2000,1001,1.0,0.0
31937,149509,220,1754,220,2194,440,221,7.973,0.0
3194,148301,0,3276,0,3319,43,44,76.186,0.5
31942,247589,0,1000,0,2000,1000,1001,1.0,0.5
31943,641424,0,10000,0,11000,1000,1001,10.0,0.5
31946,40767,28,581,28,637,56,29,20.75,0.0
31949,6570,0,65,0,78,13,14,5.0,0.0
3195,1466258,0,18626,0,19626,1000,658,37.252,0.0
31950,49157467,4,32,4,40,8,5,8.0,0.0
31954,249589,1000,1000,1000,3000,2000,1001,1.0,0.0
31956,380764,1000,4000,1000,6000,2000,1001,4.0,0.0
31957,42085,0,168,0,336,168,169,1.0,0.0
31958,801998,0,14039,0,15039,1000,1001,14.039,0.0
31959,258481,0,3276,0,3822,546,547,6.0,0.0
31960,616540,1996,7983,1996,11975,3992,1998,3.999,1.0
31962,528327,0,9000,0,10000,1000,1001,9.0,0.0
31963,587667,992,8915,992,10899,1984,993,8.987,0.5
31964,6662,24,24,24,72,48,25,1.0,0.0
31967,47152,187,187,187,561,374,188,1.0,0.0
31969,2581,8,8,8,24,16,9,1.0,0.0
3197,4814,0,55,0,60,5,6,11.0,0.0
31972,693475,0,12994,0,13994,1000,1001,12.994,0.5
31976,546585,0,8331,0,9331,1000,1001,8.331,0.0
31977,95511,206,1030,206,1442,412,207,5.0,0.0
31979,424087,750,7587,750,9087,1500,751,10.116,0.0
3198,49997,0,652,0,678,26,27,25.077,0.0
31981,307813,0,5041,0,5369,328,329,15.369,0.0
31982,25141,0,300,0,350,50,51,6.0,0.0
31985,253590,1000,1000,1000,3000,2000,1001,1.0,0.0
31986,16839,14,239,14,281,42,30,8.536,0.0
31988,752378,0,13605,0,14605,1000,1001,13.605,0.0
3199,18238,0,246,0,273,27,28,9.111,0.0
31990,661306,0,12000,0,13000,1000,1001,12.0,0.0
31992,731484,0,8000,0,9000,1000,1001,8.0,0.5
31995,2333384,0,32965,0,33965,1000,1001,32.965,0.0
31997,21054,0,216,0,270,54,55,4.0,0.0
31999,740346,0,12988,0,13988,1000,1001,12.988,1.0
3200,108818,225,1268,225,1718,450,226,5.636,0.0
32005,72503,205,820,205,1230,410,206,4.0,0.0
32006,409500,726,7318,726,8770,1452,727,10.08,0.0
32008,648861,0,12000,0,13000,1000,1001,12.0,0.0
32009,2559,5,20,5,30,10,6,4.0,0.0
3201,41591,0,646,0,718,72,73,8.972,0.0
32010,30723,0,122,0,244,122,123,1.0,0.0
32011,770739,1000,7832,1000,9832,2000,1001,7.832,0.5
32015,4891,17,17,17,51,34,18,1.0,0.5
3202,49565,55,600,55,710,110,56,10.909,0.0
32023,23399,28,335,28,419,84,58,5.982,0.0
32028,650053,0,12000,0,13000,1000,1001,12.0,0.0
32029,177180,292,1752,292,2336,584,293,6.0,1.0
3203,14593,0,119,0,126,7,8,17.0,0.0
32033,4784,0,25,0,34,9,10,2.778,0.0
32034,353572,792,4743,792,6327,1584,793,5.989,0.0
32035,247589,0,1000,0,2000,1000,1001,1.0,0.0
32037,39321,88,440,88,616,176,89,5.0,0.0
3204,235429,500,2815,500,3815,1000,501,5.63,0.0
32042,799834,0,14992,0,15992,1000,1001,14.992,0.0
32043,2867009,0,58490,0,59490,1000,1001,58.49,0.0
32044,4573,16,16,16,48,32,17,1.0,0.0
32046,529338,0,5769,0,6769,1000,1001,5.769,0.0
32047,144685,205,1627,205,2037,410,206,7.937,0.0
32048,29398,75,225,75,375,150,76,3.0,0.0
32049,18126,0,71,0,142,71,72,1.0,0.0
3205,4142,0,38,0,47,9,10,4.222,0.0
32050,34764,85,340,85,510,170,86,4.0,0.5
32051,60551,237,237,237,711,474,238,1.0,0.0
32052,11761,0,120,0,144,24,25,5.0,0.0
32055,23200,0,300,0,310,10,11,30.0,0.0
32056,8955,0,100,0,120,20,21,5.0,0.0
32058,455319,0,4795,0,5754,959,960,5.0,0.0
32059,34911,67,335,67,469,134,68,5.0,1.0
3206,7619,0,84,0,96,12,13,7.0,0.0
3207,26289,12,595,12,619,24,13,49.583,0.0
3208,13129,0,182,0,208,26,27,7.0,0.0
3209,24697,0,353,0,397,44,45,8.023,0.0
3210,844975,500,16305,500,17305,1000,501,32.61,0.0
3211,17516,0,302,0,328,26,27,11.615,1.0
3212,23764,0,375,0,400,25,26,15.0,0.0
3213,341722,500,5000,500,6000,1000,501,10.0,0.0
3214,6145,0,27,0,45,18,19,3.0,1.0
32141,534839,0,8000,0,9000,1000,1001,8.0,0.5
3215,231206,500,2695,500,3695,1000,501,5.39,0.0
3216,2197,4,16,4,24,8,5,4.0,0.0
32166,541543,1000,8000,1000,10000,2000,1001,8.0,0.5
32168,823126,1000,7760,1000,9760,2000,1001,7.76,0.5
3217,231983,500,2778,500,3778,1000,501,5.556,0.0
3218,238392,500,2808,500,3808,1000,501,5.616,0.5
3219,519618,156,5304,156,5616,312,157,34.0,0.0
3220,6752,0,80,0,90,10,11,8.0,0.0
32201,12021,30,115,30,175,60,31,3.833,0.0
32206,433145,0,5989,0,6989,1000,1001,5.989,0.5
32209,544341,1000,8000,1000,10000,2000,1001,8.0,0.0
3221,685229,0,9670,0,10170,500,501,19.34,0.75
32210,495513,0,8977,0,9601,624,625,14.386,0.0
32211,661620,0,12000,0,13000,1000,1001,12.0,0.0
32212,712004,0,12332,0,13332,1000,1001,12.332,0.0
32213,21421,0,264,0,308,44,45,6.0,0.0
32214,554947,1000,8590,1000,10590,2000,1001,8.59,0.0
32215,44786,96,480,96,672,192,97,5.0,0.0
32216,1585,4,4,4,12,8,5,1.0,0.0
32217,129778,122,2190,122,2434,244,123,17.951,0.0
32218,245485,0,2653,0,3033,380,381,6.982,0.0
32219,227179,910,910,910,2730,1820,911,1.0,1.0
3222,1395,2,8,2,12,4,3,4.0,0.0
32220,10621,0,122,0,132,10,11,12.2,0.0
32222,912,1,2,1,4,2,2,2.0,0.0
32223,10642,13,128,13,154,26,14,9.846,0.0
32224,249589,1000,1000,1000,3000,2000,1001,1.0,0.0
32225,821617,0,15000,0,16000,1000,1001,15.0,0.0
32226,54929,0,220,0,440,220,221,1.0,0.0
32227,812442,0,7840,0,8840,1000,1001,7.84,0.0
32228,1585,4,4,4,12,8,5,1.0,0.0
32229,19265,44,220,44,308,88,45,5.0,0.5
3223,16518,0,125,0,140,15,16,8.333,0.0
32230,9728,0,37,0,74,37,38,1.0,0.0
32231,35377,37,410,37,521,111,76,5.541,0.0
32232,654241,0,12000,0,13000,1000,1001,12.0,0.0
32233,24425,0,258,0,268,10,11,25.8,0.0
32234,249589,1000,1000,1000,3000,2000,1001,1.0,0.0
32235,247589,0,1000,0,2000,1000,1001,1.0,1.0
32236,403589,0,5000,0,6000,1000,1001,5.0,0.5
32237,23473,0,330,0,367,37,38,8.919,0.0
32238,13609,0,145,0,155,10,11,14.5,0.0
32242,64797,0,880,0,990,110,111,8.0,0.0
32243,7505,0,28,0,56,28,29,1.0,1.0
32244,562116,0,9229,0,10229,1000,1001,9.229,0.0
32245,2614,8,8,8,24,16,9,1.0,1.0
32247,5775,8,64,8,80,16,9,8.0,0.0
32248,22312,0,212,0,222,10,11,21.2,0.5
32249,57113,0,227,0,454,227,228,1.0,0.0
3225,33907,0,288,0,384,96,97,3.0,0.5
32250,565590,1000,7707,1000,9707,2000,1001,7.707,0.5
32251,3893,6,42,6,54,12,7,7.0,0.0
32252,15770,60,60,60,180,120,61,1.0,0.0
32253,400589,0,5000,0,6000,1000,1001,5.0,0.5
32254,22501,88,88,88,264,176,89,1.0,0.0
32255,103814,408,408,408,1224,816,409,1.0,0.0
32257,706433,0,12329,0,13329,1000,1001,12.329,0.0
32258,24301,0,96,0,192,96,97,1.0,0.0
32259,436043,0,5990,0,6990,1000,1001,5.99,0.5
3226,229475,500,2758,500,3758,1000,501,5.516,0.0
32260,732273,0,7996,0,8996,1000,1001,7.996,0.0
32261,181575,0,2604,0,3038,434,435,6.0,0.0
32264,6296,0,65,0,78,13,14,5.0,0.0
32265,409589,0,5000,0,6000,1000,1001,5.0,0.5
32266,212760,530,1982,530,3042,1060,531,3.74,0.0
32267,308984,722,4332,722,5776,1444,723,6.0,0.0
32269,437589,0,6000,0,7000,1000,1001,6.0,0.0
3227,23778,0,375,0,400,25,26,15.0,0.0
32270,249589,1000,1000,1000,3000,2000,1001,1.0,0.0
32271,17644,0,177,0,187,10,11,17.7,0.0
32272,429208,0,5868,0,6868,1000,1001,5.868,0.0
32273,397196,0,8531,0,9101,570,571,14.967,0.0
32274,464416,0,6313,0,7313,1000,1001,6.313,1.0
32275,384253,504,3916,504,4924,1008,505,7.77,0.0
32276,438242,1000,5957,1000,7957,2000,1001,5.957,0.0
32277,247589,0,1000,0,2000,1000,1001,1.0,0.0
32279,5431,11,44,11,66,22,12,4.0,0.75
3228,19653,12,336,12,360,24,13,28.0,0.0
32280,253590,1000,1000,1000,3000,2000,1001,1.0,0.0
32281,19931,0,240,0,280,40,41,6.0,1.0
32283,247589,0,1000,0,2000,1000,1001,1.0,0.0
32286,433228,0,5987,0,6987,1000,1001,5.987,0.5
32287,716289,0,12355,0,13355,1000,1001,12.355,0.0
32288,425683,1000,5589,1000,7589,2000,1001,5.589,0.0
32289,438981,0,5995,0,6995,1000,1001,5.995,0.0
3229,7413,0,42,0,56,14,15,3.0,0.0
32290,18216,0,176,0,218,42,43,4.19,0.0
32291,9728,0,37,0,74,37,38,1.0,0.0
32294,8538,12,71,12,95,24,13,5.917,0.0
32297,249590,0,1000,0,2000,1000,1001,1.0,0.5
32298,2084,0,6,0,12,6,7,1.0,0.0
32299,48507,0,194,0,388,194,195,1.0,0.0
3230,13998,0,200,0,225,25,26,8.0,0.0
32300,12637,0,112,0,140,28,29,4.0,0.0
32301,2581,8,8,8,24,16,9,1.0,0.5
32304,58358,0,232,0,464,232,233,1.0,0.0
32306,2779,0,24,0,30,6,7,4.0,0.0
3231,327299,0,4000,0,4500,500,501,8.0,0.0
32311,436266,0,5995,0,6995,1000,1001,5.995,0.0
32312,247589,0,1000,0,2000,1000,1001,1.0,1.0
32314,369667,504,3712,504,4720,1008,505,7.365,0.0
32317,6232,0,65,0,78,13,14,5.0,0.0
32318,15514,35,140,35,210,70,36,4.0,0.0
32319,33412,0,450,0,525,75,76,6.0,0.0
3232,26220,55,220,55,330,110,56,4.0,0.0
32321,247589,0,1000,0,2000,1000,1001,1.0,0.5
32327,249589,1000,1000,1000,3000,2000,1001,1.0,0.0
32328,6567,0,65,0,78,13,14,5.0,0.0
3233,48383,54,484,54,592,108,55,8.963,1.0
32331,11457,0,44,0,88,44,45,1.0,0.0
32335,249589,1000,1000,1000,3000,2000,1001,1.0,0.0
32339,33590,52,416,52,520,104,53,8.0,0.0
3234,182286,0,824,0,927,103,104,8.0,0.0
32342,219709,880,880,880,2640,1760,881,1.0,0.0
32347,26673,39,350,39,428,78,40,8.974,0.5
3235,141637,46,1781,46,1873,92,47,38.717,0.0
32351,247589,0,1000,0,2000,1000,1001,1.0,0.0
32355,806589,1000,14000,1000,16000,2000,1001,14.0,0.0
3236,10437,20,116,20,156,40,21,5.8,0.0
32368,247589,0,1000,0,2000,1000,1001,1.0,1.0
3237,7756,0,55,0,61,6,7,9.167,0.0
32377,6184,0,65,0,78,13,14,5.0,0.0
32382,249589,1000,1000,1000,3000,2000,1001,1.0,0.5
32388,10546,13,128,13,154,26,14,9.846,0.0
32389,25042,0,99,0,198,99,100,1.0,0.5
3239,29521,0,409,0,464,55,56,7.436,0.0
32398,37886,0,151,0,302,151,152,1.0,0.0
32399,50389,200,200,200,600,400,201,1.0,0.0
3240,17164,0,247,0,268,21,22,11.762,0.0
32400,51224,0,205,0,410,205,206,1.0,0.5
32403,6686,0,65,0,78,13,14,5.0,0.0
32406,249590,0,1000,0,2000,1000,1001,1.0,0.0
32408,247589,0,1000,0,2000,1000,1001,1.0,0.0
3241,7170,0,73,0,79,6,7,12.167,0.0
32411,135451,0,546,0,1092,546,547,1.0,0.0
32412,253590,1000,1000,1000,3000,2000,1001,1.0,0.0
32415,247589,0,1000,0,2000,1000,1001,1.0,0.0
32416,247589,0,1000,0,2000,1000,1001,1.0,0.0
32417,6502,0,65,0,78,13,14,5.0,0.0
32418,6258,0,65,0,78,13,14,5.0,0.0
32421,6384,0,65,0,78,13,14,5.0,0.0
32422,6296,0,65,0,78,13,14,5.0,0.0
32423,32946,0,131,0,262,131,132,1.0,0.0
32427,18237,0,195,0,234,39,40,5.0,0.0
32428,249589,1000,1000,1000,3000,2000,1001,1.0,0.0
3243,14261,0,139,0,152,13,14,10.692,0.5
32430,6400,0,65,0,78,13,14,5.0,0.0
32431,249590,0,1000,0,2000,1000,1001,1.0,0.5
32433,247589,0,1000,0,2000,1000,1001,1.0,0.0
32436,61346,0,244,0,488,244,245,1.0,0.0
32438,6199,0,65,0,78,13,14,5.0,0.0
3244,120823,250,1500,250,2000,500,251,6.0,0.0
32446,6555,0,65,0,78,13,14,5.0,0.0
32447,6348,0,65,0,78,13,14,5.0,0.0
32448,7245414,670,5216,670,6556,1340,671,7.785,0.0
32449,247589,0,1000,0,2000,1000,1001,1.0,1.0
3245,27353,0,225,0,250,25,26,9.0,0.0
32451,6226,0,65,0,78,13,14,5.0,0.0
32452,247589,0,1000,0,2000,1000,1001,1.0,0.0
3246,23273,0,375,0,400,25,26,15.0,0.0
32460,247589,0,1000,0,2000,1000,1001,1.0,1.0
32465,249589,1000,1000,1000,3000,2000,1001,1.0,0.0
32466,247589,0,1000,0,2000,1000,1001,1.0,0.0
32467,247589,0,1000,0,2000,1000,1001,1.0,0.0
32469,801589,1000,14000,1000,16000,2000,1001,14.0,0.0
3247,4629,7,63,7,77,14,8,9.0,0.0
32470,247589,0,1000,0,2000,1000,1001,1.0,0.0
32471,21374,42,292,42,376,84,43,6.952,0.0
32472,809589,1000,14000,1000,16000,2000,1001,14.0,0.5
32473,247589,0,1000,0,2000,1000,1001,1.0,1.0
32474,249590,0,1000,0,2000,1000,1001,1.0,0.0
32475,247589,0,1000,0,2000,1000,1001,1.0,0.0
32476,10963,0,42,0,84,42,43,1.0,0.0
32477,247589,0,1000,0,2000,1000,1001,1.0,0.0
32478,247589,0,1000,0,2000,1000,1001,1.0,0.0
32479,247589,0,1000,0,2000,1000,1001,1.0,1.0
3248,9343,0,86,0,92,6,7,14.333,0.0
32481,249590,0,1000,0,2000,1000,1001,1.0,0.0
32482,247589,0,1000,0,2000,1000,1001,1.0,0.0
32483,9071,25,75,25,125,50,26,3.0,0.0
32487,247589,0,1000,0,2000,1000,1001,1.0,0.0
3249,20452,28,238,28,294,56,29,8.5,0.0
32490,247589,0,1000,0,2000,1000,1001,1.0,0.0
32491,41838,0,167,0,334,167,168,1.0,0.0
32494,371692,1000,3952,1000,5952,2000,1001,3.952,0.0
32495,249590,0,1000,0,2000,1000,1001,1.0,0.0
32496,836,0,1,0,2,1,2,1.0,0.0
32497,27450,60,288,60,408,120,61,4.8,0.6666666666666666
32498,6815,0,25,0,50,25,26,1.0,0.0
3250,22342,0,273,0,312,39,40,7.0,0.0
32500,87533,0,352,0,704,352,353,1.0,0.0
32501,3329,0,11,0,22,11,12,1.0,0.0
32502,249589,1000,1000,1000,3000,2000,1001,1.0,0.0
32503,102181,408,408,408,1224,816,409,1.0,0.0
32504,1577,0,4,0,8,4,5,1.0,0.0
32505,87533,0,352,0,704,352,353,1.0,0.0
32506,6566,0,24,0,48,24,25,1.0,0.0
32507,15529,60,60,60,180,120,61,1.0,0.75
32508,35914,54,442,54,550,108,55,8.185,0.0
32509,88238,0,352,0,704,352,353,1.0,0.0
3251,35109,0,480,0,540,60,61,8.0,0.0
32510,233757,0,944,0,1888,944,945,1.0,0.0
32511,102181,408,408,408,1224,816,409,1.0,0.0
32512,233757,0,944,0,1888,944,945,1.0,0.0
32513,154275,208,2303,208,2719,416,209,11.072,0.0
32514,103814,408,408,408,1224,816,409,1.0,0.0
32515,56744,135,540,135,810,270,136,4.0,0.75
32516,135945,0,548,0,1096,548,549,1.0,0.0
32517,16891,0,66,0,132,66,67,1.0,0.0
32518,233757,0,944,0,1888,944,945,1.0,0.0
3252,21660,0,329,0,356,27,28,12.185,0.0
3254,1441184,0,18525,0,19525,1000,615,37.05,0.0
3255,110892,0,1355,0,1626,271,272,5.0,0.0
32554,453632,598,6459,598,7655,1196,599,10.801,0.5
32555,717000,1000,8963,1000,10963,2000,1001,8.963,0.0
32556,22456,41,217,41,299,82,42,5.293,0.0
32557,135601,253,1518,253,2024,506,254,6.0,0.0
32558,2226433,656,34202,656,35723,1521,753,52.137,0.0
32559,275170,517,2554,517,3588,1034,518,4.94,0.0
3256,24482,60,240,60,360,120,62,4.0,0.0
32561,11307,16,129,16,161,32,17,8.062,0.0
32562,14603,22,154,22,198,44,23,7.0,0.0
32563,23219,22,308,22,352,44,23,14.0,0.0
32565,6583,9,72,9,90,18,10,8.0,0.0
32566,40199,62,528,62,652,124,63,8.516,0.0
32567,46922,69,619,69,757,138,70,8.971,0.0
32570,30981,65,260,65,390,130,66,4.0,0.0
32571,5781,12,48,12,72,24,13,4.0,0.0
32572,142344,239,2061,239,2539,478,240,8.623,0.0
32573,34477,40,400,40,480,80,41,10.0,0.0
32574,5548,7,63,7,77,14,8,9.0,0.0
32575,16454,25,250,25,300,50,26,10.0,0.0
32576,2620667,993,37603,993,40405,2802,1094,37.868,0.0
32577,3332,4,36,4,44,8,5,9.0,0.0
32578,2073252,517,31432,517,32905,1473,618,60.797,0.0
32580,2524,3,24,3,30,6,4,8.0,0.0
32581,10329,15,118,15,148,30,16,7.867,0.0
32582,29543,40,400,40,480,80,41,10.0,0.0
32584,24835,39,297,39,375,78,40,7.615,0.0
32585,30443,49,407,49,505,98,50,8.306,0.0
32587,11120,19,158,19,196,38,20,8.316,0.0
32588,104964,147,1701,147,1995,294,148,11.571,0.0
32589,24049,40,240,40,320,80,41,6.0,0.0
3259,234035,76,1520,76,1672,152,77,20.0,0.0
32590,2231885,1000,32854,1000,35475,2621,1048,32.854,0.0
32591,4297,6,60,6,72,12,7,10.0,0.0
32592,50082,51,763,51,865,102,52,14.961,0.0
32593,10515,15,162,15,192,30,16,10.8,0.0
32598,23582,37,299,37,373,74,38,8.081,0.0
32599,698656,1000,10000,1000,12000,2000,1001,10.0,0.0
3260,14408,32,158,32,222,64,33,4.938,1.0
32601,1807,2,13,2,17,4,3,6.5,0.0
32602,1856,2,16,2,20,4,3,8.0,0.0
32603,51266,58,785,58,901,116,59,13.534,0.0
32607,6672,9,72,9,90,18,10,8.0,0.0
3261,11698,19,123,19,161,38,20,6.474,0.0
32613,26454,42,355,42,439,84,43,8.452,0.0
32615,25220,31,403,31,465,62,32,13.0,0.0
32616,42008,62,558,62,682,124,63,9.0,0.0
32618,10004,15,105,15,135,30,16,7.0,0.0
3262,250685,500,3000,500,4000,1000,501,6.0,0.0
32620,12120,16,144,16,176,32,17,9.0,0.0
32621,15583,19,243,19,281,38,20,12.789,0.0
32622,5164,7,56,7,70,14,8,8.0,0.0
32623,9399,14,140,14,168,28,15,10.0,0.0
32624,3315,4,36,4,44,8,5,9.0,0.0
32625,1505,2,8,2,12,4,3,4.0,0.0
32627,16141,24,235,24,283,48,25,9.792,0.0
32631,5385,11,44,11,66,22,12,4.0,0.0
32632,785368,1000,11769,1000,13769,2000,1001,11.769,0.0
32633,600152,1000,8000,1000,10000,2000,1001,8.0,0.0
32634,597606,1000,8000,1000,10000,2000,1001,8.0,0.0
32635,695653,1000,9383,1000,11383,2000,1001,9.383,0.0
32636,1033734,1000,16238,1000,18238,2000,1001,16.238,0.0
32637,838850,1000,16000,1000,18000,2000,1001,16.0,0.0
32639,466040,1000,6902,1000,8902,2000,1001,6.902,0.0
32640,901277,1000,18791,1000,20791,2000,1001,18.791,0.0
32641,499919,1000,7955,1000,9955,2000,1001,7.955,0.0
32642,498358,1000,8000,1000,10000,2000,1001,8.0,0.0
32644,167471,326,2282,326,2934,652,327,7.0,0.0
32645,623058,1000,10120,1000,12120,2000,1001,10.12,0.0
32648,474172,1000,7329,1000,9329,2000,1001,7.329,0.0
32649,88957,326,326,326,978,652,327,1.0,0.0
32650,275612,1000,1000,1000,3000,2000,1001,1.0,0.0
32653,3193649,1000,60101,1000,62101,2000,1001,60.101,0.0
32654,346229,1000,3000,1000,5000,2000,1001,3.0,1.0
32658,603709,1000,10000,1000,12000,2000,1001,10.0,0.5
3266,683527,500,13000,500,14000,1000,501,26.0,0.0
32662,459251,1000,6000,1000,8000,2000,1001,6.0,0.0
32664,271611,1000,1000,1000,3000,2000,1001,1.0,0.0
32665,353242,546,5778,546,6870,1092,547,10.582,1.0
32667,271611,1000,1000,1000,3000,2000,1001,1.0,0.0
32668,390133,908,5445,908,7261,1816,909,5.997,0.0
3267,115098,190,1140,190,1520,380,191,6.0,0.0
32671,271611,1000,1000,1000,3000,2000,1001,1.0,0.0
32673,271611,1000,1000,1000,3000,2000,1001,1.0,0.0
32675,495100,1000,7000,1000,9000,2000,1001,7.0,0.0
32676,920585,1000,16000,1000,18000,2000,1001,16.0,0.0
32677,559719,1000,7912,1000,9912,2000,1001,7.912,0.0
3268,4544,7,41,7,55,14,8,5.857,0.0
32680,540432,1000,9000,1000,11000,2000,1001,9.0,0.0
32681,597234,1000,7111,1000,9111,2000,1001,7.111,0.0
32682,635147,1000,10987,1000,12987,2000,1001,10.987,0.0
32684,271611,1000,1000,1000,3000,2000,1001,1.0,0.0
32687,275612,1000,1000,1000,3000,2000,1001,1.0,0.0
32688,491592,1000,8000,1000,10000,2000,1001,8.0,0.0
32689,565511,1000,10018,1000,12018,2000,1001,10.018,0.0
3269,107949,199,1194,199,1592,398,200,6.0,0.0
32691,7792,16,80,16,112,32,17,5.0,0.0
32693,3050,9,9,9,27,18,10,1.0,0.0
32699,271611,1000,1000,1000,3000,2000,1001,1.0,0.0
3270,72091,130,780,130,1040,260,131,6.0,0.5
32700,275612,1000,1000,1000,3000,2000,1001,1.0,0.0
32705,250406,0,3912,0,4238,326,327,12.0,0.0
32706,571629,1000,9000,1000,11000,2000,1001,9.0,0.0
3271,12240,22,132,22,176,44,23,6.0,0.0
32718,212507,322,2898,322,3542,644,323,9.0,0.0
3272,251528,500,3000,500,4000,1000,501,6.0,1.0
32720,271611,1000,1000,1000,3000,2000,1001,1.0,0.0
32728,570830,1000,9000,1000,11000,2000,1001,9.0,0.0
3273,18426,0,308,0,319,11,12,28.0,0.0
32731,271611,1000,1000,1000,3000,2000,1001,1.0,0.0
3274,18448,11,308,11,330,22,12,28.0,0.0
32741,7493,9,99,9,117,18,10,11.0,0.0
32746,128212,464,464,464,1392,928,465,1.0,0.0
32747,271611,1000,1000,1000,3000,2000,1001,1.0,0.0
3275,18448,11,308,11,330,22,12,28.0,0.0
32753,271611,1000,1000,1000,3000,2000,1001,1.0,0.0
32755,271611,1000,1000,1000,3000,2000,1001,1.0,0.0
32756,88305,0,326,0,652,326,327,1.0,0.0
32757,277693,644,3208,644,4496,1288,645,4.981,0.0
32758,503065,1000,7895,1000,9895,2000,1001,7.895,0.0
32759,275612,1000,1000,1000,3000,2000,1001,1.0,0.0
3276,45797,65,715,65,845,130,66,11.0,0.5
32760,271611,1000,1000,1000,3000,2000,1001,1.0,0.0
32761,554176,1000,7000,1000,9000,2000,1001,7.0,0.0
32763,271611,1000,1000,1000,3000,2000,1001,1.0,0.0
32764,214908,504,2520,504,3528,1008,505,5.0,0.0
32766,271611,1000,1000,1000,3000,2000,1001,1.0,0.0
32767,25543,92,92,92,276,184,93,1.0,0.0
32768,49601,126,504,126,756,252,127,4.0,0.0
32769,6864,10,80,10,100,20,11,8.0,0.5
3277,1022882,391,7000,391,7782,782,392,17.903,0.0
32770,15787,56,56,56,168,112,57,1.0,0.0
32771,473516,0,5604,0,6604,1000,1001,5.604,0.5
32773,271611,1000,1000,1000,3000,2000,1001,1.0,0.0
32775,503217,1000,7898,1000,9898,2000,1001,7.898,0.0
32777,271611,1000,1000,1000,3000,2000,1001,1.0,0.0
32779,271611,1000,1000,1000,3000,2000,1001,1.0,0.0
32780,271611,1000,1000,1000,3000,2000,1001,1.0,0.0
32781,271611,1000,1000,1000,3000,2000,1001,1.0,0.0
32784,25543,92,92,92,276,184,93,1.0,0.0
32786,275612,1000,1000,1000,3000,2000,1001,1.0,0.0
32787,25543,92,92,92,276,184,93,1.0,0.0
32788,287522,714,3570,714,4998,1428,715,5.0,0.0
3279,472043,500,7489,500,8489,1000,501,14.978,0.0
32790,271611,1000,1000,1000,3000,2000,1001,1.0,0.0
32791,271611,1000,1000,1000,3000,2000,1001,1.0,0.0
32793,8434344,255,1530,255,2040,510,256,6.0,0.0
32794,271611,1000,1000,1000,3000,2000,1001,1.0,0.0
32796,275612,1000,1000,1000,3000,2000,1001,1.0,0.0
32797,271611,1000,1000,1000,3000,2000,1001,1.0,0.0
32799,4157,9,36,9,54,18,10,4.0,0.0
3280,18935,39,195,39,273,78,40,5.0,0.0
32802,275612,1000,1000,1000,3000,2000,1001,1.0,0.0
32804,497514,1000,8010,1000,10010,2000,1001,8.01,0.0
32805,271611,1000,1000,1000,3000,2000,1001,1.0,0.0
32806,275612,1000,1000,1000,3000,2000,1001,1.0,0.5
32808,271611,1000,1000,1000,3000,2000,1001,1.0,0.0
3281,39836,75,450,75,600,150,76,6.0,0.0
32812,271611,1000,1000,1000,3000,2000,1001,1.0,0.0
32813,696361,1000,10995,1000,12995,2000,1001,10.995,0.0
32814,271611,1000,1000,1000,3000,2000,1001,1.0,0.0
32815,25543,92,92,92,276,184,93,1.0,0.5
32818,271611,1000,1000,1000,3000,2000,1001,1.0,0.0
3282,2355,4,18,4,26,8,5,4.5,0.0
32820,271611,1000,1000,1000,3000,2000,1001,1.0,0.0
32822,158150,0,1035,0,1144,109,110,9.495,0.0
32823,271611,1000,1000,1000,3000,2000,1001,1.0,0.0
32825,271611,1000,1000,1000,3000,2000,1001,1.0,0.0
32828,275612,1000,1000,1000,3000,2000,1001,1.0,0.0
32829,271611,1000,1000,1000,3000,2000,1001,1.0,0.0
3283,8402,14,90,14,118,28,15,6.429,0.0
32832,275612,1000,1000,1000,3000,2000,1001,1.0,0.0
32833,15787,56,56,56,168,112,57,1.0,0.0
32835,34757,126,126,126,378,252,127,1.0,0.0
3284,47027,89,534,89,712,178,90,6.0,0.5
32840,481976,1000,6000,1000,8000,2000,1001,6.0,0.0
32843,28795,104,104,104,312,208,105,1.0,0.0
32844,271611,1000,1000,1000,3000,2000,1001,1.0,0.0
32847,275612,1000,1000,1000,3000,2000,1001,1.0,0.0
32848,34473,44,572,44,660,88,45,13.0,0.0
32849,271611,1000,1000,1000,3000,2000,1001,1.0,0.0
3285,960498,500,16000,500,17000,1000,501,32.0,0.0
32850,707339,1000,10994,1000,12994,2000,1001,10.994,0.0
32854,275612,1000,1000,1000,3000,2000,1001,1.0,0.0
32855,439709,0,6000,0,7000,1000,1001,6.0,0.0
32856,166597,408,1632,408,2448,816,409,4.0,0.0
32857,881386,1103,15652,1103,17858,2206,1105,14.19,0.0
32858,1185004,1989,21484,1989,25462,3978,1991,10.801,0.0
32859,34793,130,130,130,390,260,131,1.0,0.0
3286,787008,500,13000,500,14000,1000,501,26.0,0.0
32860,550075,1000,6000,1000,9000,3000,2002,3.0,0.5
32861,952827,0,13000,0,14000,1000,1001,13.0,0.0
32862,263603,1000,1000,1000,3000,2000,1001,1.0,0.5
32863,548675,991,5982,991,8964,2982,1993,3.005,0.5
32864,759981,1000,10190,1000,12190,2000,1001,10.19,0.0
32865,1303392,2000,20466,2000,25466,5000,3002,6.822,0.0
32866,756628,18,9126,18,10162,1036,1020,8.965,0.0
32867,109417,130,1039,130,1299,260,131,7.992,0.5
32868,32644,120,120,120,360,240,121,1.0,0.0
32869,742026,1014,9096,1014,11124,2028,1016,8.97,0.0
3287,33242,14,268,14,296,28,15,19.143,0.5
32870,898823,0,13251,0,14251,1000,1001,13.251,0.0
32871,729841,1000,10000,1000,12000,2000,1001,10.0,0.0
32872,13747,16,182,16,230,48,34,5.688,0.0
32873,735373,1000,10000,1000,12000,2000,1001,10.0,0.0
32874,228342,0,2907,0,2986,79,80,36.797,0.0
32875,141365,140,2128,140,2549,421,283,7.573,0.5
32876,777937,1000,10163,1000,12163,2000,1001,10.163,0.0
32877,18896,0,333,0,337,4,5,83.25,0.5
32878,11130,0,120,0,140,20,21,6.0,0.0
32879,55991,0,600,0,720,120,121,5.0,0.0
32880,45028,0,480,0,560,80,81,6.0,0.0
32881,2349,5,15,5,25,10,6,3.0,0.0
32882,196458,418,2080,418,2916,836,419,4.976,0.0
32883,23249,0,252,0,288,36,37,7.0,0.0
32884,21187,0,240,0,280,40,41,6.0,0.0
32885,3870,3,69,3,75,6,4,23.0,0.0
32886,3906,0,35,0,42,7,8,5.0,0.0
32887,5403,0,60,0,70,10,11,6.0,0.0
32888,5863,20,20,20,60,40,21,1.0,0.0
32889,2092,4,12,4,20,8,5,3.0,0.0
3289,3077,5,28,5,38,10,6,5.6,0.0
32890,31105,0,358,0,430,72,73,4.972,0.0
32891,24733,0,288,0,324,36,37,8.0,0.0
32892,2489,0,20,0,25,5,6,4.0,0.0
32893,7589,0,75,0,90,15,16,5.0,0.0
32894,1655,4,4,4,12,8,5,1.0,0.0
3290,11053,17,102,17,136,34,18,6.0,0.0
32904,29100,56,443,56,555,112,57,7.911,0.0
32907,534128,1000,7511,1000,9511,2000,1001,7.511,0.5
3291,286218,0,4500,0,5000,500,501,9.0,0.0
32917,14536,51,51,51,153,102,52,1.0,0.0
32918,273613,1000,1000,1000,3000,2000,1001,1.0,0.0
3292,229226,0,3500,0,4000,500,501,7.0,0.0
32920,277614,1000,1000,1000,3000,2000,1001,1.0,0.0
32923,16126,56,56,56,168,112,57,1.0,0.0
32927,468749,947,6549,947,8443,1894,948,6.916,0.0
3293,148344,268,2137,268,2673,536,269,7.974,0.0
32933,569922,1000,6000,1000,8000,2000,1001,6.0,0.0
32940,236664,224,4008,224,4456,448,225,17.893,1.0
32942,537379,1000,6930,1000,8930,2000,1001,6.93,0.0
32943,1442867,835,19711,835,21381,1670,836,23.606,0.0
3295,101539,219,1108,219,1617,509,289,5.059,0.0
3296,846125,500,16000,500,17000,1000,501,32.0,0.0
32960,273613,1000,1000,1000,3000,2000,1001,1.0,0.0
3297,766614,500,13000,500,14000,1000,501,26.0,0.0
32974,20269,72,72,72,216,144,73,1.0,0.0
32976,40198,145,145,145,435,290,146,1.0,0.0
32978,11334,14,126,14,154,28,15,9.0,0.0
32979,273613,1000,1000,1000,3000,2000,1001,1.0,0.0
3298,4571,9,38,9,56,18,10,4.222,0.0
32980,59308,215,215,215,645,430,216,1.0,0.0
32982,273613,1000,1000,1000,3000,2000,1001,1.0,0.0
32985,14536,51,51,51,153,102,52,1.0,0.0
32993,90430,329,329,329,987,658,330,1.0,0.0
32996,136294,497,497,497,1491,994,498,1.0,0.0
32997,277614,1000,1000,1000,3000,2000,1001,1.0,0.0
32998,5666,0,40,0,54,14,15,2.857,0.0
3300,56421,104,624,104,832,208,105,6.0,0.5
33003,138283,497,497,497,1491,994,498,1.0,0.0
33004,225583,497,2485,497,3479,994,498,5.0,0.0
33008,40198,145,145,145,435,290,146,1.0,0.0
33009,158953,580,580,580,1740,1160,581,1.0,0.0
3301,44425,83,498,83,664,166,84,6.0,0.0
33010,273613,1000,1000,1000,3000,2000,1001,1.0,0.0
33012,10030,16,127,16,159,32,17,7.938,0.0
33015,1137,1,5,1,7,2,2,5.0,0.0
33016,3889,12,12,12,36,24,13,1.0,0.0
33017,138283,497,497,497,1491,994,498,1.0,0.0
33018,138205,504,504,504,1512,1008,505,1.0,0.0
33019,40198,145,145,145,435,290,146,1.0,0.0
3302,24551,39,234,39,312,78,40,6.0,0.0
33023,4435,14,14,14,42,28,15,1.0,0.0
33024,136294,497,497,497,1491,994,498,1.0,0.0
33029,97528,355,355,355,1065,710,356,1.0,0.0
3303,36672,22,638,22,682,44,23,29.0,0.0
33030,15355,54,54,54,162,108,55,1.0,0.0
33031,9076,31,31,31,93,62,32,1.0,0.0
33033,98949,355,355,355,1065,710,356,1.0,0.0
33035,273613,1000,1000,1000,3000,2000,1001,1.0,0.0
33036,158953,580,580,580,1740,1160,581,1.0,0.0
33039,25183,90,90,90,270,180,91,1.0,0.0
3304,19094,0,308,0,319,11,12,28.0,0.0
33040,105445,384,384,384,1152,768,385,1.0,0.0
33042,1143,1,5,1,7,2,2,5.0,0.0
3305,468232,500,4270,500,5453,1183,677,8.54,0.0
33050,277614,1000,1000,1000,3000,2000,1001,1.0,0.0
33053,1795909,204,2044,204,2452,408,205,10.02,0.0
33056,25183,90,90,90,270,180,91,1.0,0.0
33058,136294,497,497,497,1491,994,498,1.0,0.0
33059,263037,316,4094,316,4726,632,317,12.956,0.0
3306,979198,910,9460,910,11280,1820,912,10.396,1.0
33061,19996,71,71,71,213,142,72,1.0,0.0
33064,411005,980,4900,980,6860,1960,981,5.0,0.0
33065,4981,16,16,16,48,32,17,1.0,0.0
33067,3889,12,12,12,36,24,13,1.0,0.0
33068,136294,497,497,497,1491,994,498,1.0,0.0
33069,136294,497,497,497,1491,994,498,1.0,0.0
3307,425919,500,6000,500,7000,1000,501,12.0,0.0
33076,25183,90,90,90,270,180,91,1.0,0.0
3308,420370,500,6000,500,7000,1000,501,12.0,0.0
33082,4981,16,16,16,48,32,17,1.0,0.0
33083,4981,16,16,16,48,32,17,1.0,0.0
33085,10863,37,37,37,111,74,38,1.0,0.0
33086,114184,410,410,410,1230,820,411,1.0,0.0
33087,31718,41,532,41,614,82,42,12.976,0.0
33088,19682,41,245,41,327,82,42,5.976,0.0
33095,3262,5,40,5,50,10,6,8.0,0.0
33097,19682,41,245,41,327,82,42,5.976,0.0
33098,2232,3,24,3,30,6,4,8.0,0.0
3310,115496,0,1200,0,1440,240,241,5.0,0.0
33103,7522,21,63,21,105,42,22,3.0,0.0
33106,8976,25,75,25,125,50,26,3.0,0.0
33107,3353,7,21,7,35,14,8,3.0,0.0
33108,19847,41,245,41,327,82,42,5.976,0.0
3311,503455,0,9124,0,9624,500,501,18.248,0.0
33111,5448,9,71,9,89,18,10,7.889,0.0
33112,2236,3,24,3,30,6,4,8.0,0.0
33113,1694881,1000,30790,1000,32790,2000,1001,30.79,0.5
33119,3004,0,21,0,28,7,8,3.0,0.0
3312,306471,500,4000,500,5000,1000,501,8.0,1.0
33123,400925,208,8291,208,8707,416,210,39.861,0.0
33129,6858,0,51,0,68,17,18,3.0,0.0
3313,161674,0,1715,0,1960,245,246,7.0,1.0
33130,444130,1000,5000,1000,7000,2000,1001,5.0,0.0
33131,3307,5,40,5,50,10,6,8.0,0.0
33132,3510918,1000,80658,1000,82658,2000,1001,80.658,0.0
33144,2298277,0,36630,0,37630,1000,1001,36.63,0.0
33145,1049203,1955,16489,1955,20399,3910,1957,8.434,0.0
33147,838842,1000,14223,1000,16223,2000,1001,14.223,0.0
33149,1277129,995,20921,995,23911,2990,1997,10.487,0.0
33150,734585,1000,11925,1000,13925,2000,1001,11.925,0.0
33155,1277128,1995,20921,1995,24911,3990,1997,10.487,0.0
33156,515698,1000,5984,1000,7984,2000,1001,5.984,0.0
33160,1281129,1995,20921,1995,24911,3990,1997,10.487,0.0
33161,1277128,1995,20921,1995,24911,3990,1997,10.487,0.0
33162,405836,0,4000,0,5000,1000,1001,4.0,0.0
33167,19656,41,245,41,327,82,42,5.976,0.0
33168,6823,0,51,0,68,17,18,3.0,0.0
3317,589422,500,10105,500,11105,1000,501,20.21,0.0
33174,811443,1000,12270,1000,14270,2000,1001,12.27,0.0
33175,1231992,1000,16234,1000,18234,2000,1001,16.234,0.0
33178,864580,1000,14894,1000,16894,2000,1001,14.894,0.0
33179,1358224,939,24385,939,26263,1878,940,25.969,0.0
3318,101103,0,1320,0,1452,132,133,10.0,0.0
33191,2312383,1000,36878,1000,38878,2000,1001,36.878,0.0
33192,696486,1000,8000,1000,10000,2000,1001,8.0,0.0
33193,998549,0,14030,0,15030,1000,1001,14.03,0.0
3320,122533,0,1380,0,1580,200,201,6.9,0.0
33200,1235,0,6,0,8,2,3,3.0,0.0
33204,105497,134,1732,134,2000,268,135,12.925,0.0
33206,978696,641,17326,641,18608,1282,642,27.03,0.0
33208,21506,45,268,45,358,90,46,5.956,0.0
3321,2789670,0,54994,0,55494,500,501,109.988,0.0
33215,684715,1000,9839,1000,11839,2000,1001,9.839,0.5
33217,677538,1000,8000,1000,10000,2000,1001,8.0,0.0
33219,918356,1000,11999,1000,13999,2000,1001,11.999,0.0
33224,1186277,0,20952,0,21952,1000,1001,20.952,0.0
33228,3512946,2000,73818,2000,77818,4000,2002,36.909,0.0
3323,10991426,0,227487,0,227987,500,501,454.974,0.0
33237,3284963,1998,71249,1998,75245,3996,2000,35.66,0.5
3324,246255,278,2803,278,3359,556,279,10.083,0.0
33244,2197233,1000,48813,1000,50813,2000,1001,48.813,0.0
33246,5219,0,48,0,60,12,13,4.0,0.0
33249,241208,0,3304,0,3717,413,414,8.0,0.0
3325,182809,0,2248,0,2448,200,201,11.24,0.5
33254,1159680,1000,11000,1000,13000,2000,1001,11.0,0.0
33255,686308,1000,9926,1000,11926,2000,1001,9.926,0.0
33257,1113782,1000,11000,1000,13000,2000,1001,11.0,0.5
33258,577330,0,9000,0,10000,1000,1001,9.0,0.0
33259,1111528,1000,11000,1000,13000,2000,1001,11.0,0.5
33265,350776,0,7074,0,7437,363,364,19.488,0.0
33267,377735,396,2772,396,3564,792,397,7.0,1.0
33268,1118802,1000,11000,1000,13000,2000,1001,11.0,0.5
3327,5790,7,105,7,119,14,9,15.0,1.0
33270,1110262,1000,11000,1000,13000,2000,1001,11.0,0.5
33273,1128756,1000,11000,1000,13000,2000,1001,11.0,0.0
33278,32685,78,312,78,468,156,79,4.0,0.0
33279,1113513,1000,11000,1000,13000,2000,1001,11.0,0.5
3328,1985,2,30,2,34,4,4,15.0,0.0
33280,520724,1000,5170,1000,7170,2000,1001,5.17,0.0
33281,26066,45,358,45,448,90,46,7.956,0.0
33282,21506,45,268,45,358,90,46,5.956,0.0
33284,1116289,1000,11000,1000,13000,2000,1001,11.0,0.5
33285,1165621,1000,11000,1000,13000,2000,1001,11.0,0.5
33286,1116777,1000,11000,1000,13000,2000,1001,11.0,0.5
33287,21687,45,268,45,358,90,46,5.956,0.0
33288,1118794,1000,11000,1000,13000,2000,1001,11.0,0.5
3329,451184,11,77,11,99,22,12,7.0,0.0
33290,1590713,0,32000,0,33000,1000,1001,32.0,0.0
33291,257597,1000,1000,1000,3000,2000,1001,1.0,0.0
33292,70285,267,267,267,801,534,268,1.0,0.0
33295,5220,0,48,0,60,12,13,4.0,0.0
33297,1160571,1000,11000,1000,13000,2000,1001,11.0,0.75
33298,255597,0,1000,0,2000,1000,1001,1.0,0.0
33302,2953,2,42,2,46,4,3,21.0,0.0
3331,12685,0,100,0,125,25,26,4.0,0.5
33312,467828,410,6221,410,7041,820,411,15.173,0.0
3333,9397,18,122,18,158,36,20,6.778,0.0
33330,1635,1,18,1,20,2,2,18.0,0.0
3334,5963,7,105,7,119,14,9,15.0,0.0
33345,15403,39,117,39,195,78,40,3.0,0.5
33347,103229,134,1598,134,1866,268,135,11.925,0.0
3335,276644,199,1093,199,1491,398,200,5.492,0.0
33353,124221,317,1585,317,2219,634,318,5.0,0.0
33357,70285,267,267,267,801,534,268,1.0,0.0
33367,1936739,0,42792,0,43792,1000,1001,42.792,0.0
33376,23365,45,313,45,403,90,46,6.956,0.0
33377,1001670,1000,17738,1000,19738,2000,1001,17.738,0.0
3338,775651,0,15500,0,16000,500,501,31.0,0.0
3339,360727,0,6000,0,6500,500,501,12.0,0.0
33394,1717,2,6,2,10,4,3,3.0,0.0
33396,21687,45,268,45,358,90,46,5.956,0.0
33397,737581,488,16170,488,17146,976,489,33.135,0.0
33399,904631,1000,13993,1000,15993,2000,1001,13.993,0.5
3340,6269,0,48,0,60,12,13,4.0,0.0
33406,8976,25,75,25,125,50,26,3.0,0.0
3341,5002,9,59,9,77,18,11,6.556,0.0
33413,1368,1,12,1,14,2,2,12.0,0.0
33414,5862,0,44,0,59,15,16,2.933,0.0
33415,22158,45,268,45,358,90,46,5.956,0.0
33416,19608,45,223,45,313,90,46,4.956,0.0
3342,5957,11,73,11,95,22,13,6.636,0.0
33420,21506,45,268,45,358,90,46,5.956,0.0
33421,17819,0,147,0,196,49,50,3.0,0.0
33423,1553180,0,26084,0,27084,1000,1001,26.084,0.0
33427,103313,200,1196,200,1596,400,201,5.98,0.0
33430,59422,0,576,0,720,144,145,4.0,0.0
33431,5610,15,45,15,75,30,16,3.0,0.0
33433,4966,17,17,17,51,34,18,1.0,0.0
33440,5355,9,62,9,80,18,10,6.889,0.0
33441,25126,0,195,0,260,65,66,3.0,0.0
33447,1240,0,6,0,8,2,3,3.0,0.0
3345,718325,923,9476,923,11322,1846,925,10.267,0.0
33455,22158,45,268,45,358,90,46,5.956,0.0
33457,1321,1,12,1,14,2,2,12.0,0.0
33458,514711,1000,5173,1000,7173,2000,1001,5.173,0.0
3346,5277,0,48,0,56,8,9,6.0,0.0
33464,1806996,1000,41364,1000,43364,2000,1001,41.364,0.0
33472,4696,0,36,0,48,12,13,3.0,0.0
33473,21745,45,268,45,358,90,46,5.956,0.0
33475,1208664,1000,15871,1000,17871,2000,1001,15.871,0.0
33479,2483,0,18,0,24,6,7,3.0,0.0
3348,261798,500,4484,500,5484,1000,501,8.968,0.5
33481,108610,316,948,316,1580,632,317,3.0,0.0
33484,7742,16,80,16,112,32,17,5.0,0.0
33494,80128,89,1386,89,1564,178,90,15.573,0.0
33495,1644972,0,30095,0,31095,1000,1001,30.095,0.5
33502,38807,0,596,0,646,50,51,11.92,0.0
33504,2826,1,36,1,38,2,2,36.0,0.0
33506,816827,1000,11997,1000,13997,2000,1001,11.997,0.0
3351,260517,500,3500,500,4500,1000,501,7.0,0.0
33512,222174,205,2968,205,3378,410,206,14.478,0.0
33515,335260,528,5451,528,6507,1056,530,10.324,0.0
33516,257597,1000,1000,1000,3000,2000,1001,1.0,0.0
33519,1657895,1000,28545,1000,30545,2000,1001,28.545,0.5
3352,5992,13,55,13,81,26,14,4.231,0.0
33520,1655387,1000,28552,1000,30552,2000,1001,28.552,0.0
33522,2209788,1000,49197,1000,51197,2000,1001,49.197,0.0
33526,257597,1000,1000,1000,3000,2000,1001,1.0,0.0
33528,23365,45,313,45,403,90,46,6.956,0.0
3353,90708,164,1148,164,1476,328,165,7.0,0.5
33533,32194,0,273,0,364,91,92,3.0,0.5
33536,3267060,2000,70312,2000,74312,4000,2002,35.156,0.0
33539,1234600,0,16333,0,17333,1000,1001,16.333,0.0
33540,512917,1000,5978,1000,7978,2000,1001,5.978,0.0
33541,4154,10,30,10,50,20,11,3.0,0.0
33545,19983,53,159,53,265,106,54,3.0,0.0
33549,4725,0,35,0,47,12,13,2.917,0.0
3355,3174,0,36,0,42,6,7,6.0,0.0
33553,430342,1000,6093,1000,8093,2000,1001,6.093,0.0
3356,4101,0,24,0,32,8,9,3.0,0.0
33563,5672,0,52,0,65,13,14,4.0,0.0
33564,1109,1,6,1,8,2,2,6.0,0.0
33565,168227,386,1750,386,2522,772,387,4.534,0.0
33568,1045636,1000,19821,1000,21821,2000,1001,19.821,0.0
33569,1114,1,6,1,8,2,2,6.0,0.0
3357,2711,0,30,0,35,5,6,6.0,0.0
33570,1114,1,6,1,8,2,2,6.0,0.0
33571,1273407,1983,20765,1983,24731,3966,1985,10.472,0.0
33578,4324,0,33,0,44,11,12,3.0,0.0
3358,3406,0,45,0,50,5,6,9.0,0.0
3359,23952,10,280,10,300,20,11,28.0,0.0
33594,257597,1000,1000,1000,3000,2000,1001,1.0,0.0
3360,114549,49,1370,49,1468,98,50,27.959,0.0
33600,2287,0,15,0,20,5,6,3.0,0.5
33601,1648310,1000,28112,1000,30112,2000,1001,28.112,0.0
3361,5665,0,48,0,60,12,13,4.0,0.0
33610,581088,423,10540,423,11386,846,424,24.917,0.0
33611,63981,0,555,0,740,185,186,3.0,0.0
3362,5521,0,48,0,60,12,13,4.0,0.0
33624,877382,1000,12000,1000,14000,2000,1001,12.0,0.0
33625,257597,1000,1000,1000,3000,2000,1001,1.0,0.0
33626,6277,0,65,0,78,13,14,5.0,1.0
33627,149722,409,1227,409,2045,818,410,3.0,0.0
3363,754279,295,9145,295,9735,590,296,31.0,0.0
3364,414409,500,4834,500,5834,1000,501,9.668,0.0
33642,322675,748,3571,748,5067,1496,749,4.774,0.0
33645,27615,78,234,78,390,156,79,3.0,0.0
3365,1319241,500,18684,500,19684,1000,501,37.368,0.0
33659,516723,1000,5170,1000,7170,2000,1001,5.17,0.0
3366,19281,0,289,0,320,31,32,9.323,0.0
33668,23139,46,271,46,363,92,47,5.891,0.0
3367,758553,500,4454,500,5867,1413,914,8.908,0.6666666666666666
3368,20166,12,336,12,360,24,13,28.0,0.0
3369,4851,10,40,10,60,20,11,4.0,0.5
33691,9867,23,92,23,138,46,24,4.0,0.0
3370,22732,0,140,0,175,35,36,4.0,0.625
3371,9168,0,88,0,97,9,10,9.778,1.0
33719,23814,46,317,46,409,92,47,6.891,0.0
3372,297718,0,3500,0,4000,500,501,7.0,0.5
33723,26575,46,363,46,455,92,47,7.891,0.0
33725,3288964,1998,71249,1998,75245,3996,2000,35.66,0.0
33732,539592,802,7786,802,9390,1604,803,9.708,0.0
33734,2361,5,15,5,25,10,6,3.0,0.0
33735,648779,1000,8916,1000,10916,2000,1001,8.916,0.0
3374,3295,0,40,0,45,5,6,8.0,0.0
33745,1260468,1000,16943,1000,18943,2000,1001,16.943,1.0
33746,257597,1000,1000,1000,3000,2000,1001,1.0,0.0
33748,241921,0,939,0,1878,939,940,1.0,0.0
3375,349743,500,6401,500,7401,1000,501,12.802,0.0
33754,257597,1000,1000,1000,3000,2000,1001,1.0,0.0
33755,21414,81,81,81,243,162,82,1.0,0.0
33758,1203253,1000,15962,1000,17962,2000,1001,15.962,0.0
3376,246311,40,3724,40,3804,80,41,93.1,0.0
33763,383656,324,5181,324,5829,648,325,15.991,0.0
33764,1057293,1000,20977,1000,22977,2000,1001,20.977,0.0
33765,33108,20,701,20,741,40,22,35.05,0.0
33768,1140597,0,15144,0,16144,1000,1001,15.144,1.0
3377,185690,500,2000,500,3000,1000,501,4.0,0.0
33778,5448,8,71,8,87,16,9,8.875,0.0
3378,13383,0,204,0,230,26,27,7.846,0.5
33789,1266,1,11,1,13,2,2,11.0,0.0
3379,237323,500,2804,500,3804,1000,501,5.608,0.8333333333333334
33793,5699,0,52,0,65,13,14,4.0,0.0
33794,108538,92,1431,92,1615,184,93,15.554,0.0
33798,257597,1000,1000,1000,3000,2000,1001,1.0,0.0
3380,30723,55,329,55,439,110,56,5.982,0.5
33807,4791,0,36,0,48,12,13,3.0,0.0
3381,108775,132,1846,132,2110,264,133,13.985,0.0
33811,529357,1000,5828,1000,7828,2000,1001,5.828,0.0
33812,1102178,0,14553,0,15461,908,909,16.028,0.0
33814,533171,1000,5855,1000,7855,2000,1001,5.855,0.0
3382,23347,0,375,0,400,25,26,15.0,0.0
33820,257597,1000,1000,1000,3000,2000,1001,1.0,0.0
33822,257597,1000,1000,1000,3000,2000,1001,1.0,0.0
33823,4767,0,36,0,48,12,13,3.0,0.0
33824,1325693,1000,17903,1000,19903,2000,1001,17.903,0.0
3383,8302,0,96,0,108,12,13,8.0,0.0
33830,257597,1000,1000,1000,3000,2000,1001,1.0,0.0
33837,257597,1000,1000,1000,3000,2000,1001,1.0,0.0
33838,8307,30,30,30,90,60,31,1.0,0.0
33839,1271715,1000,16651,1000,18651,2000,1001,16.651,0.0
3384,233220,500,2913,500,3913,1000,501,5.826,0.0
33847,261598,1000,1000,1000,3000,2000,1001,1.0,0.0
33848,1189915,1000,15699,1000,17699,2000,1001,15.699,0.5
3385,49109,55,492,55,602,110,56,8.945,0.5
33850,261598,1000,1000,1000,3000,2000,1001,1.0,0.0
33856,1321698,1000,17998,1000,19998,2000,1001,17.998,0.0
3386,5205,8,72,8,88,16,9,9.0,0.0
33866,257597,1000,1000,1000,3000,2000,1001,1.0,0.0
33868,257597,1000,1000,1000,3000,2000,1001,1.0,0.0
3387,279791,0,3500,0,4000,500,501,7.0,0.0
33873,1328075,1000,17953,1000,19953,2000,1001,17.953,0.0
33878,257597,1000,1000,1000,3000,2000,1001,1.0,0.0
33879,3483846,1882,72403,1882,76167,3764,1884,38.471,0.0
3388,10163,0,72,0,80,8,9,9.0,0.0
33880,39671,0,646,0,696,50,51,12.92,0.0
33881,231799,360,3718,360,4438,720,362,10.328,0.0
33882,1123783,1000,14997,1000,16997,2000,1001,14.997,0.0
33883,1324203,1000,17988,1000,19988,2000,1001,17.988,0.0
33884,257597,1000,1000,1000,3000,2000,1001,1.0,0.0
33886,255597,0,1000,0,2000,1000,1001,1.0,0.0
33887,259738,0,3120,0,3572,452,453,6.903,0.0
3389,1472509,500,18708,500,20207,1499,739,37.416,0.0
33892,1280095,960,17199,960,19119,1920,961,17.916,0.0
33896,24057,0,92,0,184,92,93,1.0,0.0
33898,1111782,1000,15001,1000,17001,2000,1001,15.001,0.0
3390,23722,54,216,54,324,108,55,4.0,0.0
33900,261598,1000,1000,1000,3000,2000,1001,1.0,0.0
33903,493137,1000,5995,1000,7995,2000,1001,5.995,0.0
33905,8976,25,75,25,125,50,26,3.0,0.0
33908,261598,1000,1000,1000,3000,2000,1001,1.0,0.0
33909,4197,10,30,10,50,20,11,3.0,0.0
3391,35605,22,616,22,660,44,23,28.0,0.0
33910,1101297,1000,15002,1000,17002,2000,1001,15.002,0.0
33912,314369,164,6486,164,6814,328,166,39.549,0.0
33914,1331497,1000,17942,1000,19942,2000,1001,17.942,0.0
33915,21904,46,271,46,363,92,47,5.891,0.0
33916,257597,1000,1000,1000,3000,2000,1001,1.0,0.0
33919,260643,0,3120,0,3572,452,453,6.903,0.0
3392,4985,0,51,0,62,11,12,4.636,0.0
33920,1128658,1000,15002,1000,17002,2000,1001,15.002,0.0
33922,1336507,1000,17995,1000,19995,2000,1001,17.995,0.0
33923,1246781,0,16407,0,17407,1000,1001,16.407,0.0
33925,261598,1000,1000,1000,3000,2000,1001,1.0,0.0
33926,257597,1000,1000,1000,3000,2000,1001,1.0,0.0
33927,257597,1000,1000,1000,3000,2000,1001,1.0,0.0
33928,1381,3,3,3,9,6,4,1.0,0.0
3393,20132,0,491,0,517,26,27,18.885,0.0
33930,1307250,1000,17722,1000,19722,2000,1001,17.722,0.0
33933,61763,238,238,238,714,476,239,1.0,0.0
33934,1098210,1000,15000,1000,17000,2000,1001,15.0,0.0
33935,1307806,1000,17991,1000,19991,2000,1001,17.991,0.0
33936,1121990,1000,14998,1000,16998,2000,1001,14.998,0.0
33937,261598,1000,1000,1000,3000,2000,1001,1.0,0.0
33938,261598,1000,1000,1000,3000,2000,1001,1.0,0.0
33939,1303679,1000,17995,1000,19995,2000,1001,17.995,0.0
3394,21610,0,224,0,270,46,47,4.87,0.0
33940,257597,1000,1000,1000,3000,2000,1001,1.0,0.0
33941,1322122,1000,17986,1000,19986,2000,1001,17.986,0.0
33942,70285,267,267,267,801,534,268,1.0,0.0
33943,257597,1000,1000,1000,3000,2000,1001,1.0,0.0
33944,257597,1000,1000,1000,3000,2000,1001,1.0,0.0
33945,69216,267,267,267,801,534,268,1.0,0.0
33946,69216,267,267,267,801,534,268,1.0,0.0
33947,261598,1000,1000,1000,3000,2000,1001,1.0,0.0
33948,1254902,1000,16478,1000,18478,2000,1001,16.478,1.0
33949,257597,1000,1000,1000,3000,2000,1001,1.0,0.0
33951,4240,3,48,3,54,6,4,16.0,0.0
33954,3432,4,48,4,56,8,5,12.0,0.0
33955,3433,0,48,0,52,4,5,12.0,0.0
33957,257597,1000,1000,1000,3000,2000,1001,1.0,0.0
3396,45081,0,728,0,771,43,44,16.93,0.0
3397,127662,0,1450,0,1740,290,291,5.0,0.0
3398,33928,0,291,0,388,97,98,3.0,0.5
3399,503791,0,8386,0,8886,500,501,16.772,0.5
3401,6544,0,160,0,167,7,8,22.857,0.0
3402,12430,0,116,0,125,9,10,12.889,0.0
3403,425897,500,5544,500,7044,1500,1002,5.544,0.0
3404,2063,4,14,4,22,8,5,3.5,0.0
3406,22402,0,364,0,377,13,14,28.0,0.0
3408,28388,54,213,54,321,108,55,3.944,0.0
3409,263137,500,3000,500,4000,1000,501,6.0,0.0
3410,176100,500,2000,500,3000,1000,501,4.0,0.0
3411,293382,500,3500,500,4500,1000,501,7.0,0.0
3412,294571,500,3500,500,4500,1000,501,7.0,0.0
3413,255925,500,3000,500,4000,1000,501,6.0,0.0
3414,294032,500,3500,500,4500,1000,501,7.0,0.0
3415,130503,144,2562,144,2850,288,145,17.792,0.0
34151,1019513,0,14290,0,15290,1000,1001,14.29,0.5
34162,932916,1000,14961,1000,16961,2000,1001,14.961,0.5
34163,114300,439,439,439,1317,878,440,1.0,0.0
34164,5765265,1000,10714,1000,12714,2000,1001,10.714,0.0
3417,255051,500,3000,500,4000,1000,501,6.0,0.0
34174,1633825,1000,25207,1000,27207,2000,1001,25.207,0.0
3418,294393,500,3500,500,4500,1000,501,7.0,0.0
34181,1463045,1000,21977,1000,23977,2000,1001,21.977,0.0
3419,252886,500,3000,500,4000,1000,501,6.0,0.0
34191,128804,495,495,495,1485,990,496,1.0,0.0
34196,1662100,82,20604,82,20768,164,83,251.268,0.0
3420,235749,500,2500,500,3500,1000,501,5.0,0.0
34200,263600,1000,1000,1000,3000,2000,1001,1.0,0.0
34203,282952,439,2542,439,3420,878,440,5.79,0.0
34212,259599,1000,1000,1000,3000,2000,1001,1.0,0.0
34214,21837,82,82,82,246,164,83,1.0,0.0
34215,198251,82,1066,82,1230,164,83,13.0,1.0
3422,291109,500,3500,500,4500,1000,501,7.0,0.0
34225,1695604,1000,26674,1000,28674,2000,1001,26.674,0.5
34228,1646387,1000,24178,1000,26178,2000,1001,24.178,0.5
3423,292328,500,3500,500,4500,1000,501,7.0,0.0
3424,18237,0,60,0,70,10,11,6.0,1.0
34243,1579747,31,155,31,217,62,32,5.0,0.0
34249,22166,82,82,82,246,164,83,1.0,0.0
3425,92125,144,1364,144,1652,288,145,9.472,0.0
34250,259599,1000,1000,1000,3000,2000,1001,1.0,0.0
34255,6746,14,70,14,98,28,15,5.0,0.5
34257,436324,82,4736,82,4900,164,83,57.756,0.0
3426,66679,157,628,157,942,314,158,4.0,0.0
34260,106326,402,402,402,1206,804,403,1.0,0.0
34262,259599,1000,1000,1000,3000,2000,1001,1.0,0.0
34264,58544,59,684,59,802,118,60,11.593,0.0
34265,165797,82,650,82,814,164,83,7.927,0.0
3427,251151,500,4000,500,5000,1000,501,8.0,0.0
3428,250196,500,3000,500,4000,1000,501,6.0,0.0
34281,1120291,1000,17200,1000,19200,2000,1001,17.2,0.0
34283,745116,0,9789,0,10391,602,603,16.261,0.0
34284,26868,41,369,41,451,82,42,9.0,0.5
34287,163887,82,656,82,820,164,83,8.0,0.0
34289,21837,82,82,82,246,164,83,1.0,0.0
3429,292285,500,3500,500,4500,1000,501,7.0,0.0
34290,260789,0,2675,0,3210,535,536,5.0,0.0
34293,783579,0,3000,0,4000,1000,1001,3.0,0.0
34295,21837,82,82,82,246,164,83,1.0,0.0
34296,158917,0,490,0,572,82,83,5.976,0.0
34297,68457,262,262,262,786,524,263,1.0,0.0
34298,786379,0,3000,0,4000,1000,1001,3.0,0.0
3430,250626,500,3000,500,4000,1000,501,6.0,0.0
34301,143487,177,2288,177,2642,354,178,12.927,0.5
34302,259599,1000,1000,1000,3000,2000,1001,1.0,0.0
34304,491259,1000,6971,1000,8971,2000,1001,6.971,0.0
34305,127301,82,410,82,574,164,83,5.0,0.0
34306,104717,402,402,402,1206,804,403,1.0,0.0
34307,22166,82,82,82,246,164,83,1.0,0.0
34309,139164,535,535,535,1605,1070,536,1.0,0.0
3431,292651,500,3500,500,4500,1000,501,7.0,0.0
34311,94357,362,362,362,1086,724,363,1.0,0.0
34313,259599,1000,1000,1000,3000,2000,1001,1.0,0.0
34314,21837,82,82,82,246,164,83,1.0,0.0
34316,350977,82,3696,82,3860,164,83,45.073,0.0
34317,223267,82,1558,82,1722,164,83,19.0,0.0
3432,250957,500,3000,500,4000,1000,501,6.0,0.0
34320,620707,1000,7033,1000,9033,2000,1001,7.033,0.0
34321,263600,1000,1000,1000,3000,2000,1001,1.0,0.0
34323,670347,1000,9729,1000,11729,2000,1001,9.729,0.0
34324,21837,82,82,82,246,164,83,1.0,0.0
34325,22166,82,82,82,246,164,83,1.0,0.0
34328,21837,82,82,82,246,164,83,1.0,0.0
34329,55507,212,212,212,636,424,213,1.0,0.0
3433,235749,500,2500,500,3500,1000,501,5.0,0.0
34330,6297,22,22,22,66,44,23,1.0,0.0
34331,259599,1000,1000,1000,3000,2000,1001,1.0,0.0
34333,1004223,492,3610,492,4594,984,493,7.337,0.0
34337,94357,362,362,362,1086,724,363,1.0,0.0
34340,599128,17,68,17,102,34,18,4.0,0.0
34342,263600,1000,1000,1000,3000,2000,1001,1.0,0.0
34343,366034,418,5526,418,6362,836,419,13.22,0.0
34346,175779,82,730,82,894,164,83,8.902,0.0
34347,259599,1000,1000,1000,3000,2000,1001,1.0,0.0
34349,259599,1000,1000,1000,3000,2000,1001,1.0,0.0
3435,250223,500,3000,500,4000,1000,501,6.0,0.0
34350,259599,1000,1000,1000,3000,2000,1001,1.0,0.0
34353,1646602,80,20720,80,20880,160,81,259.0,0.0
34354,249593,82,2130,82,2294,164,83,25.976,0.0
34355,104717,402,402,402,1206,804,403,1.0,0.0
34358,259599,1000,1000,1000,3000,2000,1001,1.0,0.0
34359,21837,82,82,82,246,164,83,1.0,0.0
3436,82520,86,1320,86,1492,172,87,15.349,0.0
34360,21837,82,82,82,246,164,83,1.0,0.0
34362,806498,1000,10765,1000,12765,2000,1001,10.765,0.0
34363,259599,1000,1000,1000,3000,2000,1001,1.0,0.0
34364,166974,82,656,82,820,164,83,8.0,0.0
34367,153668,82,490,82,654,164,83,5.976,0.0
34368,259599,1000,1000,1000,3000,2000,1001,1.0,0.0
34372,20283,76,76,76,228,152,77,1.0,0.0
34374,156866,82,492,82,656,164,83,6.0,0.0
34376,223872,82,1690,82,1854,164,83,20.61,0.0
34378,259599,1000,1000,1000,3000,2000,1001,1.0,0.0
3438,235740,500,2500,500,3500,1000,501,5.0,0.0
34381,28805,40,320,40,400,80,41,8.0,0.0
34383,263600,1000,1000,1000,3000,2000,1001,1.0,0.0
34385,259599,1000,1000,1000,3000,2000,1001,1.0,0.0
34386,190714,82,984,82,1148,164,83,12.0,0.0
3439,248680,431,5760,431,6622,862,433,13.364,0.0
34390,4225,14,14,14,42,28,15,1.0,0.0
34391,259599,1000,1000,1000,3000,2000,1001,1.0,0.0
34393,159755,82,490,82,654,164,83,5.976,0.0
34394,259599,1000,1000,1000,3000,2000,1001,1.0,0.0
34396,259599,1000,1000,1000,3000,2000,1001,1.0,0.0
34397,14844,55,55,55,165,110,56,1.0,0.0
3440,250263,500,3000,500,4000,1000,501,6.0,0.0
34403,21837,82,82,82,246,164,83,1.0,0.0
34404,259599,1000,1000,1000,3000,2000,1001,1.0,0.0
34407,21837,82,82,82,246,164,83,1.0,0.0
3441,293562,500,3500,500,4500,1000,501,7.0,0.0
34410,2412,7,7,7,21,14,8,1.0,0.0
34414,10959,40,40,40,120,80,41,1.0,0.0
34415,259599,1000,1000,1000,3000,2000,1001,1.0,0.0
34416,263600,1000,1000,1000,3000,2000,1001,1.0,0.0
34417,21837,82,82,82,246,164,83,1.0,0.0
34418,450949,1000,5217,1000,7217,2000,1001,5.217,0.0
34419,22166,82,82,82,246,164,83,1.0,0.0
3442,236696,500,2500,500,3500,1000,501,5.0,0.0
34423,259599,1000,1000,1000,3000,2000,1001,1.0,0.0
34424,21837,82,82,82,246,164,83,1.0,0.0
34427,56356,212,212,212,636,424,213,1.0,0.0
3443,66680,157,628,157,942,314,158,4.0,0.0
34435,259599,1000,1000,1000,3000,2000,1001,1.0,0.0
34437,22166,82,82,82,246,164,83,1.0,0.0
3444,206033,500,3000,500,4000,1000,501,6.0,0.0
34440,263600,1000,1000,1000,3000,2000,1001,1.0,0.0
34444,128027,492,492,492,1476,984,493,1.0,0.0
34449,108861,418,418,418,1254,836,419,1.0,0.0
3445,250267,500,3000,500,4000,1000,501,6.0,0.0
34451,20024,75,75,75,225,150,76,1.0,0.0
34452,1046738,6,18,6,30,12,7,3.0,0.5
34455,1315383,1000,24603,1000,26603,2000,1001,24.603,0.0
34456,21837,82,82,82,246,164,83,1.0,0.0
34459,21837,82,82,82,246,164,83,1.0,0.0
3446,292661,500,3500,500,4500,1000,501,7.0,0.0
34466,8110,29,29,29,87,58,30,1.0,0.0
3447,292424,500,3500,500,4500,1000,501,7.0,0.0
34472,259599,1000,1000,1000,3000,2000,1001,1.0,0.0
34476,259599,1000,1000,1000,3000,2000,1001,1.0,0.0
34487,4553,7,35,7,49,14,8,5.0,0.0
34488,259599,1000,1000,1000,3000,2000,1001,1.0,0.0
34489,517963,1000,7000,1000,9000,2000,1001,7.0,0.0
3449,236305,500,2500,500,3500,1000,501,5.0,0.0
34490,21837,82,82,82,246,164,83,1.0,0.0
34496,259599,1000,1000,1000,3000,2000,1001,1.0,0.0
34498,45324,75,751,75,901,150,76,10.013,0.0
34507,591579,1000,10009,1000,12009,2000,1001,10.009,0.0
34508,21837,82,82,82,246,164,83,1.0,0.0
34509,263600,1000,1000,1000,3000,2000,1001,1.0,0.0
3451,82641,144,1521,144,1809,288,145,10.562,0.0
34510,259599,1000,1000,1000,3000,2000,1001,1.0,0.0
34511,21837,82,82,82,246,164,83,1.0,0.0
34512,14526,39,156,39,234,78,40,4.0,0.0
34513,1026105,1000,19004,1000,21004,2000,1001,19.004,0.0
34514,21319,80,80,80,240,160,81,1.0,0.0
34515,21837,82,82,82,246,164,83,1.0,0.0
34516,259599,1000,1000,1000,3000,2000,1001,1.0,0.0
34517,259599,1000,1000,1000,3000,2000,1001,1.0,0.0
34518,128027,492,492,492,1476,984,493,1.0,0.0
34519,259599,1000,1000,1000,3000,2000,1001,1.0,0.0
3452,10633,25,149,25,199,50,26,5.96,0.0
34520,263600,1000,1000,1000,3000,2000,1001,1.0,0.0
34521,493973,1000,7000,1000,9000,2000,1001,7.0,0.0
34522,60095,22,88,22,132,44,23,4.0,0.0
34523,22166,82,82,82,246,164,83,1.0,0.0
34524,444840,1000,6000,1000,8000,2000,1001,6.0,0.0
34525,259599,1000,1000,1000,3000,2000,1001,1.0,0.0
34526,263600,1000,1000,1000,3000,2000,1001,1.0,0.0
34535,36649,146,146,146,438,292,147,1.0,0.0
34536,49421,0,670,0,716,46,47,14.565,0.0
34538,983355,1000,17024,1000,19024,2000,1001,17.024,0.0
34539,131923,0,1707,0,1763,56,57,30.482,0.0
3454,291306,500,3500,500,4500,1000,501,7.0,0.0
3455,292202,500,3500,500,4500,1000,501,7.0,0.0
34551,251588,1000,1000,1000,3000,2000,1001,1.0,0.0
34553,2169650,54,13682,54,13790,108,55,253.37,0.0
34559,491445,0,5796,0,6440,644,645,9.0,0.0
3456,66680,157,628,157,942,314,158,4.0,0.0
3457,259497,500,3000,500,4000,1000,501,6.0,0.0
34579,2300666,0,14487,0,14544,57,58,254.158,0.0
34588,13179,12,173,12,197,24,13,14.417,0.0
3459,291072,500,3500,500,4500,1000,501,7.0,0.0
34592,1272411,2000,19000,2000,24000,5000,3002,6.333,0.5
34593,1005110,0,6337,0,6362,25,26,253.48,0.0
34596,185826,738,738,738,2214,1476,739,1.0,0.5
3460,294011,500,3500,500,4500,1000,501,7.0,0.0
3461,502666,500,6000,500,7000,1000,501,12.0,0.0
3462,505331,500,6000,500,7000,1000,501,12.0,0.0
34628,358311,0,4271,0,4350,79,80,54.063,0.0
3463,260175,0,4000,0,4500,500,501,8.0,0.0
34645,3411945,0,35148,0,36148,1000,1001,35.148,0.5
34647,267679,0,1680,0,1688,8,9,210.0,0.0
34650,250040,266,4023,266,4830,807,543,7.436,0.0
34651,9432,12,141,12,165,24,13,11.75,0.0
34652,316731,335,5043,335,6060,1017,684,7.394,0.0
34655,68334,0,1215,0,1309,94,95,12.926,0.0
3466,276212,0,4000,0,4500,500,501,8.0,0.0
34662,1257731,2000,19000,2000,24000,5000,3002,6.333,0.5
34668,1175448,0,6117,0,6150,33,34,185.364,0.0
3467,260233,0,4000,0,4500,500,501,8.0,0.0
34671,593137,89,9468,89,10646,1178,1091,8.694,0.0
34674,400412,0,2518,0,2529,11,12,228.909,0.0
34675,354773,0,2248,0,2257,9,10,249.778,0.0
34677,19240,32,352,32,416,64,33,11.0,0.5
34679,100533,0,1062,0,1275,213,214,4.986,0.0
34682,390858,0,2466,0,2476,10,11,246.6,0.0
34684,197380,49,4597,49,4695,98,50,93.816,0.0
34686,49260,0,412,0,515,103,104,4.0,1.0
34687,199916,807,807,807,2421,1614,808,1.0,0.0
3469,516700,0,6000,0,6500,500,501,12.0,0.0
34692,1968308,0,10195,0,10249,54,55,188.796,0.0
34697,582434,0,3012,0,3028,16,17,188.25,0.0
3470,421944,500,5500,500,6500,1000,501,11.0,0.0
34700,662272,0,8869,0,9506,637,638,13.923,0.0
34701,270224,0,1706,0,1713,7,8,243.714,0.0
34702,653319,1000,8025,1000,10025,2000,1001,8.025,0.0
34704,19022,19,322,19,360,38,20,16.947,0.0
34706,1023024,0,19000,0,20000,1000,1001,19.0,0.0
34707,277996,0,1758,0,1765,7,8,251.143,0.0
34708,835007,0,12135,0,13135,1000,1001,12.135,0.0
34709,269736,0,1897,0,1952,55,56,34.491,0.0
3471,485141,500,6133,500,7133,1000,501,12.266,0.0
34710,195996,0,1240,0,1245,5,6,248.0,0.0
34711,251588,1000,1000,1000,3000,2000,1001,1.0,0.0
34712,268989,0,1698,0,1705,7,8,242.571,0.0
34714,775024,732,9516,732,10980,1464,733,13.0,0.0
34715,29943,0,216,0,315,99,100,2.182,0.0
34717,792665,641,12585,641,14867,2282,1643,7.669,0.0
3472,331642,0,4489,0,4556,67,68,67.0,0.0
34720,1017625,0,19000,0,20000,1000,1001,19.0,0.0
34721,827548,0,11991,0,12991,1000,1001,11.991,0.0
34724,828330,0,11957,0,12957,1000,1001,11.957,0.0
34726,152693,0,972,0,976,4,5,243.0,0.0
3473,291728,500,4000,500,5000,1000,501,8.0,0.0
34732,247587,1000,1000,1000,3000,2000,1001,1.0,0.0
34733,86190,0,1177,0,1256,79,80,14.899,0.0
34737,637852,0,7997,0,8997,1000,1001,7.997,0.5
3474,261182,500,4000,500,5000,1000,501,8.0,0.0
34740,792665,641,12585,641,14867,2282,1643,7.669,0.0
34741,875570,720,18340,720,19780,1440,722,25.472,0.0
34742,1158006,0,20187,0,21187,1000,1001,20.187,0.0
34744,149251,0,946,0,950,4,5,236.5,0.0
34745,912940,325,9044,325,9694,650,326,27.828,0.5
3475,298387,0,4014,0,4363,349,350,11.501,0.0
34752,1003943,0,19000,0,20000,1000,1001,19.0,0.0
34753,352643,0,1855,0,1866,11,12,168.636,0.0
34755,609814,0,3190,0,3208,18,19,177.222,0.0
3476,276272,0,4000,0,4500,500,501,8.0,0.0
34760,247587,1000,1000,1000,3000,2000,1001,1.0,0.6666666666666666
34761,247587,1000,1000,1000,3000,2000,1001,1.0,0.0
34762,2608846,1000,30301,1000,32301,2000,1001,30.301,0.75
34763,128305,0,1709,0,1869,160,161,10.681,0.0
34764,726238,923,10149,923,11995,1846,924,10.996,0.0
34766,172630,0,906,0,911,5,6,181.2,0.0
34768,204443,0,1072,0,1078,6,7,178.667,0.0
3477,483519,500,6104,500,7104,1000,501,12.208,0.0
3478,576915,500,6906,500,8332,1426,720,13.812,0.75
34784,1263781,2000,19000,2000,24000,5000,3002,6.333,1.0
34786,51754,0,1041,0,1134,93,94,11.194,0.0
3479,46209,50,682,50,782,100,51,13.64,0.0
34794,197084,0,1248,0,1253,5,6,249.6,0.0
34799,1264345,2000,19000,2000,24000,5000,3002,6.333,0.75
3480,186210,0,2576,0,2960,384,385,6.708,0.0
34806,620557,0,8731,0,9731,1000,1001,8.731,0.0
34808,3231673,1000,88000,1000,90000,2000,1001,88.0,0.0
3481,510532,0,6000,0,6500,500,501,12.0,0.0
34811,9746,16,183,16,215,32,17,11.438,0.0
34812,110208,151,1353,151,1655,302,152,8.96,0.0
34813,353996,0,1838,0,1848,10,11,183.8,0.0
34815,1190660,1000,17494,1000,19494,2000,1001,17.494,0.5
34819,43941,64,511,64,639,128,65,7.984,0.0
3482,2097449,500,34000,500,35000,1000,501,68.0,0.0
34823,184124,0,950,0,955,5,6,190.0,0.0
34827,844853,1000,18777,1000,20777,2000,1001,18.777,0.75
34828,47212,71,710,71,852,142,72,10.0,0.0
34829,792665,641,12585,641,14867,2282,1643,7.669,0.0
3483,168683,392,1960,392,2744,784,393,5.0,0.5
34830,61724,54,1242,54,1377,135,83,15.333,0.0
34832,120314,0,642,0,646,4,5,160.5,0.0
34833,315169,85,8732,85,8902,170,86,102.729,0.0
34834,1023808,0,19000,0,20000,1000,1001,19.0,0.0
34836,489865,1000,8000,1000,10000,2000,1001,8.0,0.0
34838,1136304,1000,24868,1000,26868,2000,1001,24.868,0.0
3484,297622,0,5000,0,5500,500,501,10.0,0.0
34841,858607,0,12487,0,13487,1000,1001,12.487,0.0
34844,1053474,0,19000,0,20000,1000,1001,19.0,0.0
34845,2444380,2000,47844,2000,51844,4000,2002,23.922,0.6666666666666666
34846,1030287,0,19000,0,20000,1000,1001,19.0,0.0
3485,517218,0,6000,0,6500,500,501,12.0,0.0
34851,813753,1000,9206,1000,11206,2000,1001,9.206,0.0
34854,1001238,0,19000,0,20000,1000,1001,19.0,0.0
34856,1015015,0,19000,0,20000,1000,1001,19.0,0.0
34858,967183,0,19354,0,20354,1000,1001,19.354,0.0
3486,517640,0,6000,0,6500,500,501,12.0,0.0
34860,66160,0,812,0,928,116,117,7.0,0.0
34861,1198239,2345,21691,2345,26381,4690,2347,9.25,0.0
34862,507031,1000,5000,1000,7000,2000,1002,5.0,1.0
34863,157797,0,998,0,1002,4,5,249.5,0.0
34866,143911,0,746,0,750,4,5,186.5,0.0
34869,853103,808,13608,808,16224,2616,1810,7.527,0.0
3487,733796,0,8504,0,9004,500,501,17.008,0.0
34870,331406,0,1710,0,1719,9,10,190.0,0.0
34871,329033,0,1702,0,1711,9,10,189.111,0.0
34872,501148,482,6579,482,7543,964,483,13.649,0.0
34873,1020719,0,19000,0,20000,1000,1001,19.0,0.0
34875,240753,0,1276,0,1284,8,9,159.5,0.0
34879,490350,1000,7000,1000,9000,2000,1001,7.0,0.0
3488,276143,500,4000,500,5000,1000,501,8.0,0.0
34884,178170,0,926,0,931,5,6,185.2,0.0
34886,7028,9,81,9,99,18,10,9.0,0.0
34887,14246,0,87,0,127,40,41,2.175,0.5
34889,849762,804,13614,804,16222,2608,1806,7.547,0.0
3489,259202,0,4000,0,4500,500,501,8.0,0.0
34892,988894,0,10110,0,10436,326,327,31.012,0.5
34894,561936,1002,8964,1002,10968,2004,1004,8.946,0.0
34895,840570,764,13335,764,15863,2528,1766,7.56,0.0
34896,21048,58,276,58,392,116,60,4.759,0.0
3490,259385,500,4000,500,5000,1000,501,8.0,0.0
34905,47615,57,684,57,798,114,58,12.0,0.0
34908,197501,0,2205,0,2646,441,442,5.0,0.0
3491,259003,338,3380,338,4056,676,339,10.0,0.0
34911,987303,0,19000,0,20000,1000,1001,19.0,0.0
34913,247587,1000,1000,1000,3000,2000,1001,1.0,0.0
34914,220358,0,3074,0,3603,529,530,5.811,0.0
34916,835134,1000,11872,1000,13872,2000,1001,11.872,0.0
3492,1125600,0,14854,0,15354,500,501,29.708,0.0
34921,897941,1000,15998,1000,17998,2000,1001,15.998,0.0
34924,463409,249,7650,249,8148,498,250,30.723,0.0
34925,1279783,3000,19000,3000,25000,6000,3002,6.333,0.0
34927,999781,0,19000,0,20000,1000,1001,19.0,0.0
34928,1013578,0,19000,0,20000,1000,1001,19.0,0.0
3493,162818,140,1709,140,1989,280,141,12.207,0.0
34930,868957,0,12666,0,13666,1000,1001,12.666,0.0
34931,22208,0,475,0,494,19,20,25.0,0.0
34932,20559,0,211,0,229,18,19,11.722,0.5
34936,1266346,2000,19000,2000,24000,5000,3002,6.333,0.6666666666666666
34937,1023790,0,19000,0,20000,1000,1001,19.0,0.0
3494,339264,0,8000,0,8500,500,501,16.0,0.0
3495,197509,0,1848,0,2002,154,155,12.0,0.0
3496,451484,500,6004,500,7004,1000,501,12.008,0.0
34965,572329,0,6652,0,6725,73,74,91.123,0.0
34966,18994,0,402,0,418,16,17,25.125,0.0
3497,2124415,500,34000,500,35000,1000,501,68.0,0.0
3499,807021,0,12212,0,12712,500,501,24.424,0.5
3500,373376,500,5500,500,6500,1000,501,11.0,0.5
3501,538431,0,6500,0,7000,500,501,13.0,0.0
3502,259249,500,4000,500,5000,1000,501,8.0,0.0
3503,259214,0,4000,0,4500,500,501,8.0,0.0
3504,268556,0,2520,0,2730,210,211,12.0,0.5
3505,538437,0,6500,0,7000,500,501,13.0,0.0
3506,531282,500,6500,500,7500,1000,501,13.0,0.0
35067,16938,0,141,0,188,47,48,3.0,0.0
35068,1274411,3000,19000,3000,25000,6000,3002,6.333,0.5
35069,1635051,0,14442,0,14471,29,30,498.0,0.0
3507,467372,500,7500,500,8500,1000,501,15.0,0.5
35075,30053,12,672,12,708,36,26,28.0,0.5
35077,2016,0,18,0,20,2,3,9.0,0.0
3508,259232,500,4000,500,5000,1000,501,8.0,0.0
35081,7882,0,99,0,108,9,10,11.0,0.0
35084,392441,389,4668,389,5446,778,390,12.0,0.5
35086,1257203,1000,21900,1000,23900,2000,1001,21.9,0.0
3509,274130,0,4000,0,4500,500,501,8.0,0.0
35093,3845,0,44,0,48,4,5,11.0,0.0
35094,1039770,0,11181,0,11252,71,72,157.479,0.0
35096,10171,0,152,0,171,19,20,8.0,0.5
3510,302527,500,3980,500,4980,1000,501,7.96,0.0
35100,14466,0,198,0,231,33,34,6.0,0.0
3511,323870,497,3976,497,4970,994,498,8.0,0.5
35114,925834,0,11713,0,12713,1000,1001,11.713,0.0
35115,990138,0,19000,0,20000,1000,1001,19.0,0.0
35118,40256,0,530,0,619,89,90,5.955,0.0
35128,1267,0,12,0,13,1,2,12.0,0.0
3513,740903,500,10166,500,11166,1000,501,20.332,0.0
3514,258133,0,4000,0,4500,500,501,8.0,0.0
35142,4952,6,54,6,66,12,7,9.0,0.5
3515,419977,500,6143,500,7143,1000,501,12.286,0.0
35153,372734,0,5214,0,6112,898,899,5.806,0.0
3516,259204,0,4000,0,4500,500,501,8.0,0.0
3517,324631,500,4441,500,5441,1000,501,8.882,0.5
35171,1032070,0,19000,0,20000,1000,1001,19.0,0.0
35175,116318,333,999,333,1665,666,334,3.0,0.0
35179,1006705,0,19000,0,20000,1000,1001,19.0,0.0
3518,354586,351,4184,351,4886,702,352,11.92,0.0
35181,493233,1000,7000,1000,9000,2000,1001,7.0,0.0
35182,217989,0,3740,0,3908,168,169,22.262,0.0
35183,28968,0,595,0,630,35,36,17.0,0.0
35185,894540,936,14291,936,17163,2872,1938,7.382,0.0
35187,3487,4,36,4,44,8,5,9.0,0.0
3519,70451,77,793,77,947,154,78,10.299,0.0
35191,1569270,1230,32782,1230,35242,2460,1232,26.652,0.0
35192,784523,1672,12491,1672,15835,3344,1674,7.471,0.0
35195,493872,1000,7000,1000,9000,2000,1001,7.0,0.0
35198,28579,36,613,36,685,72,37,17.028,0.0
3520,505554,500,6000,500,7000,1000,501,12.0,0.0
35202,1033063,0,19000,0,20000,1000,1001,19.0,0.0
35206,6764,19,57,19,95,38,20,3.0,0.0
3521,309585,0,6000,0,6500,500,501,12.0,0.0
35210,917299,1000,18014,1000,20014,2000,1001,18.014,0.0
35213,680728,1000,9000,1000,11000,2000,1001,9.0,0.6666666666666666
35218,136996,37,1569,37,1680,111,76,21.203,0.0
3523,16602,0,227,0,258,31,32,7.323,0.0
35232,7818,0,99,0,108,9,10,11.0,0.0
3524,3637,0,24,0,30,6,7,4.0,0.0
3525,27454,28,298,28,354,56,29,10.643,0.0
3526,13572,8,91,8,107,16,9,11.375,0.0
3527,98192,200,1198,200,1598,400,201,5.99,1.0
3528,175626,0,2366,0,2706,340,341,6.959,0.0
3529,228998,500,2858,500,3858,1000,501,5.716,0.75
3530,33161,0,288,0,384,96,97,3.0,0.5
3531,567745,0,9368,0,9868,500,501,18.736,0.5
35317,2497,4,28,4,36,8,5,7.0,0.75
3532,9188,0,77,0,103,26,27,2.962,0.0
35320,16502,17,192,17,226,34,18,11.294,0.0
35329,825104,0,11929,0,12929,1000,1001,11.929,0.0
3533,15234,0,175,0,200,25,26,7.0,0.0
35330,216045,0,3722,0,3891,169,170,22.024,0.5
35335,2020,2,18,2,22,4,3,9.0,0.0
35336,5790,1,53,1,55,2,2,53.0,0.0
35339,50137,0,628,0,698,70,71,8.971,0.0
3534,242508,0,3496,0,3996,500,501,6.992,0.0
35341,50103,154,462,154,770,308,155,3.0,0.0
35344,8738,33,33,33,99,66,34,1.0,0.0
35346,567481,1263,9212,1263,11738,2526,1265,7.294,0.0
35348,12881,0,100,0,117,17,18,5.882,0.0
35349,172765,18,4608,18,4644,36,19,256.0,0.0
3535,34573,0,291,0,388,97,98,3.0,0.5
35352,55474,0,750,0,827,77,78,9.74,0.0
35355,13384,21,168,21,210,42,22,8.0,0.0
35361,826132,0,11931,0,12931,1000,1001,11.931,0.0
35367,170053,352,2351,352,3055,704,353,6.679,0.0
3537,7670,0,73,0,86,13,14,5.615,0.0
35377,59797,0,750,0,857,107,108,7.009,0.0
35378,6103,9,72,9,90,18,10,8.0,0.0
35379,193354,481,2831,481,3793,962,483,5.886,0.0
3538,41690,0,380,0,507,127,128,2.992,0.0
35397,5401,0,65,0,71,6,7,10.833,0.0
3540,52046,0,1041,0,1096,55,56,18.927,1.0
3541,10253,0,46,0,53,7,8,6.571,0.0
3542,4096,0,50,0,55,5,6,10.0,0.0
35424,5058937,729,57935,729,59942,2007,1280,45.333,0.0
3543,54961,55,434,55,544,110,56,7.891,0.0
35433,701640,1000,11993,1000,13993,2000,1001,11.993,0.0
35435,15420,12,363,12,387,24,13,30.25,0.0
35436,181359,320,2235,320,2875,640,321,6.984,0.0
3544,8627,0,56,0,66,10,11,5.6,0.0
35446,428547,0,5802,0,6802,1000,1001,5.802,0.0
3545,219658,0,2361,0,2861,500,501,4.722,0.0
35459,251588,1000,1000,1000,3000,2000,1001,1.0,0.5
3546,150351,152,1824,152,2128,304,153,12.0,0.0
35464,5855,1,54,1,56,2,2,54.0,0.0
35465,5945,5,65,5,75,10,6,13.0,0.0
3547,277718,0,4500,0,5000,500,501,9.0,0.0
35473,2210,0,22,0,24,2,3,11.0,0.0
35475,38675,0,513,0,599,86,87,5.965,0.0
3548,227857,500,2722,500,3722,1000,501,5.444,0.0
35482,512930,1000,7000,1000,9000,2000,1001,7.0,0.0
35485,84650,0,1122,0,1203,81,82,13.852,0.0
3549,233375,500,2841,500,3841,1000,501,5.682,0.0
35494,1014993,0,19000,0,20000,1000,1001,19.0,0.0
35497,62484,0,736,0,818,82,83,8.976,0.0
3550,21441,0,281,0,324,43,44,6.535,0.0
35501,677866,1000,9000,1000,11000,2000,1001,9.0,0.5
35505,23300,0,270,0,300,30,31,9.0,0.0
35508,2715,3,26,3,32,6,4,8.667,0.0
35517,299917,440,4609,440,5489,880,441,10.475,0.0
35519,44245,41,574,41,656,82,42,14.0,0.75
35526,1304,1,9,1,11,2,2,9.0,0.5
35529,1400,0,11,0,12,1,2,11.0,0.0
3553,5405,10,60,10,80,20,11,6.0,0.0
35535,830358,1000,11961,1000,13961,2000,1001,11.961,0.0
3554,3565,0,40,0,45,5,6,8.0,0.0
35540,187605,272,3492,272,4036,544,273,12.838,0.0
35543,50132,45,777,45,867,90,46,17.267,0.0
35546,51203,49,926,49,1024,98,50,18.898,0.0
35547,17945,22,286,22,330,44,23,13.0,0.0
3556,134752,0,1412,0,1635,223,224,6.332,0.0
35560,41229,47,464,47,558,94,48,9.872,0.0
35564,5858,1,54,1,56,2,2,54.0,0.0
35568,451144,1000,6800,1000,8800,2000,1001,6.8,0.0
35578,153446,0,2137,0,2502,365,366,5.855,0.0
3558,143610,430,1290,430,2150,860,431,3.0,0.0
35580,1017465,0,19000,0,20000,1000,1001,19.0,0.0
35583,251588,1000,1000,1000,3000,2000,1001,1.0,0.0
35584,1399,0,11,0,12,1,2,11.0,0.0
35588,5768,1,53,1,55,2,2,53.0,0.0
35596,5841,1,54,1,56,2,2,54.0,0.0
35597,1011577,0,19000,0,20000,1000,1001,19.0,0.0
35607,929982,1000,9850,1000,11850,2000,1001,9.85,0.0
3561,207153,0,2784,0,3063,279,280,9.978,0.0
35612,9972,0,179,0,197,18,19,9.944,0.0
3562,237477,500,2873,500,3873,1000,501,5.746,0.0
35625,488755,1000,7000,1000,9000,2000,1001,7.0,0.0
35626,15653,0,290,0,319,29,30,10.0,0.0
35636,11673,0,247,0,257,10,11,24.7,0.0
35637,36006,0,478,0,527,49,50,9.755,0.0
3564,2668,0,20,0,24,4,5,5.0,0.0
35645,179658,331,2648,331,3310,662,332,8.0,0.0
3565,104453,119,952,119,1190,238,120,8.0,0.0
35650,179801,331,2648,331,3310,662,332,8.0,0.0
35657,521380,743,8900,743,10386,1486,744,11.978,0.0
3566,15375,0,182,0,196,14,15,13.0,0.0
35660,16894,31,248,31,310,62,32,8.0,0.0
35661,8359,10,100,10,120,20,11,10.0,0.0
35663,7177,12,120,12,144,24,13,10.0,0.0
3567,12637,0,185,0,210,25,26,7.4,1.0
35670,5904,0,119,0,124,5,6,23.8,0.0
35675,13255,0,208,0,221,13,14,16.0,0.5
35677,2793,3,33,3,42,9,8,5.5,0.0
35678,14835,30,180,30,240,60,31,6.0,0.0
3568,10803,0,112,0,128,16,17,7.0,0.5
35680,1542,1,23,1,25,2,2,23.0,0.0
35681,290940,506,4047,506,5059,1012,507,7.998,0.0
35682,42072,54,828,54,936,108,56,15.333,0.0
35687,5451,0,66,0,72,6,7,11.0,0.0
35689,20125,0,258,0,303,45,46,5.733,0.0
3569,2197,4,16,4,24,8,5,4.0,0.0
35690,5853,1,54,1,56,2,2,54.0,0.0
35695,1032161,0,19000,0,20000,1000,1001,19.0,0.0
35697,17166,33,264,33,330,66,34,8.0,0.0
3570,294012,500,3500,500,4500,1000,501,7.0,0.0
35708,9939,0,123,0,144,21,22,5.857,0.0
3571,16810,0,141,0,188,47,48,3.0,0.0
35710,20704,8,448,8,472,24,18,28.0,0.75
35711,7039,9,81,9,99,18,10,9.0,0.0
35714,69495,60,1559,60,1679,120,61,25.983,0.0
3572,63551,148,592,148,888,296,149,4.0,0.0
35728,638142,912,10941,912,12765,1824,913,11.997,0.0
3573,67309,157,628,157,942,314,158,4.0,0.0
3574,252272,500,3000,500,4000,1000,501,6.0,0.0
3575,299984,500,3500,500,4500,1000,501,7.0,0.5
3576,255555,500,3000,500,4000,1000,501,6.0,0.0
35768,1309,1,9,1,11,2,2,9.0,0.0
3577,242972,500,2997,500,3997,1000,501,5.994,0.0
35772,1164191,1000,18042,1000,20042,2000,1001,18.042,0.0
35777,21931,9,459,9,486,27,20,25.5,0.5
3578,366191,500,3747,500,4747,1000,501,7.494,0.0
3579,366913,0,3761,0,4261,500,501,7.522,0.0
3580,252120,500,3000,500,4000,1000,501,6.0,0.0
3581,296064,500,3500,500,4500,1000,501,7.0,0.0
35816,2784,3,33,3,42,9,8,5.5,0.0
35818,40715,79,474,79,632,158,80,6.0,0.5
35821,21017,0,243,0,270,27,28,9.0,0.0
35824,247587,1000,1000,1000,3000,2000,1001,1.0,0.0
35826,250830,30,4448,30,4508,60,31,148.267,0.0
35828,2755,3,27,3,33,6,4,9.0,0.0
3583,424716,500,4500,500,5500,1000,501,9.0,0.5
35830,1097625,1000,20000,1000,22000,2000,1001,20.0,0.0
35831,16098,12,310,12,346,36,26,12.917,0.0
35832,2911,0,30,0,33,3,4,10.0,0.0
35836,11231,8,256,8,272,16,9,32.0,0.0
35838,1180026,1000,18999,1000,20999,2000,1001,18.999,0.0
3584,250273,500,3000,500,4000,1000,501,6.0,0.0
35841,3952,7,49,7,63,14,8,7.0,0.0
35844,13106,0,186,0,217,31,32,6.0,0.75
35849,178474,0,2648,0,2979,331,332,8.0,0.0
3585,279251,500,4000,500,5000,1000,501,8.0,1.0
35850,3531,3,69,3,75,6,4,23.0,0.0
35851,1108,1,10,1,12,2,2,10.0,0.0
3586,236413,500,2500,500,3500,1000,501,5.0,0.0
35861,1516100,1000,22131,1000,24131,2000,1001,22.131,0.0
35863,9830,0,204,0,212,8,9,25.5,0.0
3587,235749,500,2500,500,3500,1000,501,5.0,0.0
3588,63295,149,596,149,894,298,150,4.0,0.0
35885,4068,8,56,8,72,16,9,7.0,0.0
35887,2778,3,27,3,33,6,4,9.0,0.0
3589,631630,500,9038,500,10038,1000,501,18.076,0.5
35892,287624,300,4624,300,5543,919,621,7.47,0.0
35893,1179283,1000,19157,1000,21157,2000,1001,19.157,0.0
35895,15619,31,155,31,217,62,32,5.0,0.0
3590,297881,500,3500,500,4500,1000,501,7.0,0.0
35913,443645,488,6670,488,7646,976,489,13.668,0.0
35916,14677,0,175,0,210,35,36,5.0,0.0
3592,260401,116,5425,116,5657,232,117,46.767,0.0
3593,295910,500,3500,500,4500,1000,501,7.0,0.0
3594,250270,500,3000,500,4000,1000,501,6.0,0.0
3595,66328,156,624,156,936,312,157,4.0,0.0
3596,236291,500,2500,500,3500,1000,501,5.0,0.0
35962,247587,1000,1000,1000,3000,2000,1001,1.0,0.0
3597,94611,144,1872,144,2160,288,145,13.0,0.0
3599,170408,500,2000,500,3000,1000,501,4.0,0.0
3600,294888,500,3500,500,4500,1000,501,7.0,0.0
3601,66751,157,628,157,942,314,158,4.0,0.0
3602,63303,149,596,149,894,298,150,4.0,0.0
3603,422265,500,4500,500,5500,1000,501,9.0,0.0
3604,104040,144,2016,144,2304,288,145,14.0,0.0
3605,95849,144,2016,144,2304,288,145,14.0,0.5
3608,253866,500,3000,500,4000,1000,501,6.0,0.0
36085,31886,54,322,54,430,108,55,5.963,0.0
3609,295978,500,3500,500,4500,1000,501,7.0,0.0
36093,20931,9,461,9,488,27,20,25.611,0.5
36096,7175,0,88,0,103,15,16,5.867,0.0
3610,294818,500,3500,500,4500,1000,501,7.0,0.0
36100,263050,219,4609,219,5047,438,220,21.046,0.0
36101,1218,0,12,0,13,1,2,12.0,0.0
36107,1318,1,9,1,11,2,2,9.0,0.0
36108,5022,0,60,0,70,10,11,6.0,0.0
36109,62184,189,579,189,957,378,190,3.063,0.0
3611,250059,500,3000,500,4000,1000,501,6.0,0.0
36114,938749,0,17000,0,18000,1000,1001,17.0,0.0
36115,13341,0,154,0,180,26,27,5.923,0.0
36118,350598,763,3815,763,5341,1526,764,5.0,0.0
3612,236827,500,2500,500,3500,1000,501,5.0,0.0
36135,9939,0,123,0,144,21,22,5.857,0.0
36139,40629,67,400,67,534,134,68,5.97,0.0
3614,107832,293,1142,293,1728,586,294,3.898,0.0
36140,23270,51,302,51,404,102,52,5.922,0.0
36141,27324,0,377,0,440,63,64,5.984,0.0
36142,21577,25,298,25,348,50,26,11.92,0.0
36143,22968,55,199,55,309,110,56,3.618,0.0
36144,29672,70,202,70,342,140,71,2.886,0.0
36145,11353,15,184,15,214,30,16,12.267,0.5
36146,9961,14,156,14,184,28,15,11.143,0.5
3615,313931,500,5513,500,6513,1000,501,11.026,0.0
36151,578994,0,8472,0,9472,1000,1001,8.472,0.0
36153,1364,0,18,0,19,1,2,18.0,0.5
36154,2716,0,48,0,50,2,3,24.0,0.0
36155,10338,17,153,17,187,34,18,9.0,0.0
3617,293090,500,3500,500,4500,1000,501,7.0,0.0
36178,1110,1,10,1,12,2,2,10.0,0.0
3618,294895,500,3500,500,4500,1000,501,7.0,0.0
3619,250235,500,3000,500,4000,1000,501,6.0,0.0
3620,261367,0,3178,0,3524,346,347,9.185,0.5
36202,1494,0,23,0,24,1,2,23.0,0.0
36206,80673,100,1500,100,1700,200,101,15.0,0.0
3621,259314,0,4000,0,4500,500,501,8.0,0.0
36219,1296,0,12,0,13,1,2,12.0,0.0
36224,211116,372,4093,372,4837,744,374,11.003,0.0
36225,3054,2,46,2,51,5,5,15.333,0.0
36229,4208,10,40,10,60,20,11,4.0,0.0
3623,275125,0,4000,0,4500,500,501,8.0,0.0
36233,4592,7,63,7,77,14,8,9.0,0.0
36239,35693,0,493,0,577,84,85,5.869,0.0
3624,847790,500,13000,500,14000,1000,501,26.0,0.0
36240,703690,1000,11980,1000,13980,2000,1001,11.98,0.0
36245,106475,269,1036,269,1574,538,270,3.851,0.5
36249,2221,0,22,0,24,2,3,11.0,0.0
36255,22056,9,461,9,488,27,20,25.611,0.6666666666666666
36256,21730,9,458,9,485,27,20,25.444,0.0
36265,5843,1,54,1,56,2,2,54.0,0.0
36279,46598,69,447,69,585,138,70,6.478,0.5
3628,507424,0,7497,0,7997,500,501,14.994,0.0
36280,32097,0,441,0,504,63,64,7.0,0.0
36284,24322,0,452,0,481,29,30,15.586,0.0
36286,3923,0,42,0,50,8,9,5.25,0.0
3629,230198,500,3000,500,4000,1000,501,6.0,0.5
36290,1212283,1000,18055,1000,20055,2000,1001,18.055,0.0
36291,1280,0,12,0,13,1,2,12.0,0.0
36293,5787,1,53,1,55,2,2,53.0,0.0
36298,1310,1,9,1,11,2,2,9.0,0.0
3630,572051,0,13500,0,14000,500,501,27.0,0.0
36309,34056,50,338,50,438,100,51,6.76,0.5
36321,30587,16,616,16,656,40,26,25.667,0.0
36325,32826,0,651,0,684,33,34,19.727,0.0
3633,1268880,500,22500,500,23500,1000,501,45.0,0.0
36331,1256334,1000,18025,1000,20025,2000,1001,18.025,0.5
36335,1106,0,10,0,11,1,2,10.0,0.0
36339,1107,0,10,0,11,1,2,10.0,0.0
3634,481709,500,6088,500,7088,1000,501,12.176,0.0
36341,3060,9,18,9,36,18,10,2.0,0.0
36342,177277,331,2648,331,3310,662,332,8.0,0.0
36349,14589,0,274,0,292,18,19,15.222,0.0
3635,3671361,0,38997,0,39497,500,501,77.994,0.5
36350,22678,0,410,0,439,29,30,14.138,0.0
36355,8638,12,125,12,149,24,13,10.417,0.0
3636,306843,0,4500,0,5000,500,501,9.0,0.0
36364,1109,0,10,0,11,1,2,10.0,0.0
36368,21600,9,459,9,486,27,20,25.5,0.0
36369,1246,0,12,0,13,1,2,12.0,0.0
36372,1897,0,28,0,29,1,2,28.0,0.0
36373,6077,0,70,0,83,13,14,5.385,0.0
36378,12823,0,186,0,217,31,32,6.0,1.0
36379,58288,0,805,0,920,115,116,7.0,0.0
36389,1560,0,23,0,24,1,2,23.0,0.0
3639,275456,0,4000,0,4500,500,501,8.0,0.0
36393,67487,0,826,0,944,118,119,7.0,0.0
36394,59205,0,831,0,886,55,56,15.109,0.0
36395,23229,0,303,0,354,51,52,5.941,0.0
36396,25788,0,357,0,417,60,61,5.95,0.0
36398,1336,0,9,0,10,1,2,9.0,0.0
36399,1113,1,10,1,12,2,2,10.0,0.0
3640,211448,249,3210,249,3708,498,250,12.892,0.0
36400,1113,0,10,0,11,1,2,10.0,0.0
36403,3750,4,72,4,80,8,5,18.0,0.0
36408,42387,0,940,0,990,50,51,18.8,0.75
36409,67223,17,616,17,650,34,18,36.235,0.0
3641,465993,500,7500,500,8500,1000,501,15.0,0.5
36411,31411,66,549,66,681,132,67,8.318,0.0
36412,10760,26,104,26,156,52,27,4.0,0.0
36415,43928,0,513,0,570,57,58,9.0,0.0
36417,11790,0,120,0,150,30,31,4.0,0.0
36419,1324,0,12,0,13,1,2,12.0,0.0
3642,966652,0,12000,0,12500,500,501,24.0,0.5
36420,32501,0,378,0,420,42,43,9.0,0.0
36424,27311,0,519,0,550,31,32,16.742,0.0
36425,1143487,1000,22936,1000,24936,2000,1001,22.936,0.0
36427,28541,55,440,55,550,110,56,8.0,0.0
3643,483320,500,6125,500,7125,1000,501,12.25,0.0
36430,2122,0,16,0,20,4,5,4.0,0.0
36432,42450,0,940,0,990,50,51,18.8,0.75
36434,949236,0,14263,0,15208,945,946,15.093,0.0
36435,44768,58,580,58,696,116,59,10.0,0.0
36436,7617,19,91,19,129,38,21,4.789,0.0
36439,2790,3,33,3,42,9,8,5.5,0.0
3644,309897,0,6000,0,6500,500,501,12.0,0.0
36446,29908,61,414,61,536,122,62,6.787,0.0
3645,294736,0,5000,0,5500,500,501,10.0,0.5
36455,25840,41,602,41,684,82,42,14.683,0.0
36459,33490,41,696,41,778,82,42,16.976,0.0
3646,259286,0,4000,0,4500,500,501,8.0,0.0
36460,41136,30,566,30,626,60,31,18.867,0.0
36461,22410,11,398,11,431,33,24,18.091,1.0
36462,32463,0,640,0,673,33,34,19.394,0.0
36464,63965,0,888,0,1039,151,152,5.881,0.0
36466,44752,0,623,0,729,106,107,5.877,0.0
36467,36163,53,530,53,636,106,54,10.0,0.0
36469,9261,0,90,0,100,10,11,9.0,0.0
3647,385758,115,2565,115,2866,301,165,22.304,0.75
36470,15375,31,153,31,215,62,32,4.935,0.0
36478,2119,1,18,1,23,5,6,4.5,0.0
3648,259284,0,4000,0,4500,500,501,8.0,0.0
36480,8350,0,150,0,165,15,16,10.0,0.0
36484,22712,19,551,19,589,38,20,29.0,0.0
36487,209851,0,2714,0,2935,221,222,12.281,0.5
36488,2859,0,27,0,30,3,4,9.0,0.0
36489,41015,30,566,30,626,60,31,18.867,0.0
3649,137825,0,2385,0,2454,69,70,34.565,0.0
36491,16588,35,175,35,245,70,36,5.0,0.0
36492,13586,32,144,32,208,64,34,4.5,0.0
36493,57324,0,815,0,856,41,42,19.878,0.0
36494,1395,0,12,0,13,1,2,12.0,0.0
36495,88422,148,1320,148,1616,296,149,8.919,0.0
36496,486998,693,8315,693,9701,1386,694,11.999,0.0
36497,49018,0,576,0,640,64,65,9.0,0.0
36498,2108,0,18,0,20,2,3,9.0,0.0
3650,309882,0,6000,0,6500,500,501,12.0,0.0
36500,9074,14,112,14,140,28,15,8.0,0.0
3651,274141,0,4000,0,4500,500,501,8.0,0.0
36514,29672,70,202,70,342,140,71,2.886,0.0
36519,179578,331,2648,331,3310,662,332,8.0,0.0
3652,31704,0,440,0,480,40,41,11.0,0.0
3653,480736,500,7500,500,8500,1000,501,15.0,0.0
36536,11107,2,108,2,112,4,3,54.0,0.0
36537,1011205,0,19000,0,20000,1000,1001,19.0,0.0
36538,126270,44,3124,44,3212,88,45,71.0,0.0
36539,28690,61,392,61,514,122,62,6.426,0.0
3654,509678,500,6500,500,7500,1000,501,13.0,0.0
36548,1491,1,23,1,25,2,2,23.0,0.0
3655,662394,0,9228,0,9728,500,501,18.456,0.0
36553,101984,185,1627,185,1997,370,186,8.795,0.0
3656,516286,0,6000,0,6500,500,501,12.0,0.0
36564,2783,3,33,3,42,9,8,5.5,0.0
36565,66410,0,812,0,928,116,117,7.0,0.0
36566,209851,0,2714,0,2935,221,222,12.281,0.5
3657,274130,0,4000,0,4500,500,501,8.0,0.0
36573,639907,1000,10922,1000,12922,2000,1001,10.922,0.0
36576,73559,133,1197,133,1463,266,134,9.0,1.0
3658,538443,0,6500,0,7000,500,501,13.0,0.0
36584,26720,11,616,11,649,33,24,28.0,0.0
36588,7266,11,88,11,110,22,12,8.0,0.0
3660,191766,243,1944,243,2430,486,244,8.0,0.75
36601,11974,29,145,29,203,58,30,5.0,0.0
3661,471010,500,7500,500,8500,1000,501,15.0,0.0
3662,503544,500,6000,500,7000,1000,501,12.0,0.0
36627,147475,0,2004,0,2356,352,353,5.693,0.0
36628,13853,24,212,24,260,48,25,8.833,0.75
3663,98153,0,1408,0,1536,128,129,11.0,0.0
36638,28979,61,392,61,514,122,62,6.426,0.0
3664,343324,0,5000,0,5500,500,501,10.0,0.0
36643,74119,134,1200,134,1468,268,135,8.955,1.0
3665,509094,0,6000,0,6500,500,501,12.0,0.0
36651,9934,0,248,0,256,8,9,31.0,0.0
3666,479680,500,6105,500,7105,1000,501,12.21,0.0
36666,48461,37,763,37,898,135,100,7.786,0.0
3668,275222,0,4000,0,4500,500,501,8.0,0.0
36682,1514,1,14,1,16,2,2,14.0,0.0
3669,128058,0,1674,0,2010,336,337,4.982,0.0
3670,529939,0,6500,0,7000,500,501,13.0,0.0
36716,30125,0,640,0,690,50,51,12.8,1.0
36719,1595,2,16,2,20,4,3,8.0,0.0
3672,259241,0,4000,0,4500,500,501,8.0,0.0
3673,15585,23,115,23,195,80,47,5.0,0.0
3674,114918,0,1661,0,1812,151,152,11.0,0.0
3675,167433,277,1662,277,2216,554,278,6.0,0.0
3676,678539,500,8974,500,9974,1000,501,17.948,0.5
3677,391568,0,4282,0,4782,500,501,8.564,1.0
3679,514976,0,6000,0,6500,500,501,12.0,0.0
3680,529900,0,6500,0,7000,500,501,13.0,0.0
36804,14141,0,135,0,162,27,28,5.0,0.0
36806,1353,0,9,0,10,1,2,9.0,0.0
36807,1307,0,12,0,13,1,2,12.0,0.0
3681,376926,0,5746,0,6084,338,339,17.0,0.0
36814,22031,9,461,9,488,27,20,25.611,0.0
3682,91823,222,1110,222,1554,444,223,5.0,0.0
36822,67249,0,826,0,944,118,119,7.0,0.0
3684,275248,0,4000,0,4500,500,501,8.0,0.0
3686,503221,500,6000,500,7000,1000,501,12.0,0.0
3687,324318,0,3108,0,3367,259,260,12.0,0.0
36875,14071,23,207,23,253,46,24,9.0,0.0
36877,1109,1,10,1,12,2,2,10.0,0.0
3688,395344,0,5797,0,6138,341,342,17.0,0.0
36888,30536,16,616,16,656,40,26,25.667,0.0
3689,500009,500,6000,500,7000,1000,501,12.0,0.0
36897,23264,51,302,51,404,102,52,5.922,0.0
3690,538484,0,6500,0,7000,500,501,13.0,0.0
36904,22675,47,185,47,279,94,48,3.936,0.0
36907,7876,13,117,13,143,26,14,9.0,0.0
3691,538338,0,6500,0,7000,500,501,13.0,0.0
36915,30243,0,592,0,624,32,33,18.5,0.0
36918,185662,58,2499,58,2615,116,59,43.086,0.0
36922,21130,18,414,18,459,45,29,15.333,0.0
3693,538546,0,6500,0,7000,500,501,13.0,0.0
3694,516692,0,6000,0,6500,500,501,12.0,1.0
3695,797702,500,13323,500,14323,1000,501,26.646,1.0
36962,37971,54,701,54,809,108,55,12.981,0.5
3697,277109,200,3466,200,4064,598,395,17.33,1.0
36972,43049,17,678,17,712,34,18,39.882,1.0
36991,14770,12,263,12,299,36,26,10.958,1.0
36993,2787,3,33,3,42,9,8,5.5,0.0
36994,31035,41,607,41,689,82,42,14.805,0.0
3700,804702,985,10724,985,12694,1970,987,10.887,0.5
37002,20589,29,232,29,290,58,30,8.0,0.0
37003,30897,16,736,16,768,32,17,46.0,0.0
37004,13082,0,186,0,217,31,32,6.0,0.75
37007,2784,3,33,3,42,9,8,5.5,0.0
37010,38635,66,462,66,594,132,67,7.0,1.0
37011,11983,0,153,0,180,27,28,5.667,0.0
37018,67249,0,826,0,944,118,119,7.0,0.0
37022,2795,3,33,3,42,9,8,5.5,0.0
37028,3045,4,32,4,40,8,5,8.0,0.0
37034,31627,0,619,0,652,33,34,18.758,0.0
37038,30120,50,636,50,736,100,51,12.72,1.0
37039,1038402,1000,19000,1000,21000,2000,1001,19.0,0.0
37040,91067,69,828,69,966,138,70,12.0,0.5
37044,23302,51,303,51,405,102,52,5.941,0.0
37048,1031725,1000,11838,1000,13838,2000,1001,11.838,0.0
37050,23498,51,303,51,405,102,52,5.941,0.0
37052,33800,36,754,36,826,72,37,20.944,0.0
37056,30175,61,412,61,534,122,62,6.754,0.0
37057,4145,7,56,7,70,14,8,8.0,0.0
3706,950810,500,11316,500,12316,1000,502,22.632,0.0
37060,2481,0,28,0,30,2,3,14.0,0.0
37061,23479,51,302,51,404,102,52,5.922,0.0
37064,32125,41,613,41,695,82,42,14.951,0.0
37065,67486,118,826,118,1062,236,119,7.0,0.0
37069,57638,106,1015,106,1227,212,107,9.575,0.0
3707,342267,0,5214,0,5487,273,268,22.67,0.5
37070,1037620,1000,18991,1000,20991,2000,1001,18.991,0.0
37072,10478,0,246,0,254,8,9,30.75,0.0
37075,17429,25,225,25,275,50,26,9.0,0.5
37077,34185,0,670,0,703,33,34,20.303,0.0
37078,23493,0,375,0,404,29,30,12.931,0.0
37079,5490,1,50,1,52,2,2,50.0,0.0
3708,305719,500,4500,500,5500,1000,501,9.0,0.0
37082,28799,72,288,72,432,144,73,4.0,0.0
37083,2094,3,24,3,30,6,4,8.0,0.0
37084,66927,117,819,117,1053,234,118,7.0,0.0
37087,2793,3,33,3,42,9,8,5.5,0.0
37088,11278,23,180,23,226,46,24,7.826,0.0
3709,181042,304,2736,304,3344,608,305,9.0,0.0
37090,2101,0,20,0,22,2,3,10.0,0.0
37091,21940,9,461,9,488,27,20,25.611,0.5
37092,1510,1,14,1,16,2,2,14.0,0.0
37094,5701,9,81,9,99,18,10,9.0,0.0
37099,56381,51,798,51,900,102,52,15.647,1.0
3710,223106,500,2500,500,3500,1000,501,5.0,0.0
37109,27220,37,332,37,406,74,38,8.973,0.0
3711,18075,37,184,37,258,74,38,4.973,0.0
37110,2413,3,24,3,30,6,4,8.0,0.0
37112,177224,331,2648,331,3310,662,332,8.0,0.0
37114,25511,28,374,28,430,56,29,13.357,0.0
3712,59536,83,581,83,747,166,84,7.0,0.0
37128,13918,24,214,24,262,48,25,8.917,0.5
37129,25219,39,343,39,421,78,40,8.795,0.0
3713,2755,5,22,5,32,10,6,4.4,0.5
37141,21151,41,287,41,369,82,42,7.0,0.0
37148,67496,0,826,0,944,118,119,7.0,0.0
3715,225928,500,2500,500,3500,1000,501,5.0,0.0
37151,66409,116,812,116,1044,232,117,7.0,0.0
37158,179394,331,2648,331,3310,662,332,8.0,0.0
3716,79256,48,1392,48,1488,96,49,29.0,0.0
37167,42618,0,940,0,990,50,51,18.8,0.75
37169,10216,9,117,9,135,18,10,13.0,0.0
3717,18426,0,308,0,319,11,12,28.0,0.0
37176,1799,0,16,0,18,2,3,8.0,0.5
3718,25211,0,199,0,212,13,14,15.308,0.0
37180,19872,0,434,0,443,9,10,48.222,0.5
37182,26348,53,318,53,424,106,54,6.0,0.0
37184,3640,5,40,5,50,10,6,8.0,0.0
37189,3614,0,36,0,40,4,5,9.0,0.0
3719,121569,315,1260,315,1890,630,316,4.0,0.0
37190,1103516,1000,15032,1000,17032,2000,1001,15.032,0.0
37194,956,0,4,0,5,1,2,4.0,0.0
37195,46418,52,520,52,624,104,53,10.0,0.0
37197,12903,6,144,6,183,39,35,4.364,0.0
37199,22398,9,461,9,488,27,20,25.611,0.5
3720,365495,500,6500,500,7500,1000,502,13.0,0.0
37201,28565,0,450,0,516,66,67,6.818,0.0
37202,25147,10,560,10,590,30,22,28.0,0.0
37203,32674,0,676,0,728,52,53,13.0,0.0
37204,1149722,1000,18014,1000,20014,2000,1001,18.014,0.0
37205,25764,0,550,0,582,32,33,17.188,0.0
37209,2784,3,33,3,42,9,8,5.5,0.0
3721,241570,500,3493,500,4493,1000,501,6.986,0.75
37210,31384,0,552,0,618,66,67,8.364,0.0
37214,66405,116,812,116,1044,232,117,7.0,0.0
37217,149800,337,2124,337,2798,674,338,6.303,0.0
37219,28911,53,424,53,530,106,54,8.0,0.0
3722,249853,500,4000,500,5000,1000,501,8.0,0.0
37224,66924,117,819,117,1053,234,118,7.0,0.0
3723,183135,500,2000,500,3000,1000,501,4.0,0.0
37230,2671,3,33,3,39,6,4,11.0,0.0
37231,30416,53,742,53,848,106,54,14.0,0.0
37234,2100,0,20,0,22,2,3,10.0,0.5
37236,25130,10,560,10,590,30,22,28.0,0.0
37237,28433,61,392,61,514,122,62,6.426,0.0
3724,40759,87,435,87,609,174,88,5.0,0.0
37240,1240414,1000,19807,1000,21807,2000,1001,19.807,0.0
37242,53051,77,1232,77,1386,154,78,16.0,0.0
37243,13862,24,214,24,262,48,25,8.917,0.75
37246,4219,6,48,6,60,12,7,8.0,0.0
37247,36716,14,578,14,606,28,15,41.286,1.0
37248,2784,3,33,3,42,9,8,5.5,0.0
3725,56773,130,650,130,910,260,131,5.0,0.0
37250,24175,33,558,33,624,66,34,16.909,0.0
37251,16818,25,240,25,290,50,26,9.6,0.0
37252,11886,0,108,0,135,27,28,4.0,0.0
37253,5879,0,113,0,121,8,9,14.125,0.0
37254,15684,25,175,25,225,50,26,7.0,0.5
37256,18267,7,392,7,413,21,16,28.0,0.0
37259,12071,17,174,17,208,34,18,10.235,0.0
3726,605651,500,12000,500,13000,1000,501,24.0,0.0
37260,12411,5,280,5,295,15,12,28.0,0.0
37261,68229,0,938,0,1072,134,135,7.0,0.0
37262,16690,25,175,25,225,50,26,7.0,0.0
37263,990004,1000,16321,1000,18321,2000,1001,16.321,0.0
37268,22419,32,336,32,400,64,33,10.5,0.0
37269,1401,1,12,1,14,2,2,12.0,0.0
3727,607379,500,12000,500,13000,1000,501,24.0,0.0
37271,137582,205,2005,205,2415,410,206,9.78,0.0
37272,14013,23,207,23,253,46,24,9.0,0.0
37277,28695,40,590,40,670,80,41,14.75,0.0
3728,61979,110,770,110,990,220,111,7.0,0.0
37281,13980,23,207,23,253,46,24,9.0,0.0
37282,17238,0,233,0,273,40,41,5.825,0.0
37283,31967,0,628,0,661,33,34,19.03,0.0
37286,24434,43,344,43,430,86,44,8.0,0.0
37287,1557,1,23,1,25,2,2,23.0,0.0
3729,620626,500,8293,500,9293,1000,501,16.586,0.0
37290,26387,32,560,32,624,64,33,17.5,0.0
37292,53778,107,740,107,954,214,108,6.916,0.0
37296,28738,53,371,53,477,106,54,7.0,0.0
37299,15439,11,296,11,329,33,24,13.455,0.5
3730,226233,500,2500,500,3500,1000,501,5.0,0.0
37302,16632,25,175,25,225,50,26,7.0,0.0
37304,15872,0,271,0,293,22,23,12.318,0.0
37308,18149,50,200,50,300,100,51,4.0,0.0
3731,184816,500,2500,500,3500,1000,501,5.0,0.0
37310,1140506,1000,18000,1000,20000,2000,1001,18.0,0.0
37312,30026,24,608,24,656,48,26,25.333,0.0
37314,2572,6,18,6,30,12,7,3.0,0.0
37319,40544,0,553,0,632,79,80,7.0,0.0
3732,539859,200,4088,200,4488,400,201,20.44,0.0
37320,1505,1,14,1,16,2,2,14.0,0.0
37331,67504,118,826,118,1062,236,119,7.0,0.0
3734,189627,500,2500,500,3500,1000,501,5.0,0.0
37343,40806,106,583,106,795,212,108,5.5,0.75
3735,204486,500,2917,500,3917,1000,501,5.834,0.0
37354,41473,54,378,54,486,108,55,7.0,0.0
3736,134163,381,1522,381,2284,762,382,3.995,0.0
37362,1135005,0,20981,0,21981,1000,1001,20.981,0.0
37365,49421,0,670,0,716,46,47,14.565,0.0
37366,1940,2,22,2,26,4,3,11.0,0.0
37367,16647,25,175,25,225,50,26,7.0,1.0
37368,8091,0,120,0,135,15,16,8.0,1.0
3737,463482,500,7312,500,8312,1000,501,14.624,0.0
37371,1786510,490,24970,490,25950,980,491,50.959,0.0
37373,21820,41,291,41,373,82,42,7.098,0.0
37378,1106,0,10,0,11,1,2,10.0,0.0
3738,201928,500,2997,500,3997,1000,501,5.994,0.0
37381,9223,0,30,0,45,15,16,2.0,0.0
37385,13431,52,52,52,156,104,53,1.0,0.0
3739,18426,0,308,0,319,11,12,28.0,0.0
37392,5918,0,63,0,70,7,8,9.0,0.0
37395,4930,8,67,8,83,16,9,8.375,0.0
37396,28112,30,404,30,464,60,31,13.467,0.0
3740,23631,36,288,36,360,72,37,8.0,0.5
37400,3648,6,48,6,60,12,7,8.0,0.0
37401,15656,25,175,25,225,50,26,7.0,0.5
37403,66404,0,812,0,928,116,117,7.0,0.0
37404,66408,116,812,116,1044,232,117,7.0,0.0
37407,20902,30,320,30,380,60,31,10.667,0.0
37408,133719,215,2365,215,2795,430,216,11.0,0.0
3741,298556,500,4500,500,5500,1000,501,9.0,0.0
37413,44424,66,792,66,924,132,67,12.0,0.0
37414,39706,68,673,68,809,136,69,9.897,0.0
37415,670785,0,10391,0,11391,1000,1001,10.391,0.0
37418,38647,68,136,68,272,136,69,2.0,0.0
37419,9001,0,119,0,136,17,18,7.0,0.0
3742,1047901,909,9454,909,11272,1818,911,10.4,0.0
37421,1335,0,9,0,10,1,2,9.0,0.0
37425,134136,215,2365,215,2795,430,216,11.0,0.0
37426,31743,0,623,0,656,33,34,18.879,0.0
37429,30005,42,495,42,579,84,43,11.786,0.0
37431,38735,42,756,42,840,84,43,18.0,0.0
37432,31224,41,615,41,697,82,42,15.0,0.0
3744,299091,380,4528,380,5288,760,381,11.916,0.0
37445,51339,43,1809,43,1895,86,44,42.07,0.0
37448,33835,0,665,0,698,33,34,20.152,0.0
37452,17773,29,290,29,348,58,30,10.0,0.0
37454,66922,117,819,117,1053,234,118,7.0,0.0
37455,873416,1000,12121,1000,14121,2000,1001,12.121,0.0
37458,68833,79,1422,79,1580,158,80,18.0,0.0
3746,519113,500,8431,500,9431,1000,501,16.862,0.0
37460,18267,7,392,7,413,21,16,28.0,0.0
37463,66398,116,812,116,1044,232,117,7.0,0.0
37475,66409,116,812,116,1044,232,117,7.0,0.0
3748,428344,0,8500,0,9000,500,501,17.0,0.0
3749,2295887,0,27985,0,28485,500,501,55.97,0.0
3750,22461,39,195,39,273,78,40,5.0,0.0
3751,843176,0,21658,0,22100,442,443,49.0,0.0
3752,1119520,0,14557,0,15057,500,501,29.114,0.0
3753,1306688,1000,20581,1000,22911,2330,1323,20.581,0.0
37560,27243,41,492,41,574,82,42,12.0,0.0
37561,1247421,1000,18025,1000,20025,2000,1001,18.025,0.0
37564,88422,148,1320,148,1616,296,149,8.919,0.5
37565,23436,53,318,53,424,106,54,6.0,0.0
37569,16687,25,175,25,225,50,26,7.0,1.0
3757,391778,0,5070,0,5265,195,196,26.0,0.0
37570,245716,280,4452,280,5012,560,281,15.9,0.0
37575,4862,7,56,7,70,14,8,8.0,0.0
37577,11831,0,108,0,135,27,28,4.0,0.0
3758,28890,0,461,0,489,28,29,16.464,0.0
37582,292318,0,4563,0,5126,563,564,8.105,0.0
3759,222868,0,2500,0,3000,500,501,5.0,0.0
3760,239307,0,2500,0,3000,500,501,5.0,0.0
3761,106804,0,1443,0,1480,37,38,39.0,0.0
37613,21724,30,320,30,380,60,31,10.667,0.0
37618,15797,25,175,25,225,50,26,7.0,0.5
3762,288475,437,3059,437,3933,874,439,7.0,0.5
3763,4449,6,48,6,60,12,8,8.0,0.0
37632,57426,31,1395,31,1457,62,32,45.0,0.5
37637,15673,25,175,25,225,50,26,7.0,0.5
3764,15200,7,224,7,238,14,9,32.0,0.0
37640,1185247,1000,19703,1000,21703,2000,1001,19.703,0.0
37645,17789,25,225,25,275,50,26,9.0,0.0
37646,17774,25,225,25,275,50,26,9.0,0.0
37649,28833,41,591,41,673,82,42,14.415,0.0
3765,6492,13,65,13,91,26,15,5.0,0.0
37651,14537664,1000,207905,1000,209905,2000,1001,207.905,0.0
37654,17510,25,225,25,275,50,26,9.0,0.5
37655,30044,24,608,24,656,48,26,25.333,0.0
37656,16683,25,175,25,225,50,26,7.0,0.0
37657,13162,5,280,5,295,15,12,28.0,0.0
37659,66417,116,812,116,1044,232,117,7.0,0.0
3766,1251895,500,20365,500,21365,1000,502,40.73,0.0
3767,379231,500,6000,500,7000,1000,502,12.0,0.0
37674,27801,11,616,11,649,33,24,28.0,0.0
3768,98783,70,1079,70,1289,210,111,15.414,0.0
37685,16652,25,175,25,225,50,26,7.0,0.0
3769,5703,6,69,6,81,12,8,11.5,0.0
37690,721733,1000,11998,1000,13998,2000,1001,11.998,0.0
37691,16659,25,175,25,225,50,26,7.0,0.0
37698,1126782,1000,13953,1000,15953,2000,1001,13.953,0.0
3770,12913,20,160,20,200,40,22,8.0,0.0
37701,132874,215,2365,215,2795,430,216,11.0,0.0
37702,16657,25,175,25,225,50,26,7.0,1.0
37706,1191709,1000,18834,1000,20834,2000,1001,18.834,0.0
37707,247587,1000,1000,1000,3000,2000,1001,1.0,0.0
3771,8310,19,76,19,114,38,21,4.0,0.75
3772,7790,5,160,5,170,10,7,32.0,0.0
37721,969106,1000,16196,1000,18196,2000,1001,16.196,0.0
37723,16683,25,175,25,225,50,26,7.0,1.0
37726,496227,1000,7000,1000,9000,2000,1001,7.0,0.0
37727,15786,25,175,25,225,50,26,7.0,0.5
3773,329339,500,3165,500,4165,1000,502,6.33,0.0
37735,130941,215,2365,215,2795,430,216,11.0,0.0
3774,4250,9,36,9,54,18,11,4.0,0.0
37748,1229790,1000,19764,1000,21764,2000,1001,19.764,0.0
3775,5575,11,55,11,77,22,13,5.0,0.0
37752,1173339,1000,18141,1000,20141,2000,1001,18.141,0.0
37754,850059,1000,17241,1000,19241,2000,1001,17.241,0.0
37756,1137705,1000,18014,1000,20014,2000,1001,18.014,0.0
37764,17762,25,225,25,275,50,26,9.0,0.0
37767,1180806,1000,19597,1000,21597,2000,1001,19.597,0.0
3777,15821,18,126,18,162,36,20,7.0,0.0
37778,176451,712,712,712,2136,1424,713,1.0,0.0
3778,45224,0,518,0,555,37,38,14.0,0.0
37787,247587,1000,1000,1000,3000,2000,1001,1.0,0.0
3779,50997,0,629,0,666,37,38,17.0,0.0
37790,21554,42,252,42,336,84,43,6.0,0.0
37793,3501959,464,19024,464,19952,928,465,41.0,0.0
37795,251588,1000,1000,1000,3000,2000,1001,1.0,0.0
37796,7155,13,104,13,130,26,14,8.0,0.0
3780,63261,0,851,0,888,37,38,23.0,0.0
37802,15784,25,175,25,225,50,26,7.0,0.5
37804,503158,1000,7000,1000,9000,2000,1001,7.0,0.0
37809,2453745,1000,43000,1000,45000,2000,1001,43.0,0.0
3781,7891,5,155,5,165,10,7,31.0,0.0
37811,131734,215,2365,215,2795,430,216,11.0,0.0
37813,17746,25,225,25,275,50,26,9.0,0.0
37815,131357,215,2365,215,2795,430,216,11.0,0.0
3782,26509,20,348,20,388,40,22,17.4,0.0
3783,42542,0,518,0,555,37,38,14.0,0.0
37830,8380,15,150,15,180,30,16,10.0,0.0
37833,132606,215,2365,215,2795,430,216,11.0,0.0
37840,4536873,1000,83317,1000,85317,2000,1001,83.317,0.0
37842,448509,756,6602,756,8114,1512,757,8.733,0.0
3785,2972,5,25,5,35,10,7,5.0,0.0
37854,274004,80,6000,80,6160,160,81,75.0,0.0
37860,1201193,1000,19960,1000,21960,2000,1001,19.96,0.0
37861,58138,233,233,233,699,466,234,1.0,0.0
37862,932,0,4,0,5,1,2,4.0,0.0
37863,934,1,4,1,6,2,2,4.0,0.0
37866,932,0,4,0,5,1,2,4.0,0.0
37869,20347,80,80,80,240,160,81,1.0,0.0
3787,3158,7,21,7,35,14,9,3.0,0.0
37871,445612,0,6336,0,7021,685,686,9.25,0.0
37873,250180,0,3914,0,4398,484,485,8.087,0.0
37874,934,0,4,0,5,1,2,4.0,0.0
37875,2316,7,7,7,21,14,8,1.0,0.0
37876,14177,28,168,28,224,56,29,6.0,0.0
37879,3288925,1000,36503,1000,38503,2000,1001,36.503,0.0
3788,5149,11,44,11,66,22,13,4.0,0.0
37880,10148,7,115,7,129,14,8,16.429,0.0
37882,2434443,1000,43000,1000,45000,2000,1001,43.0,0.0
37884,247587,1000,1000,1000,3000,2000,1001,1.0,0.0
37885,1153069,1000,18196,1000,20196,2000,1001,18.196,0.0
37886,677807,1000,12321,1000,14321,2000,1001,12.321,0.5
37888,569755,835,10425,835,12095,1670,836,12.485,0.0
37889,1128089,1000,17996,1000,19996,2000,1001,17.996,0.0
3789,3146,7,21,7,35,14,9,3.0,0.0
37898,1125758,1000,18026,1000,20026,2000,1001,18.026,0.0
3790,5782,11,55,11,77,22,13,5.0,0.0
37901,2459056,1000,43000,1000,45000,2000,1001,43.0,0.0
37905,846403,1000,12432,1000,14432,2000,1001,12.432,0.0
37907,282741,0,4352,0,4881,529,530,8.227,0.0
3791,644575,0,8929,0,9429,500,501,17.858,0.0
37910,130387,215,2365,215,2795,430,216,11.0,0.0
37913,19828815,588,19401,588,20577,1176,589,32.995,0.0
37914,247587,1000,1000,1000,3000,2000,1001,1.0,0.0
37915,42508,48,912,48,1008,96,49,19.0,0.0
37918,132377,215,2365,215,2795,430,216,11.0,0.0
3792,694610,0,9017,0,9517,500,501,18.034,0.0
37922,668502,1000,12193,1000,14193,2000,1001,12.193,0.0
37923,129077,215,2365,215,2795,430,216,11.0,0.0
37929,7139,13,104,13,130,26,14,8.0,0.0
3793,461792,0,6306,0,6806,500,501,12.612,0.0
37936,680736,1000,12393,1000,14393,2000,1001,12.393,0.0
37937,443092,688,6324,688,7700,1376,689,9.192,0.0
37939,17871,29,230,29,288,58,30,7.931,0.0
3794,680315,500,14563,500,15563,1000,501,29.126,0.5
37940,505532,1000,7000,1000,9000,2000,1001,7.0,0.0
37944,1165524,1000,18210,1000,20210,2000,1001,18.21,0.0
3795,14396,0,234,0,248,14,15,16.714,0.0
37956,244129,986,986,986,2958,1972,987,1.0,0.0
37957,11750,27,135,27,189,54,28,5.0,0.0
37959,2438644,1000,43000,1000,45000,2000,1001,43.0,0.0
3796,346735,0,4464,0,4712,248,249,18.0,0.0
37961,2430491,1000,43000,1000,45000,2000,1001,43.0,0.0
37962,200808,0,3121,0,3503,382,383,8.17,0.0
37963,690736,1000,12491,1000,14491,2000,1001,12.491,0.0
37965,1015594,1000,17520,1000,19520,2000,1001,17.52,0.0
37966,1269150,1000,21552,1000,23552,2000,1001,21.552,0.0
37967,1132090,1000,17996,1000,19996,2000,1001,17.996,0.0
37968,2443598,1000,43000,1000,45000,2000,1001,43.0,0.0
37969,245280,359,4484,359,5202,718,360,12.49,0.0
3797,904060,0,13083,0,13583,500,501,26.166,0.0
37970,75155,117,1129,117,1476,347,218,9.65,0.5
37971,209968,311,3889,311,4511,622,312,12.505,0.0
37972,20347,80,80,80,240,160,81,1.0,0.0
37973,247587,1000,1000,1000,3000,2000,1001,1.0,0.0
37974,932,0,4,0,5,1,2,4.0,0.0
37975,680307,1000,12438,1000,14438,2000,1001,12.438,0.0
37977,935,0,4,0,5,1,2,4.0,0.0
37979,251588,1000,1000,1000,3000,2000,1001,1.0,0.0
3798,8003,9,144,9,162,18,10,16.0,0.0
37980,685925,1000,12552,1000,14552,2000,1001,12.552,0.0
37981,450284,662,8275,662,9599,1324,663,12.5,0.0
37982,169110,115,2054,115,2284,230,116,17.861,0.5
37984,113847,106,1970,106,2182,212,107,18.585,0.0
37985,685632,1000,12481,1000,14481,2000,1001,12.481,0.0
37986,1133161,1000,18209,1000,20209,2000,1001,18.209,0.0
37987,932,0,4,0,5,1,2,4.0,0.0
37988,936,1,4,1,6,2,2,4.0,0.0
3799,5963,7,105,7,119,14,9,15.0,0.0
37995,1189981,1000,19981,1000,21981,2000,1001,19.981,0.0
37996,250455,370,4514,370,5254,740,371,12.2,0.0
37997,934,0,4,0,5,1,2,4.0,0.0
37998,247587,1000,1000,1000,3000,2000,1001,1.0,0.0
37999,67893,46,812,46,904,92,47,17.652,0.0
3800,252791,500,2466,500,3466,1000,502,4.932,1.0
38000,205571,0,3214,0,3610,396,397,8.116,0.0
38001,1148479,1000,18042,1000,20042,2000,1001,18.042,0.0
38004,247587,1000,1000,1000,3000,2000,1001,1.0,0.0
38008,1148430,1000,18728,1000,20728,2000,1001,18.728,0.0
3801,5790,7,105,7,119,14,9,15.0,1.0
38012,102961,151,1904,151,2206,302,152,12.609,0.0
38013,682277,1000,12430,1000,14430,2000,1001,12.43,0.0
38014,243566,358,4494,358,5210,716,359,12.553,0.0
38015,275496,406,5090,406,5902,812,407,12.537,0.0
38016,496587,1000,7000,1000,9000,2000,1001,7.0,0.0
38018,204654,0,3164,0,3547,383,384,8.261,0.0
3802,1985,2,30,2,34,4,4,15.0,1.0
38020,2438053,1000,43000,1000,45000,2000,1001,43.0,0.0
38021,1410472,1000,23952,1000,25952,2000,1001,23.952,0.0
38022,1212431,1000,19740,1000,21740,2000,1001,19.74,0.0
38023,2430593,1000,43000,1000,45000,2000,1001,43.0,0.0
38024,2481209,1000,43000,1000,45000,2000,1001,43.0,0.0
38028,1169165,1000,18574,1000,20574,2000,1001,18.574,0.0
38029,1153268,1000,18939,1000,20939,2000,1001,18.939,0.0
3803,687187,662,7664,662,9433,1769,738,11.577,0.5
38030,1214566,1000,19413,1000,21413,2000,1001,19.413,0.0
38031,773177,1000,2000,1000,4000,2000,1001,2.0,0.0
38032,932,0,4,0,5,1,2,4.0,0.0
38033,3106416,1000,40035,1000,42035,2000,1001,40.035,0.5
38034,410868,606,7586,606,8798,1212,607,12.518,0.0
38035,1163310,1000,19205,1000,21205,2000,1001,19.205,0.0
38036,217447,153,4896,153,5202,306,154,32.0,0.0
38037,247587,1000,1000,1000,3000,2000,1001,1.0,0.5
38038,247587,1000,1000,1000,3000,2000,1001,1.0,0.0
38039,502588,1000,7000,1000,9000,2000,1001,7.0,0.0
38040,2459957,1000,43000,1000,45000,2000,1001,43.0,0.0
38042,1228250,1000,19812,1000,21812,2000,1001,19.812,0.0
38043,4862958,588,75264,588,76440,1176,589,128.0,0.0
38044,251588,1000,1000,1000,3000,2000,1001,1.0,0.0
38046,34366,69,483,69,621,138,70,7.0,0.0
38048,1752199,1000,29020,1000,31020,2000,1001,29.02,0.0
3805,549784,0,7794,0,8294,500,501,15.588,0.0
38057,1137259,1000,18178,1000,20178,2000,1001,18.178,0.0
38058,2451121,1000,43000,1000,45000,2000,1001,43.0,0.0
38059,485030,1000,7000,1000,9000,2000,1001,7.0,0.0
3806,9560,19,38,19,95,57,39,2.0,0.0
38060,2728054,588,73500,588,74676,1176,589,125.0,0.0
38066,1273379,1000,26000,1000,28000,2000,1001,26.0,0.0
3807,963903,0,15803,0,16303,500,501,31.606,0.0
38074,912717,672,15400,672,16744,1344,673,22.917,0.0
3808,957749,0,13821,0,14321,500,501,27.642,0.0
38082,1505644,1000,25885,1000,27885,2000,1001,25.885,0.5
38089,723388,1000,10769,1000,12769,2000,1001,10.769,0.0
3810,1199722,0,17813,0,18313,500,501,35.626,0.0
38107,1492280,1000,23939,1000,25939,2000,1001,23.939,0.0
3811,780106,0,13000,0,13500,500,501,26.0,0.0
38112,939128,1000,13175,1000,15175,2000,1001,13.175,0.0
38119,905488,1000,13853,1000,15853,2000,1001,13.853,0.0
3812,241343,0,2997,0,3497,500,501,5.994,0.0
38124,428280,769,5760,769,7298,1538,770,7.49,0.5
38125,1507801,1000,33941,1000,35941,2000,1001,33.941,0.0
38131,1256002,1000,20000,1000,22000,2000,1001,20.0,0.0
38145,1699154,1000,30208,1000,32208,2000,1001,30.208,0.0
3815,272139,500,3897,500,4897,1000,501,7.794,0.0
38158,1060280,1000,15985,1000,17985,2000,1001,15.985,0.0
38167,32020,23,520,23,566,46,24,22.609,0.0
38186,4694,12,45,12,69,24,13,3.75,0.0
38190,22116,0,230,0,290,60,61,3.833,0.75
38192,20472,60,230,60,350,120,61,3.833,0.0
38195,12514,0,130,0,165,35,36,3.714,0.0
38196,12959,35,129,35,199,70,36,3.686,0.0
38198,12486,0,134,0,169,35,36,3.829,0.0
38199,20231,60,230,60,350,120,61,3.833,0.0
3820,35056,51,357,51,459,102,52,7.0,0.0
38200,22236,60,230,60,350,120,61,3.833,0.75
38201,19038,0,205,0,260,55,56,3.727,0.0
38202,8780,25,85,25,135,50,26,3.4,0.0
38203,18988,55,205,55,315,110,56,3.727,0.0
38204,20947,0,230,0,290,60,61,3.833,0.0
38206,19970,0,200,0,260,60,61,3.333,0.0
38208,20210,60,230,60,350,120,61,3.833,0.0
38211,23712,65,245,65,375,130,66,3.769,0.0
38212,19786,60,200,60,320,120,61,3.333,0.0
38216,4869,12,46,12,70,24,13,3.833,0.5
38218,20567,0,230,0,290,60,61,3.833,0.0
38219,4403,11,42,11,64,22,12,3.818,1.0
38221,20803,60,230,60,350,120,61,3.833,0.0
38223,19507,0,200,0,260,60,61,3.333,0.5
38224,18988,55,205,55,315,110,56,3.727,0.0
38225,16279,48,184,48,280,96,49,3.833,0.0
38226,11580,0,112,0,144,32,33,3.5,0.0
38227,4645,0,46,0,58,12,13,3.833,0.0
38228,4437,12,44,12,68,24,13,3.667,0.0
38229,11475,0,112,0,144,32,33,3.5,0.0
38231,4165,11,42,11,64,22,12,3.818,0.0
38232,4752,12,46,12,70,24,13,3.833,0.0
38233,18913,55,205,55,315,110,56,3.727,1.0
38236,11063,0,112,0,144,32,33,3.5,0.0
38237,4151,11,42,11,64,22,12,3.818,0.0
38238,17126,0,180,0,232,52,53,3.462,0.0
38239,4943,0,45,0,57,12,13,3.75,0.0
38240,20210,60,230,60,350,120,61,3.833,0.0
38241,4577,0,42,0,54,12,13,3.5,0.0
38244,4884,0,45,0,57,12,13,3.75,0.0
38246,23712,65,245,65,375,130,66,3.769,0.0
38247,4737,12,46,12,70,24,13,3.833,0.0
38248,21889,0,230,0,290,60,61,3.833,0.0
38249,15422,0,164,0,208,44,45,3.727,0.0
38250,12271,35,125,35,195,70,36,3.571,0.0
38252,4569,0,47,0,59,12,13,3.917,0.0
38261,20927,60,220,60,340,120,61,3.667,0.0
38264,17224,50,180,50,280,100,51,3.6,0.0
38265,20443,60,230,60,350,120,61,3.833,1.0
38266,21535,60,220,60,340,120,61,3.667,0.0
38268,19008,55,200,55,310,110,56,3.636,0.0
38269,14435,40,140,40,220,80,41,3.5,0.0
38270,20027,60,200,60,320,120,61,3.333,0.0
38272,16607,48,188,48,284,96,49,3.917,0.75
38273,4403,11,42,11,64,22,12,3.818,1.0
38276,4621,0,42,0,54,12,13,3.5,0.0
38277,4167,11,42,11,64,22,12,3.818,1.0
38278,4820,12,46,12,70,24,13,3.833,0.5
38279,4587,12,46,12,70,24,13,3.833,0.5
38287,19929,60,220,60,340,120,61,3.667,0.0
3830,71482,0,660,0,825,165,166,4.0,0.0
38302,4889,12,46,12,70,24,13,3.833,0.0
38304,21640,60,230,60,350,120,61,3.833,0.0
38308,16548,0,184,0,232,48,49,3.833,0.6666666666666666
38310,21293,59,221,59,339,118,60,3.746,0.0
38311,13921,40,140,40,220,80,41,3.5,0.0
38313,20458,0,200,0,260,60,61,3.333,0.0
38315,21985,60,230,60,350,120,61,3.833,0.0
38316,4689,0,47,0,59,12,13,3.917,0.0
38319,18874,55,190,55,300,110,56,3.455,0.0
3832,531180,240,4506,240,4986,480,241,18.775,0.0
38321,19747,60,200,60,320,120,61,3.333,1.0
38325,3575,9,32,9,50,18,10,3.556,0.0
38326,15374,44,160,44,248,88,45,3.636,0.0
38337,4645,12,42,12,66,24,13,3.5,0.0
38338,16397,0,160,0,210,50,51,3.2,0.0
38339,4352,0,42,0,54,12,13,3.5,0.0
38340,4908,12,45,12,69,24,13,3.75,0.0
38341,21258,60,205,60,325,120,61,3.417,0.0
38343,16648,0,168,0,216,48,49,3.5,0.0
38344,4378,0,42,0,54,12,13,3.5,0.0
38345,4377,0,42,0,54,12,13,3.5,0.0
38346,18922,0,199,0,254,55,56,3.618,0.0
38347,5010,12,47,12,71,24,13,3.917,0.0
38348,12486,0,134,0,169,35,36,3.829,0.0
38349,4499,0,41,0,53,12,13,3.417,0.0
38351,20964,58,217,58,333,116,59,3.741,0.0
38352,20715,60,216,60,336,120,61,3.6,0.0
38353,21535,60,220,60,340,120,61,3.667,0.0
38354,21583,60,229,60,349,120,61,3.817,0.0
38355,20498,60,224,60,344,120,61,3.733,0.75
38356,4184,10,39,10,59,20,11,3.9,0.0
38357,20286,60,201,60,321,120,61,3.35,0.0
38358,5016,12,45,12,69,24,13,3.75,0.0
38359,20966,60,225,60,345,120,61,3.75,0.0
38360,17846,49,175,49,273,98,50,3.571,0.0
38361,20172,60,200,60,320,120,61,3.333,0.0
38362,21113,60,220,60,340,120,61,3.667,0.0
38363,21443,60,230,60,350,120,61,3.833,0.75
38364,4577,0,42,0,54,12,13,3.5,0.0
38365,20927,60,220,60,340,120,61,3.667,0.0
38366,21493,60,220,60,340,120,61,3.667,0.0
38367,21804,60,220,60,340,120,61,3.667,0.5
38368,21426,60,230,60,350,120,61,3.833,1.0
38373,4593,12,47,12,71,24,13,3.917,0.0
38374,22250,60,230,60,350,120,61,3.833,0.0
38375,21263,60,222,60,342,120,61,3.7,0.5
38376,20457,60,200,60,320,120,61,3.333,0.0
38377,20600,59,200,59,318,118,60,3.39,0.0
38384,4788,0,46,0,59,13,14,3.538,1.0
38385,3612,9,32,9,50,18,10,3.556,0.0
38386,4486,12,44,12,68,24,13,3.667,0.0
38388,18960,55,197,55,307,110,56,3.582,0.0
38389,3550,0,29,0,38,9,10,3.222,0.0
38390,21750,60,225,60,345,120,61,3.75,0.0
38392,20978,0,210,0,270,60,61,3.5,0.0
38393,3575,9,32,9,50,18,10,3.556,0.0
38396,4332,0,40,0,52,12,13,3.333,0.0
38397,20077,0,220,0,280,60,61,3.667,0.6666666666666666
38398,21985,60,230,60,350,120,61,3.833,0.0
38400,3873,6,30,6,48,18,13,5.0,0.0
38401,22245,60,235,60,355,120,61,3.917,0.0
38403,9214,24,92,24,140,48,25,3.833,1.0
38405,4633,12,46,12,70,24,13,3.833,0.0
38406,4889,12,46,12,70,24,13,3.833,0.0
38408,21547,60,220,60,340,120,61,3.667,0.0
38409,4399,0,42,0,54,12,13,3.5,0.0
38411,3557,0,32,0,41,9,10,3.556,0.0
38412,4001,0,36,0,46,10,11,3.6,0.0
38413,4637,12,46,12,70,24,13,3.833,0.0
38414,18170,55,190,55,300,110,56,3.455,0.8333333333333334
38415,4689,0,47,0,59,12,13,3.917,0.0
38416,4692,0,42,0,54,12,13,3.5,0.0
38420,4486,12,44,12,68,24,13,3.667,0.0
38425,19573,0,205,0,265,60,61,3.417,1.0
38426,4869,12,46,12,70,24,13,3.833,0.5
38428,16642,65,65,65,195,130,66,1.0,0.0
3843,22758,0,301,0,344,43,44,7.0,0.0
38431,4378,0,42,0,54,12,13,3.5,0.0
38432,20279,0,204,0,264,60,61,3.4,0.0
38433,20818,60,210,60,330,120,61,3.5,0.0
38434,4352,0,42,0,54,12,13,3.5,0.0
38436,3982,0,36,0,46,10,11,3.6,0.0
38437,1259,2,8,2,12,4,3,4.0,0.0
38438,4332,0,40,0,52,12,13,3.333,0.0
38439,15172,0,147,0,192,45,46,3.267,0.0
38441,4352,0,42,0,54,12,13,3.5,0.0
38444,4437,12,44,12,68,24,13,3.667,0.0
38447,5092,13,46,13,72,26,14,3.538,0.0
38449,4499,0,41,0,53,12,13,3.417,0.0
38450,3550,0,29,0,38,9,10,3.222,0.0
38459,4191,12,35,12,59,24,13,2.917,0.0
3846,2986,0,20,0,25,5,6,4.0,0.0
38464,791784,1000,11000,1000,13000,2000,1001,11.0,0.0
38465,34909,92,276,92,460,184,93,3.0,0.0
3850,7870,8,56,8,72,16,9,7.0,0.5
38509,208811,0,2520,0,3024,504,505,5.0,1.0
38521,55258,64,1055,64,1183,128,65,16.484,0.5
38536,511651,0,1848,0,1897,49,50,37.714,0.0
3854,6658,10,54,10,79,25,16,5.4,0.0
38544,220956,871,871,871,2613,1742,872,1.0,0.0
38570,373982,576,4608,576,5760,1152,577,8.0,0.0
3863,32867,31,205,31,288,83,51,6.613,0.0
38661,2870,9,9,9,27,18,10,1.0,0.0
38662,17042,64,64,64,192,128,65,1.0,0.0
3867,444339,0,7717,0,8142,425,426,18.158,0.0
3871,737343,1000,10902,1000,13402,2500,1502,7.268,0.0
3877,2921,0,27,0,31,4,5,6.75,0.0
3880,8985,0,92,0,104,12,13,7.667,0.0
38832,9201,22,88,22,132,44,23,4.0,0.0
38834,251591,1000,1000,1000,3000,2000,1001,1.0,0.0
38836,255592,1000,1000,1000,3000,2000,1001,1.0,0.0
38837,551705,1000,7851,1000,9851,2000,1001,7.851,0.0
38838,54070,117,585,117,819,234,118,5.0,0.0
38843,255592,1000,1000,1000,3000,2000,1001,1.0,0.0
38847,251591,1000,1000,1000,3000,2000,1001,1.0,1.0
38853,2976559,0,48105,0,49105,1000,1001,48.105,0.0
38863,704804,0,9508,0,10508,1000,1001,9.508,0.5
38870,251591,1000,1000,1000,3000,2000,1001,1.0,0.0
38873,1826762,1000,26980,1000,28980,2000,1001,26.98,0.0
3888,1521,1,7,1,9,2,2,7.0,0.0
38881,1070761,1000,20000,1000,22000,2000,1001,20.0,0.0
3889,5249,0,104,0,111,7,8,14.857,0.0
3892,512530,500,3194,500,4194,1000,502,6.388,0.0
38947,2132155,1000,27576,1000,29576,2000,1001,27.576,0.0
38948,251591,1000,1000,1000,3000,2000,1001,1.0,0.0
3895,38108,0,364,0,455,91,92,4.0,0.0
38958,348204,479,4790,479,5748,958,480,10.0,0.0
38962,921397,1000,14000,1000,16000,2000,1001,14.0,0.0
3899,4698,9,72,9,90,18,10,8.0,0.0
39,18463,72,179,72,305,126,76,3.315,0.0
3901,346537,500,4500,500,6000,1500,1002,4.5,0.0
39053,51556,79,711,79,869,158,80,9.0,0.0
39056,780023,1000,10000,1000,12000,2000,1001,10.0,0.0
39058,251591,1000,1000,1000,3000,2000,1001,1.0,0.0
39070,30830,50,450,50,550,100,51,9.0,0.0
39073,251591,1000,1000,1000,3000,2000,1001,1.0,0.0
39079,3397,11,11,11,33,22,12,1.0,0.0
39080,994570,1000,16265,1000,18265,2000,1001,16.265,0.0
39081,6331880,1000,3000,1000,5000,2000,1001,3.0,0.0
39083,251591,1000,1000,1000,3000,2000,1001,1.0,0.0
39086,2056734,1000,32957,1000,34957,2000,1001,32.957,0.0
39094,251591,1000,1000,1000,3000,2000,1001,1.0,0.0
39096,255592,1000,1000,1000,3000,2000,1001,1.0,0.0
39097,122850,0,491,0,982,491,492,1.0,0.0
39107,251591,1000,1000,1000,3000,2000,1001,1.0,0.0
3912,30761,0,355,0,426,71,72,5.0,0.0
39130,96394,116,1276,116,1508,232,117,11.0,0.0
39135,13952,23,207,23,253,46,24,9.0,0.0
3914,352106,0,2801,0,3280,479,480,5.848,0.5
39145,158437,619,619,619,1857,1238,620,1.0,0.0
39146,251591,1000,1000,1000,3000,2000,1001,1.0,0.0
39152,132407,183,1954,183,2320,366,184,10.678,0.0
3916,456145,500,7500,500,8500,1000,501,15.0,0.0
39164,251591,1000,1000,1000,3000,2000,1001,1.0,0.0
39166,1212796,0,18429,0,19429,1000,1001,18.429,0.0
39167,11133,42,42,42,126,84,43,1.0,0.0
39168,12639,48,48,48,144,96,49,1.0,0.0
39169,44878,0,577,0,612,35,36,16.486,0.0
39170,193359,768,768,768,2304,1536,769,1.0,0.0
39173,711338,0,9938,0,10938,1000,1001,9.938,0.0
39189,251591,1000,1000,1000,3000,2000,1001,1.0,0.0
39192,11302,42,42,42,126,84,43,1.0,0.0
39194,255592,1000,1000,1000,3000,2000,1001,1.0,0.0
39197,40035,76,532,76,684,152,77,7.0,0.0
39198,114722,183,1647,183,2013,366,184,9.0,0.0
39199,39302,66,594,66,726,132,67,9.0,0.0
3920,24906,17,109,17,143,34,18,6.412,0.5
39202,255592,1000,1000,1000,3000,2000,1001,1.0,0.0
39206,42006,165,165,165,495,330,166,1.0,0.0
39207,251591,1000,1000,1000,3000,2000,1001,1.0,0.0
39211,3397,11,11,11,33,22,12,1.0,0.0
39213,123832,491,491,491,1473,982,492,1.0,0.0
39214,105822,172,1376,172,1720,344,173,8.0,0.0
39218,255592,1000,1000,1000,3000,2000,1001,1.0,0.0
39219,251591,1000,1000,1000,3000,2000,1001,1.0,0.0
39224,69453,116,928,116,1160,232,117,8.0,1.0
39228,2642486,697,33009,697,34403,1394,698,47.359,0.0
39235,251591,1000,1000,1000,3000,2000,1001,1.0,0.0
39239,255592,1000,1000,1000,3000,2000,1001,1.0,0.0
39242,251591,1000,1000,1000,3000,2000,1001,1.0,0.0
39248,224734,893,893,893,2679,1786,894,1.0,0.0
39251,216577,847,847,847,2541,1694,848,1.0,0.0
39252,55289,87,692,87,866,174,88,7.954,0.0
39257,89653,175,1167,175,1517,350,176,6.669,0.0
39261,15882,30,180,30,240,60,31,6.0,0.0
39263,16875,0,164,0,205,41,42,4.0,0.0
39265,251591,1000,1000,1000,3000,2000,1001,1.0,0.0
39266,255592,1000,1000,1000,3000,2000,1001,1.0,0.0
39277,2207359,1000,35000,1000,37000,2000,1001,35.0,0.0
39282,251591,1000,1000,1000,3000,2000,1001,1.0,0.0
39284,251591,1000,1000,1000,3000,2000,1001,1.0,0.0
39290,249591,0,1000,0,2000,1000,1001,1.0,0.0
39291,255592,1000,1000,1000,3000,2000,1001,1.0,0.0
39293,251591,1000,1000,1000,3000,2000,1001,1.0,0.0
39294,956700,0,16000,0,17000,1000,1001,16.0,0.0
39300,255592,1000,1000,1000,3000,2000,1001,1.0,0.0
39301,146673,582,582,582,1746,1164,583,1.0,0.0
39302,251591,1000,1000,1000,3000,2000,1001,1.0,0.0
39303,1170950,0,18930,0,19930,1000,1001,18.93,0.0
39304,251591,1000,1000,1000,3000,2000,1001,1.0,0.0
39305,45771,180,180,180,540,360,181,1.0,0.0
39309,119840,85,1602,85,1772,170,86,18.847,0.0
39310,251591,1000,1000,1000,3000,2000,1001,1.0,0.0
39315,251591,1000,1000,1000,3000,2000,1001,1.0,0.0
39316,1725045,0,28756,0,29070,314,315,91.58,0.0
39317,1089324,839,14500,839,16178,1678,840,17.282,0.0
39320,255592,1000,1000,1000,3000,2000,1001,1.0,0.0
39321,251591,1000,1000,1000,3000,2000,1001,1.0,0.0
39324,12832,48,48,48,144,96,49,1.0,0.0
39328,255592,1000,1000,1000,3000,2000,1001,1.0,0.0
39331,251591,1000,1000,1000,3000,2000,1001,1.0,0.0
39332,8121,30,30,30,90,60,31,1.0,0.0
39333,383853,0,4000,0,5000,1000,1001,4.0,0.0
39334,12639,48,48,48,144,96,49,1.0,0.0
39336,251591,1000,1000,1000,3000,2000,1001,1.0,0.0
39337,251591,1000,1000,1000,3000,2000,1001,1.0,0.0
3934,6464,0,56,0,70,14,15,4.0,0.0
39341,12639,48,48,48,144,96,49,1.0,0.0
39344,251591,1000,1000,1000,3000,2000,1001,1.0,0.0
3939,70709,0,675,0,844,169,170,3.994,0.0
3941,6897,7,46,7,60,14,8,6.571,0.0
3943,436589,0,9000,0,9500,500,501,18.0,0.0
3945,434538,0,9000,0,9500,500,501,18.0,0.0
39465,19831,4,109,4,117,8,5,27.25,0.0
39467,269536,29,278,29,336,58,30,9.586,0.0
39472,30512513,858,11154,858,12870,1716,859,13.0,0.0
39482,1344604,1000,30001,1000,32001,2000,1001,30.001,0.0
39492,34252,40,371,40,451,80,41,9.275,0.0
39498,36879,50,500,50,600,100,51,10.0,0.0
39501,1662853,1000,28000,1000,30000,2000,1001,28.0,0.0
39504,26137,6,57,6,69,12,7,9.5,0.0
39505,18742,3,79,3,85,6,4,26.333,0.0
39507,1710283,1000,34093,1000,36093,2000,1001,34.093,0.0
39509,1501330,1000,33098,1000,35098,2000,1001,33.098,0.0
39510,263603,1000,1000,1000,3000,2000,1001,1.0,0.0
39513,1337294,1000,30001,1000,32001,2000,1001,30.001,0.0
39514,389874,35,358,35,428,70,36,10.229,0.0
39515,23484,87,87,87,261,174,88,1.0,0.0
39516,1869116,1000,32074,1000,34074,2000,1001,32.074,0.0
39518,9963,4,48,4,56,8,5,12.0,0.0
39519,1416,2,8,2,12,4,3,4.0,0.0
39521,104874,58,632,58,748,116,59,10.897,0.0
39524,983,1,3,1,5,2,2,3.0,0.0
39526,263603,1000,1000,1000,3000,2000,1001,1.0,0.0
39532,263603,1000,1000,1000,3000,2000,1001,1.0,0.0
39533,2707,8,8,8,24,16,9,1.0,0.0
39535,17040,4,48,4,56,8,5,12.0,0.0
39536,1392,3,3,3,9,6,4,1.0,0.0
39540,1419,0,8,0,10,2,3,4.0,0.0
39542,17024,18,174,18,210,36,19,9.667,0.0
39549,16454,20,180,20,220,40,21,9.0,0.0
39553,996,1,3,1,5,2,2,3.0,0.0
39557,267604,1000,1000,1000,3000,2000,1001,1.0,0.0
3956,9972,0,110,0,125,15,16,7.333,0.0
39562,971,1,3,1,5,2,2,3.0,0.0
39568,267604,1000,1000,1000,3000,2000,1001,1.0,0.0
39572,967,1,3,1,5,2,2,3.0,0.0
39574,3614,6,36,6,48,12,7,6.0,0.0
39575,263603,1000,1000,1000,3000,2000,1001,1.0,0.0
39576,263603,1000,1000,1000,3000,2000,1001,1.0,0.0
39577,120754,450,450,450,1350,900,451,1.0,0.0
39583,25702,94,94,94,282,188,95,1.0,0.0
39584,237967,889,889,889,2667,1778,890,1.0,0.0
39585,263603,1000,1000,1000,3000,2000,1001,1.0,0.0
39586,85642,81,1278,81,1440,162,82,15.778,0.0
39587,263603,1000,1000,1000,3000,2000,1001,1.0,0.0
3959,19010,29,238,29,296,58,30,8.207,0.0
39590,420867,0,4000,0,5000,1000,1001,4.0,0.0
39591,263603,1000,1000,1000,3000,2000,1001,1.0,0.0
39594,263603,1000,1000,1000,3000,2000,1001,1.0,0.0
39597,2181,6,6,6,18,12,7,1.0,0.0
39598,146305,554,554,554,1662,1108,555,1.0,0.0
39599,263603,1000,1000,1000,3000,2000,1001,1.0,0.0
3963,101281,0,1306,0,1437,131,132,9.969,0.0
39640,263603,1000,1000,1000,3000,2000,1001,1.0,0.0
39642,263603,1000,1000,1000,3000,2000,1001,1.0,0.0
3965,237713,0,2500,0,3000,500,501,5.0,0.0
3966,505144,0,10240,0,10432,192,193,53.333,0.0
39666,1547560,1000,26474,1000,28474,2000,1001,26.474,0.0
3967,412972,0,8500,0,9000,500,501,17.0,0.0
39678,164320,216,2416,216,2848,432,217,11.185,0.0
3968,418377,0,8500,0,9000,500,501,17.0,0.0
3969,17845,0,176,0,228,52,53,3.385,0.0
39697,253593,1000,1000,1000,3000,2000,1001,1.0,0.0
39699,257594,1000,1000,1000,3000,2000,1001,1.0,0.0
39711,253593,1000,1000,1000,3000,2000,1001,1.0,0.0
39716,253593,1000,1000,1000,3000,2000,1001,1.0,0.0
39719,253593,1000,1000,1000,3000,2000,1001,1.0,0.0
39723,257594,1000,1000,1000,3000,2000,1001,1.0,0.0
3978,64869,0,595,0,680,85,86,7.0,0.0
3979,55242,0,508,0,593,85,86,5.976,0.0
3982,56888,0,1120,0,1190,70,71,16.0,0.0
3988,55141,0,526,0,609,83,84,6.337,0.0
3991,40451,0,444,0,480,36,37,12.333,0.0
3992,1428,2,12,2,16,4,3,6.0,0.0
3995,243402,500,1500,500,3000,1500,995,3.0,0.0
40,210100,934,2049,934,3680,1631,938,2.906,0.0
4000,7767,0,75,0,90,15,16,5.0,1.0
4002,1738,0,12,0,15,3,4,4.0,0.0
4008,7951,15,87,15,117,30,16,5.8,0.0
4012,1778,0,12,0,15,3,4,4.0,0.0
4013,9044,18,83,18,119,36,19,4.611,0.0
4018,344779,392,5518,392,6718,1200,810,6.829,0.0
4025,99550,207,1035,207,1449,414,208,5.0,0.5
4026,67726,0,1328,0,1411,83,84,16.0,0.0
4027,68394,0,1344,0,1428,84,85,16.0,0.0
4036,165861,500,1500,500,2500,1000,501,3.0,0.0
4037,1876,3,15,3,21,6,4,5.0,0.0
4045,40997,0,432,0,468,36,37,12.0,0.0
4046,32573,0,324,0,378,54,55,6.0,0.0
4047,47588,58,743,58,859,116,60,12.81,0.0
4056,8174,0,76,0,95,19,20,4.0,0.0
40583,90299,166,1172,166,1504,332,167,7.06,0.0
40604,63550,98,980,98,1176,196,99,10.0,0.0
40607,29914,43,301,43,387,86,44,7.0,1.0
40613,38333,88,528,88,704,176,89,6.0,0.0
40615,17455,26,182,26,234,52,27,7.0,0.0
40616,56118,111,777,111,999,222,112,7.0,0.0
40617,52702,91,819,91,1001,182,92,9.0,0.0
40618,4779,9,54,9,72,18,10,6.0,0.0
40620,4283,8,48,8,64,16,9,6.0,0.5
4063,8862,11,72,11,95,23,13,6.545,1.0
40630,40650,55,605,55,715,110,56,11.0,0.0
40637,85717,111,1110,111,1332,222,112,10.0,0.0
40640,82857,131,1310,131,1572,262,132,10.0,0.0
4065,83348,87,1218,87,1392,174,88,14.0,0.0
4066,5338,10,59,10,79,20,11,5.9,0.0
40666,12783,35,140,35,210,70,36,4.0,0.0
40670,79028,147,1029,147,1323,294,148,7.0,0.0
4068,5140,10,50,10,70,20,11,5.0,0.0
40684,3286,5,36,5,46,10,6,7.2,0.0
40686,4432,5,63,5,73,10,6,12.6,0.0
4069,101604,43,945,43,1074,129,63,21.977,1.0
40690,56118,111,777,111,999,222,112,7.0,0.0
40691,4859,8,56,8,72,16,9,7.0,0.0
40692,7566,20,80,20,120,40,21,4.0,0.0
40693,26445,25,556,25,606,50,26,22.24,0.0
40695,14611,19,190,19,228,38,20,10.0,0.0
40696,5847,9,81,9,99,18,10,9.0,0.0
40698,2806,2,26,2,30,4,3,13.0,0.0
4070,3681,5,30,5,40,10,6,6.0,0.0
40702,4316,8,48,8,64,16,9,6.0,0.0
40703,25502,0,366,0,419,53,54,6.906,0.0
40707,5840,10,70,10,90,20,11,7.0,0.0
40709,206293,289,2023,289,2601,578,290,7.0,1.0
40711,4004,7,49,7,63,14,8,7.0,0.0
40712,53437,79,869,79,1027,158,80,11.0,0.0
40715,3307,5,36,5,46,10,6,7.2,0.0
40718,65483,156,936,156,1248,312,157,6.0,1.0
40725,28182,45,395,45,485,90,46,8.778,0.0
40730,8176,14,98,14,126,28,15,7.0,0.0
40735,5365,9,54,9,72,18,10,6.0,0.0
40737,48154,91,546,91,728,182,92,6.0,0.0
40739,7566,20,80,20,120,40,21,4.0,0.0
40740,13693,24,192,24,240,48,25,8.0,0.0
40741,6940,14,84,14,112,28,15,6.0,0.0
40742,5840,10,70,10,90,20,11,7.0,0.0
40743,4561,0,56,0,64,8,9,7.0,0.5
40744,4075,7,49,7,63,14,8,7.0,0.0
40746,3855,4,36,4,44,8,5,9.0,0.0
40747,4603,8,56,8,72,16,9,7.0,0.0
4075,544881,500,3944,500,4944,1000,502,7.888,0.0
40751,2164,3,21,3,27,6,4,7.0,0.0
40753,4075,7,49,7,63,14,8,7.0,0.0
40754,106597,196,1567,196,1959,392,197,7.995,0.0
40755,11349,22,110,22,154,44,23,5.0,0.0
40757,96765,214,1284,214,1712,428,215,6.0,0.0
4076,311330,500,4000,500,5000,1000,502,8.0,0.0
40762,4018,7,49,7,63,14,8,7.0,0.0
40764,1543,2,14,2,18,4,3,7.0,0.0
40769,26344,25,556,25,606,50,26,22.24,0.0
4077,1083014,0,16500,0,17000,500,501,33.0,0.0
40770,12783,35,140,35,210,70,36,4.0,0.0
40772,14611,19,190,19,228,38,20,10.0,0.0
40777,6357,9,63,9,81,18,10,7.0,0.0
40778,3770,7,42,7,56,14,8,6.0,0.0
4078,455181,0,9000,0,9500,500,501,18.0,0.0
40780,4046,7,49,7,63,14,8,7.0,0.0
40781,1543,2,14,2,18,4,3,7.0,0.0
40782,14611,19,190,19,228,38,20,10.0,0.0
40784,704747,1000,7000,1000,9000,2000,1001,7.0,1.0
40785,3037,6,30,6,42,12,7,5.0,0.0
4079,458323,0,9000,0,9500,500,501,18.0,0.0
40791,10481,30,78,30,138,60,31,2.6,0.0
40794,5185,18,18,18,54,36,19,1.0,0.0
40795,4974,5,33,5,43,10,6,6.6,0.0
40796,2687,6,18,6,30,12,7,3.0,0.0
40797,21434,0,483,0,506,23,24,21.0,0.0
40798,126938,156,1716,156,2184,468,313,11.0,0.0
4080,210211,0,2000,0,2500,500,501,4.0,0.0
40800,11560,43,43,43,129,86,44,1.0,0.0
40801,56022,214,214,214,642,428,215,1.0,0.0
40802,27066,0,556,0,581,25,26,22.24,0.0
40803,11733,43,43,43,129,86,44,1.0,1.0
40804,11560,43,43,43,129,86,44,1.0,0.0
40806,12783,35,140,35,210,70,36,4.0,0.0
4081,1661593,0,35500,0,36000,500,501,71.0,0.0
40811,7225,26,26,26,78,52,27,1.0,0.0
40814,8755,32,32,32,96,64,33,1.0,0.0
40815,1668,3,11,3,17,6,4,3.667,0.0
40817,12679,0,120,0,156,36,37,3.333,0.0
40819,12720,36,120,36,192,72,37,3.333,0.0
4082,385327,0,5500,0,6000,500,501,11.0,0.0
40820,11733,43,43,43,129,86,44,1.0,0.0
40821,8155,12,108,12,132,24,13,9.0,0.0
40822,2591,6,19,6,31,12,7,3.167,0.0
40825,12686,36,119,36,191,72,37,3.306,0.0
40828,8155,12,108,12,132,24,13,9.0,0.0
4083,883913,0,15500,0,16000,500,501,31.0,0.0
40830,12440,0,113,0,149,36,37,3.139,0.0
40832,12673,0,120,0,156,36,37,3.333,0.0
40833,12034,0,99,0,135,36,37,2.75,0.0
40834,12715,36,120,36,192,72,37,3.333,0.0
40835,12643,0,120,0,156,36,37,3.333,0.0
40837,11499,0,80,0,116,36,37,2.222,0.0
4084,1858937,0,38500,0,39000,500,501,77.0,0.0
40841,4165,7,56,7,70,14,8,8.0,0.0
40842,9864,18,108,18,144,36,19,6.0,0.0
40843,8198,18,54,18,90,36,19,3.0,0.0
40844,1614,2,8,2,12,4,3,4.0,0.0
40845,13444,17,170,17,204,34,18,10.0,0.0
40846,2896,4,24,4,32,8,5,6.0,0.0
40847,3186,3,33,3,39,6,4,11.0,0.0
40848,34684,0,320,0,400,80,81,4.0,0.0
40849,1820,3,9,3,15,6,4,3.0,0.0
4085,348425,0,5000,0,5500,500,501,10.0,0.0
40850,4159,10,30,10,50,20,11,3.0,0.0
40851,3201,0,28,0,32,4,5,7.0,0.0
40852,3236,6,30,6,42,12,7,5.0,0.0
40853,40631,96,288,96,480,192,97,3.0,0.0
40854,1698,3,9,3,15,6,4,3.0,0.0
40855,17797,50,200,50,300,100,52,4.0,0.0
40856,1434,1,4,1,7,3,3,4.0,0.0
40857,481290,498,5659,498,6655,996,499,11.363,0.0
40858,3481,8,24,8,40,16,9,3.0,0.0
40859,7117,0,72,0,84,12,13,6.0,0.0
4086,461774,0,9000,0,9500,500,501,18.0,0.0
40860,1723,3,11,3,17,6,4,3.667,0.0
40861,13444,17,170,17,204,34,18,10.0,0.0
40862,25690,41,257,41,339,82,42,6.268,0.0
40863,13513,17,170,17,204,34,18,10.0,0.0
40864,8198,18,54,18,90,36,19,3.0,0.0
40865,3729,10,20,10,40,20,11,2.0,0.0
40866,13444,17,170,17,204,34,18,10.0,0.0
40867,3201,6,30,6,42,12,7,5.0,0.0
40868,1705,3,9,3,15,6,4,3.0,0.5
40869,1416,3,3,3,9,6,4,1.0,0.0
4087,290244,500,3889,500,4889,1000,501,7.778,0.5
40870,5451,18,18,18,54,36,19,1.0,0.0
40871,3417,6,30,6,42,12,7,5.0,0.0
40872,4897,6,42,6,54,12,7,7.0,0.0
40873,3879,9,26,9,44,18,10,2.889,0.0
40874,1782,3,9,3,15,6,4,3.0,0.0
40875,3653,4,36,4,44,8,5,9.0,0.0
40876,1147,2,2,2,6,4,3,1.0,0.0
40878,730864,1000,11000,1000,13000,2000,1001,11.0,0.0
4088,285169,500,3814,500,4814,1000,501,7.628,0.0
40880,2185572,2000,38384,2000,43384,5000,3002,12.795,0.0
40881,285890,571,2855,571,3997,1142,572,5.0,0.0
40882,493086,1000,4989,1000,7989,3000,2001,4.989,0.0
40883,789203,1000,11712,1000,13712,2000,1001,11.712,0.0
40884,255595,1000,1000,1000,3000,2000,1001,1.0,0.0
40888,255595,1000,1000,1000,3000,2000,1001,1.0,0.0
40890,2157026,1999,37993,1999,42991,4998,3001,12.669,0.0
40891,2082704,2000,36822,2000,41822,5000,3002,12.274,0.0
40896,879403,0,12000,0,13000,1000,1001,12.0,0.0
40898,486104,1000,5000,1000,7000,2000,1001,5.0,0.5
40901,2194968,2996,38434,2996,44426,5992,2998,12.828,0.0
40902,884626,1000,12000,1000,14000,2000,1001,12.0,0.0
40903,801317,1000,12000,1000,14000,2000,1001,12.0,0.0
40904,881403,1000,12000,1000,14000,2000,1001,12.0,0.0
40909,880929,0,12000,0,13000,1000,1001,12.0,0.0
40910,967158,0,12000,0,13000,1000,1001,12.0,0.0
40912,851957,1000,12000,1000,14000,2000,1001,12.0,0.0
40914,848468,1000,12000,1000,14000,2000,1001,12.0,0.0
4092,291531,500,3875,500,4875,1000,501,7.75,0.0
40922,847223,1000,12000,1000,14000,2000,1001,12.0,0.0
40927,1330,2,7,2,11,4,3,3.5,0.0
4093,253742,492,3250,492,4234,984,493,6.606,0.0
40931,478049,1000,4999,1000,6999,2000,1001,4.999,0.0
40932,415992,1000,5000,1000,7000,2000,1001,5.0,0.0
40934,19431,0,273,0,312,39,40,7.0,0.0
40935,14395,0,108,0,144,36,37,3.0,0.0
4094,316727,500,4500,500,5500,1000,501,9.0,0.0
40940,9760,16,112,16,144,32,17,7.0,0.0
40942,5471,13,52,13,78,26,14,4.0,0.0
40944,780624,1000,11000,1000,13000,2000,1001,11.0,0.0
40945,92631,82,840,82,1004,164,83,10.244,0.0
40946,847801,1000,12000,1000,14000,2000,1001,12.0,0.0
4095,285579,500,3891,500,4891,1000,501,7.782,0.5
40950,840652,1000,12000,1000,14000,2000,1001,12.0,0.0
40954,5050,0,48,0,60,12,13,4.0,0.0
40955,5049,12,48,12,72,24,13,4.0,0.0
40956,830276,1000,12000,1000,14000,2000,1001,12.0,0.0
40959,822798,0,12000,0,13000,1000,1001,12.0,0.0
40961,833269,1000,12000,1000,14000,2000,1001,12.0,0.0
40962,2015202,2000,34786,2000,39786,5000,3002,11.595,0.0
40963,801346,1000,12000,1000,14000,2000,1001,12.0,0.0
40969,375193,621,4275,621,5517,1242,622,6.884,0.5
4097,3742,0,32,0,40,8,9,4.0,0.0
40970,841063,0,12000,0,13000,1000,1001,12.0,0.0
40972,831706,0,12000,0,13000,1000,1001,12.0,0.0
40974,616867,654,5832,654,7140,1308,655,8.917,0.0
40976,9013,11,121,11,143,22,12,11.0,0.0
40979,5776,20,20,20,60,40,21,1.0,0.0
4098,1730,0,12,0,15,3,4,4.0,0.0
40980,30268,54,324,54,432,108,55,6.0,0.0
40981,12071,20,120,20,160,40,21,6.0,0.0
40982,33384,80,320,80,480,160,81,4.0,0.0
40984,833201,1000,12000,1000,14000,2000,1001,12.0,0.0
40985,95609,143,1285,143,1571,286,144,8.986,0.0
40986,21816,18,189,18,225,36,19,10.5,0.0
40987,7987,11,99,11,121,22,12,9.0,0.0
40988,1915,2,18,2,22,4,3,9.0,0.0
40991,4027,6,42,6,54,12,7,7.0,0.0
40993,7225,9,90,9,108,18,10,10.0,0.0
40995,38505,96,288,96,480,192,97,3.0,0.0
40997,1105,2,2,2,6,4,3,1.0,0.0
40998,1105,2,2,2,6,4,3,1.0,0.0
41,1568547,4949,12826,4949,24711,11885,5334,3.239,0.5
4100,2869,0,20,0,25,5,6,4.0,0.0
41000,37060,143,143,143,429,286,144,1.0,0.0
41001,1716,3,9,3,15,6,4,3.0,0.0
41004,3145,10,10,10,30,20,11,1.0,0.0
41007,2890,9,9,9,27,18,10,1.0,0.0
41008,3941,4,39,4,47,8,5,9.75,0.0
41009,133960,523,523,523,1569,1046,524,1.0,0.0
4101,591944,0,7500,0,8000,500,501,15.0,0.0
41010,1479,2,8,2,12,4,3,4.0,0.0
41016,2666,4,24,4,32,8,5,6.0,0.0
41019,37060,143,143,143,429,286,144,1.0,0.0
4102,292284,65,455,65,585,130,67,7.0,0.0
41020,1373,3,3,3,9,6,4,1.0,0.0
41026,3445,11,11,11,33,22,12,1.0,0.0
4103,801913,0,14000,0,14500,500,501,28.0,0.0
41034,1105,2,2,2,6,4,3,1.0,0.0
41049,16282,32,192,32,256,64,33,6.0,0.0
41054,1206832,0,16576,0,17576,1000,1001,16.576,1.0
41060,2041002,920,29847,920,31687,1840,921,32.442,0.0
41062,108606,0,1380,0,1440,60,61,23.0,0.0
41069,49311,0,572,0,594,22,23,26.0,0.0
41071,1345798,0,18000,0,19000,1000,1001,18.0,1.0
41072,1119320,1000,15000,1000,17000,2000,1001,15.0,0.0
41083,219957,0,3060,0,3213,153,154,20.0,0.0
41091,110418,0,1425,0,1500,75,76,19.0,0.0
41094,298541,0,4519,0,4688,169,170,26.74,0.0
41095,43356,0,560,0,580,20,21,28.0,0.75
41096,1603576,0,21855,0,22504,649,650,33.675,0.0
41111,88118,42,1134,42,1218,84,43,27.0,0.0
41115,133700,0,1679,0,1737,58,59,28.948,1.0
41128,111319,58,1388,58,1504,116,59,23.931,0.0
41130,3099,1,31,1,33,2,2,31.0,0.0
41138,40289,27,513,27,567,54,28,19.0,0.0
41142,117376,0,1512,0,1575,63,64,24.0,0.0
41144,920484,0,13917,0,14497,580,581,23.995,0.0
41146,42045,19,589,19,627,38,20,31.0,1.0
41148,7130023,1000,86445,1000,88445,2000,1001,86.445,0.0
41149,948052,398,14440,398,15236,796,399,36.281,0.5
4115,26929,0,302,0,342,40,41,7.55,0.0
41150,294460,0,3528,0,3735,207,208,17.043,0.0
41153,13278,9,162,9,180,18,10,18.0,0.0
41154,45497,0,381,0,508,127,128,3.0,0.5
41155,1607097,616,22016,616,23248,1232,617,35.74,0.0
41156,3432,0,26,0,35,9,10,2.889,0.5
41157,24012,0,345,0,360,15,16,23.0,0.0
41160,196009,0,2030,0,2044,14,15,145.0,0.0
41162,369790,0,3828,0,3875,47,48,81.447,0.0
41164,9316,0,119,0,122,3,4,39.667,0.0
41165,328090,0,4418,0,4531,113,114,39.097,0.0
41168,706319,0,9000,0,10000,1000,1001,9.0,0.0
41169,670226,1000,12110,1000,14110,2000,1001,12.11,0.0
41179,360476,471,6298,471,7240,942,472,13.372,0.0
4118,11354,0,108,0,127,19,20,5.684,0.0
41184,1491163,1000,23801,1000,25801,2000,1001,23.801,0.0
41186,1953187,1000,27801,1000,29801,2000,1001,27.801,0.0
41189,245585,1000,1000,1000,3000,2000,1001,1.0,0.0
41190,245585,1000,1000,1000,3000,2000,1001,1.0,0.0
41191,560720,1000,8000,1000,10000,2000,1001,8.0,0.0
41193,1019595,1000,16278,1000,18278,2000,1001,16.278,0.0
41199,37811,74,444,74,592,148,75,6.0,0.0
41200,1493077,1000,23855,1000,25855,2000,1001,23.855,0.0
41201,245585,1000,1000,1000,3000,2000,1001,1.0,0.0
41203,245585,1000,1000,1000,3000,2000,1001,1.0,0.0
41206,245585,1000,1000,1000,3000,2000,1001,1.0,0.0
41208,2233320,1000,33466,1000,35466,2000,1001,33.466,0.0
41209,42970,173,173,173,519,346,174,1.0,0.0
41210,875682,1000,15976,1000,17976,2000,1001,15.976,0.0
41212,245585,1000,1000,1000,3000,2000,1001,1.0,0.0
41216,1839536,1000,28465,1000,30465,2000,1001,28.465,0.0
41217,645271,1000,9000,1000,11000,2000,1001,9.0,0.0
41219,698878,1000,8995,1000,10995,2000,1001,8.995,0.0
41220,642583,1000,8998,1000,10998,2000,1001,8.998,0.5
41222,42970,173,173,173,519,346,174,1.0,0.0
41223,249586,1000,1000,1000,3000,2000,1001,1.0,0.0
41225,245585,1000,1000,1000,3000,2000,1001,1.0,0.0
41226,245585,1000,1000,1000,3000,2000,1001,1.0,0.0
41227,245585,1000,1000,1000,3000,2000,1001,1.0,0.0
41228,37091,0,149,0,298,149,150,1.0,0.0
4123,954822,0,21179,0,21679,500,501,42.358,0.0
41234,245585,1000,1000,1000,3000,2000,1001,1.0,0.0
41236,245585,1000,1000,1000,3000,2000,1001,1.0,0.0
41237,249586,1000,1000,1000,3000,2000,1001,1.0,0.0
4124,14981,0,253,0,276,23,24,11.0,0.5
41242,245585,1000,1000,1000,3000,2000,1001,1.0,0.0
41244,245585,1000,1000,1000,3000,2000,1001,1.0,0.0
41245,245585,1000,1000,1000,3000,2000,1001,1.0,0.0
41266,49429,94,657,94,845,188,95,6.989,0.0
4127,213135,0,2000,0,2500,500,501,4.0,0.0
41275,1658,3,12,3,18,6,4,4.0,0.0
41276,3596,7,40,7,54,14,8,5.714,0.0
41287,18416,14,112,14,140,28,15,8.0,0.0
41290,3715,8,32,8,48,16,9,4.0,0.0
41291,695264,1000,9000,1000,11000,2000,1001,9.0,0.0
4130,12685,0,100,0,125,25,26,4.0,0.5
41305,44567,0,181,0,362,181,182,1.0,0.0
41308,327436,416,4990,416,5822,832,417,11.995,0.5
4131,122533,0,1380,0,1580,200,201,6.9,0.0
41313,621882,1000,8000,1000,10000,2000,1001,8.0,0.0
4135,501538,0,10000,0,10500,500,501,20.0,0.0
41352,2892,3,15,3,24,9,7,5.0,0.0
4147,433007,0,9000,0,9500,500,501,18.0,0.0
4148,438168,0,9000,0,9500,500,501,18.0,0.0
4149,435631,0,9000,0,9500,500,501,18.0,0.0
4150,56911,0,1120,0,1190,70,71,16.0,0.0
4151,293150,0,5950,0,6300,350,351,17.0,0.0
4158,597956,500,7681,500,9444,1763,1116,15.362,0.0
4161,521296,500,9929,500,10929,1000,501,19.858,0.0
4162,11666,3,183,3,189,6,4,61.0,0.0
4163,975700,500,16975,500,17975,1000,501,33.95,0.0
4164,936495,500,15482,500,16482,1000,501,30.964,0.0
4169,789382,0,12500,0,13000,500,501,25.0,0.0
4171,21292,0,153,0,204,51,52,3.0,0.0
41720,122555,2,22,2,26,4,3,11.0,0.0
41725,458696,301,6622,301,7224,602,302,22.0,0.0
4173,7703,4,8,4,16,8,5,2.0,0.0
41757,1136710,0,18834,0,19834,1000,1001,18.834,0.5
41758,1367427,0,19249,0,20249,1000,1001,19.249,1.0
41760,150351,152,1824,152,2128,304,153,12.0,0.5
41762,1172916,1000,17998,1000,20998,3000,2002,8.999,0.0
41764,134752,0,1412,0,1635,223,224,6.332,0.0
41765,6145,0,27,0,45,18,19,3.0,1.0
41766,45081,0,728,0,771,43,44,16.93,0.0
4177,67494,0,939,0,1084,145,146,6.476,0.0
41771,851204,1000,11082,1000,14082,3000,2002,5.541,0.0
41772,28052,28,280,28,336,56,29,10.0,0.0
41776,15339,38,114,38,190,76,39,3.0,0.0
41778,43605,0,460,0,575,115,116,4.0,1.0
41780,5681,9,51,9,69,18,10,5.667,0.0
4179,204130,170,5949,170,6289,340,171,34.994,0.0
41793,1008754,0,16886,0,17886,1000,1001,16.886,0.5
41799,17823,0,142,0,154,12,13,11.833,0.0
41818,415926,1000,5000,1000,7000,2000,1001,5.0,1.0
41819,22746,12,494,12,518,24,13,41.167,0.0
41820,9168,0,88,0,97,9,10,9.778,1.0
41822,3357,6,24,6,36,12,7,4.0,0.0
41824,10998,11,84,11,106,22,12,7.636,0.5
41825,9241,0,88,0,97,9,10,9.778,0.0
41827,9168,0,88,0,97,9,10,9.778,0.0
41831,9168,0,88,0,97,9,10,9.778,0.0
41833,2267614,1000,40018,1000,42018,2000,1001,40.018,0.8333333333333334
41838,4779,10,30,10,50,20,11,3.0,0.0
41839,22697,12,494,12,518,24,13,41.167,0.0
41842,9187,0,88,0,97,9,10,9.778,1.0
41843,5742,0,39,0,49,10,11,3.9,0.0
41844,9461,15,87,15,117,30,16,5.8,0.0
41847,4357,6,36,6,48,12,7,6.0,0.5
41849,56084,89,445,89,623,178,90,5.0,1.0
41852,153221,80,2160,80,2320,160,81,27.0,0.0
41855,11043,11,84,11,106,22,12,7.636,0.0
41856,7696,13,73,13,99,26,14,5.615,0.0
41857,9581,9,72,9,90,18,10,8.0,1.0
41858,691346,0,9000,0,10000,1000,1001,9.0,0.0
41859,36672,22,638,22,682,44,23,29.0,0.0
41861,2908701,1000,37588,1000,40587,2999,1300,37.588,0.0
41863,6898,11,55,11,77,22,12,5.0,1.0
41864,49997,0,652,0,678,26,27,25.077,0.0
41865,883236,1000,13736,1000,15736,2000,1001,13.736,0.0
41868,27454,28,298,28,354,56,29,10.643,0.0
41869,20178,0,163,0,178,15,16,10.867,0.0
41870,317502,668,2004,668,3340,1336,669,3.0,0.0
41871,7413,0,42,0,56,14,15,3.0,0.0
41872,390444,301,5418,301,6020,602,302,18.0,0.0
41873,7670,0,73,0,86,13,14,5.615,0.0
41874,13572,8,91,8,107,16,9,11.375,0.0
41875,49565,55,600,55,710,110,56,10.909,0.0
41876,415656,1000,5000,1000,7000,2000,1001,5.0,1.0
41877,3345,0,24,0,30,6,7,4.0,0.0
41878,6261534,1000,152846,1000,154846,2000,1001,152.846,0.0
41879,1618314,1000,29165,1000,31165,2000,1001,29.165,0.0
41881,6660,0,48,0,58,10,11,4.8,0.0
41882,2594874,1984,20411,1984,27139,6728,4729,10.288,0.0
41883,9168,0,88,0,97,9,10,9.778,0.0
41888,10082,0,78,0,93,15,16,5.2,0.0
41891,842175,0,12000,0,13000,1000,1001,12.0,0.0
41893,21668,0,364,0,377,13,14,28.0,1.0
41897,120262,0,1276,0,1334,58,59,22.0,0.0
41898,529853,156,5304,156,5616,312,157,34.0,0.0
4190,343454,500,5208,500,6208,1000,501,10.416,0.0
41901,8332,12,124,12,148,24,13,10.333,0.0
41905,18448,11,308,11,330,22,12,28.0,0.0
4191,8770,0,55,0,66,11,12,5.0,0.0
41919,21660,0,329,0,356,27,28,12.185,0.0
4192,204150,0,1974,0,2256,282,283,7.0,1.0
41926,19653,12,336,12,360,24,13,28.0,0.0
41929,15375,0,182,0,196,14,15,13.0,0.0
4193,43182,0,399,0,469,70,71,5.7,0.0
41934,26675792,1974,189775,1974,196503,6728,4663,96.137,1.0
41936,182286,0,824,0,927,103,104,8.0,0.0
41937,43835,115,460,115,690,230,116,4.0,1.0
41938,20132,0,491,0,517,26,27,18.885,0.0
41939,9788,11,73,11,95,22,12,6.636,0.5
41941,483168,1000,5761,1000,7761,2000,1001,5.761,0.5
41943,33928,0,291,0,388,97,98,3.0,0.5
41944,26220,55,220,55,330,110,56,4.0,0.0
41950,255031,225,3675,225,4125,450,226,16.333,0.0
41954,32779,34,367,34,435,68,35,10.794,0.0
41955,2187,1,28,1,30,2,2,28.0,0.0
41956,21881,0,494,0,520,26,27,19.0,0.0
41957,33450,21,588,21,630,42,22,28.0,0.0
41958,1703624,1000,32941,1000,34941,2000,1001,32.941,0.0
41959,26220,55,220,55,330,110,56,4.0,0.0
4196,11396,12,192,12,216,24,13,16.0,0.0
41960,16520,0,212,0,228,16,17,13.25,0.0
41962,35605,22,616,22,660,44,23,28.0,0.0
41964,8450,0,135,0,140,5,6,27.0,0.0
41965,33907,0,288,0,384,96,97,3.0,0.5
41969,23421,12,515,12,539,24,13,42.917,0.0
4197,10338,12,168,12,192,24,13,14.0,0.0
41971,1197550,99,12817,99,13015,198,100,129.465,0.0
41974,52046,0,1041,0,1096,55,56,18.927,1.0
41975,1551352,700,15600,700,17000,1400,701,22.286,0.0
41976,14593,0,119,0,126,7,8,17.0,0.0
41978,17516,0,302,0,328,26,27,11.615,0.0
41979,104453,119,952,119,1190,238,120,8.0,0.0
41980,332735,0,3913,0,4472,559,560,7.0,0.5
41981,79256,48,1392,48,1488,96,49,29.0,0.0
41982,45168,0,728,0,771,43,44,16.93,0.0
41983,67059,24,1008,24,1056,48,25,42.0,0.0
41986,15965,0,130,0,140,10,11,13.0,0.0
41987,10803,0,112,0,128,16,17,7.0,0.6666666666666666
41988,974792,1000,23000,1000,25000,2000,1001,23.0,0.0
41989,98372,200,1200,200,1600,400,201,6.0,1.0
4199,1540340,500,26500,500,27500,1000,501,53.0,0.0
41991,474565,0,7249,0,7751,502,503,14.44,0.0
41992,66549,0,1176,0,1188,12,13,98.0,0.0
41993,16519,16,212,16,244,32,17,13.25,0.0
41994,1197550,99,12817,99,13015,198,100,129.465,0.0
41995,20452,28,238,28,294,56,29,8.5,0.0
41996,28388,54,213,54,321,108,55,3.944,0.0
41997,26345563,1993,187468,1993,194229,6761,4765,94.063,0.0
42,4985317,9623,57732,9623,76976,19244,9624,5.999,0.0
42000,1607451,876,22825,876,24577,1752,877,26.056,0.0
42001,43720,33,363,33,462,99,68,11.0,0.0
42004,520339,0,2191,0,2230,39,40,56.179,0.0
42005,1197550,99,12817,99,13015,198,100,129.465,0.0
42010,916837,0,13168,0,14168,1000,1001,13.168,0.5
42013,66549,0,1176,0,1188,12,13,98.0,0.0
42017,1197550,99,12817,99,13015,198,100,129.465,0.0
42018,29595,0,453,0,497,44,45,10.295,0.0
42020,475624,1000,5756,1000,7756,2000,1001,5.756,0.5
42024,467351,1000,5338,1000,7338,2000,1001,5.338,0.5
42026,27618,28,240,28,296,56,29,8.571,0.0
42027,30199,55,319,55,429,110,56,5.8,0.0
42028,218194,458,2686,458,3602,916,459,5.865,0.5
42030,19632,12,336,12,360,24,13,28.0,0.0
42031,29521,0,409,0,464,55,56,7.436,0.0
42032,17164,0,247,0,268,21,22,11.762,0.0
42033,7182,6,73,6,85,12,7,12.167,0.0
42034,8302,0,96,0,108,12,13,8.0,0.0
42035,484857,0,6995,0,7995,1000,1001,6.995,0.0
42036,38915,0,643,0,681,38,39,16.921,0.0
42038,26457916,1970,187509,1970,194211,6702,4655,95.182,0.0
4204,469927,500,9993,500,10993,1000,501,19.986,0.0
42040,21441,0,281,0,324,43,44,6.535,0.0
42044,30723,55,329,55,439,110,56,5.982,0.5
42045,9343,0,86,0,92,6,7,14.333,0.0
42047,20088,25,202,25,252,50,26,8.08,0.0
42048,44315,54,535,54,643,108,55,9.907,0.0
42049,57658,0,756,0,840,84,85,9.0,0.5
42053,473569,578,6913,578,8069,1156,579,11.96,0.0
42055,234513,0,3334,0,3707,373,374,8.938,0.0
42056,18237,27,246,27,300,54,28,9.111,0.0
42058,18246,0,275,0,300,25,26,11.0,0.0
42060,26589625,1947,188498,1947,195150,6652,4688,96.815,0.0
42061,41591,0,646,0,718,72,73,8.972,0.0
42062,19556,0,308,0,319,11,12,28.0,0.0
42063,19094,0,308,0,319,11,12,28.0,0.0
42065,17342,0,222,0,239,17,18,13.059,0.0
42066,8495,0,140,0,145,5,6,28.0,0.0
42067,16602,0,227,0,258,31,32,7.323,0.0
42069,18448,11,308,11,330,22,12,28.0,0.0
42070,19346,0,336,0,348,12,13,28.0,0.0
42071,18426,0,308,0,319,11,12,28.0,0.0
42072,1197550,99,12817,99,13015,198,100,129.465,0.0
42075,18734,0,158,0,204,46,47,3.435,0.0
42083,26933,0,448,0,464,16,17,28.0,0.0
42086,1156516,1000,14000,1000,16000,2000,1001,14.0,0.0
42113,153221,80,2160,80,2320,160,81,27.0,0.0
42115,399152,875,4791,875,6541,1750,876,5.475,0.0
42116,4775,5,95,5,105,10,6,19.0,0.0
42119,19051,0,332,0,344,12,13,27.667,0.0
42121,66524,0,1176,0,1188,12,13,98.0,0.0
42129,513538,154,5236,154,5544,308,155,34.0,0.0
4213,1662929,500,28337,500,29337,1000,501,56.674,0.0
42134,66524,0,1176,0,1188,12,13,98.0,0.0
42137,21732,0,318,0,355,37,38,8.595,0.0
42138,2671031,1000,37494,1000,39494,2000,1001,37.494,0.0
42142,26721,0,448,0,464,16,17,28.0,0.0
42152,35275,25,500,25,550,50,26,20.0,0.0
42154,464012,1000,5646,1000,7646,2000,1001,5.646,0.5
42157,1518,1,9,1,11,2,2,9.0,0.0
42158,66524,0,1176,0,1188,12,13,98.0,0.0
42159,23937,0,375,0,400,25,26,15.0,0.0
42161,66524,0,1176,0,1188,12,13,98.0,0.0
42162,26567,0,448,0,464,16,17,28.0,0.0
42165,20088,25,202,25,252,50,26,8.08,0.0
42166,17548,0,250,0,275,25,26,10.0,0.0
42174,15572,0,220,0,242,22,23,10.0,0.0
42175,64412,66,792,66,924,132,67,12.0,0.5
42177,22715,0,350,0,375,25,26,14.0,0.0
42181,66549,0,1176,0,1188,12,13,98.0,0.0
42183,48953,0,690,0,713,23,24,30.0,0.0
42189,26618696,1999,188672,1999,195526,6854,4853,94.383,0.0
42190,7768,6,55,6,67,12,7,9.167,0.0
42193,4651,5,95,5,105,10,6,19.0,0.0
4220,17981,0,178,0,207,29,30,6.138,0.5
42204,286590,625,3444,625,4694,1250,626,5.51,0.0
42205,66524,0,1176,0,1188,12,13,98.0,0.0
42206,50937,0,195,0,234,39,40,5.0,0.0
42209,475073,1000,5641,1000,7641,2000,1001,5.641,0.75
42232,12378,8,240,8,256,16,9,30.0,0.5
42233,4796,5,95,5,105,10,6,19.0,0.0
42234,66524,0,1176,0,1188,12,13,98.0,0.0
42235,26205571,1991,186146,1991,192744,6598,4573,93.494,0.0
42238,66524,0,1176,0,1188,12,13,98.0,0.0
42244,6285,8,30,8,46,16,9,3.75,0.0
42245,11916,0,136,0,153,17,18,8.0,0.0
42246,5129,6,37,6,49,12,7,6.167,0.0
42247,15791,0,223,0,250,27,28,8.259,0.0
42249,13976,7,111,7,125,14,8,15.857,0.0
42258,4672,5,95,5,105,10,6,19.0,0.0
42259,15327,0,213,0,241,28,29,7.607,0.0
42262,235892,500,2906,500,3906,1000,501,5.812,0.0
42263,4775,5,95,5,105,10,6,19.0,0.0
42267,4775,5,95,5,105,10,6,19.0,0.0
42271,13976,7,111,7,125,14,8,15.857,0.0
42272,44371,0,174,0,209,35,36,4.971,0.0
42275,1538,1,11,1,13,2,2,11.0,0.0
42276,1328,1,9,1,11,2,2,9.0,0.0
42277,77371,78,624,78,780,156,79,8.0,0.5
42279,404648,864,4818,864,6546,1728,865,5.576,0.0
42281,21899,22,264,22,308,44,23,12.0,0.0
42282,86153,175,1050,175,1400,350,176,6.0,0.0
42284,4775,5,95,5,105,10,6,19.0,0.0
42288,66524,0,1176,0,1188,12,13,98.0,0.0
42289,1259346,1000,28000,1000,30000,2000,1001,28.0,0.0
4229,57110,112,336,112,675,339,228,3.0,0.0
42290,66524,0,1176,0,1188,12,13,98.0,0.0
42291,511386,1000,6993,1000,8993,2000,1001,6.993,0.0
42292,19281,0,289,0,320,31,32,9.323,0.0
42296,4775,5,95,5,105,10,6,19.0,0.0
42298,26779461,2000,189578,2000,196340,6762,4762,94.789,0.0
4230,529689,0,8000,0,8500,500,501,16.0,0.0
42300,35296,0,887,0,911,24,25,36.958,0.0
42302,108818,225,1268,225,1718,450,226,5.636,0.0
42306,13576,0,302,0,318,16,17,18.875,0.0
42309,4651,5,95,5,105,10,6,19.0,0.0
42311,734947,1000,9999,1000,11999,2000,1001,9.999,0.5
42314,23003,0,354,0,381,27,28,13.111,0.0
42315,4775,5,95,5,105,10,6,19.0,0.0
42319,4775,5,95,5,105,10,6,19.0,0.0
42321,467587,1000,5877,1000,7877,2000,1001,5.877,1.0
42322,3550,7,28,7,42,14,8,4.0,0.5
4233,169772,159,2186,159,2663,477,320,6.874,1.0
42335,9514,6,84,6,96,12,7,14.0,0.0
42336,66524,0,1176,0,1188,12,13,98.0,0.0
42337,6329,7,35,7,49,14,8,5.0,1.0
42339,21899,22,264,22,308,44,23,12.0,0.0
42340,18836,23,188,23,234,46,24,8.174,0.0
42346,25763,0,275,0,300,25,26,11.0,0.0
42348,39621,0,174,0,209,35,36,4.971,0.0
42350,50279,0,195,0,234,39,40,5.0,0.5
42351,7631,12,72,12,96,24,13,6.0,0.0
42352,4142,0,38,0,47,9,10,4.222,0.0
42353,3575,5,40,5,50,10,6,8.0,0.0
42354,5405,10,60,10,80,20,11,6.0,0.0
42357,2954,6,24,6,36,12,7,4.0,0.0
42358,66524,0,1176,0,1188,12,13,98.0,0.0
42362,4651,5,95,5,105,10,6,19.0,0.0
42366,119211,126,882,126,1134,252,127,7.0,0.5
42367,13641,6,108,6,120,12,7,18.0,0.0
42368,519618,156,5304,156,5616,312,157,34.0,0.0
42369,4651,5,95,5,105,10,6,19.0,0.0
42370,5015,8,56,8,72,16,9,7.0,0.0
42371,309841,489,2445,489,3423,978,490,5.0,0.0
42373,4103,5,50,5,60,10,6,10.0,0.0
42375,988388,0,17183,0,18183,1000,1001,17.183,0.5
42378,43108,44,528,44,616,88,45,12.0,0.5
42384,3565,0,40,0,45,5,6,8.0,0.0
42385,465923,1000,5662,1000,7662,2000,1001,5.662,0.5
42386,4651,5,95,5,105,10,6,19.0,0.0
42388,16638,25,152,25,202,50,26,6.08,0.0
42389,3077884,0,37206,0,39206,2000,1350,37.206,0.0
42393,43484,0,507,0,532,25,26,20.28,0.0
42397,13641,6,108,6,120,12,7,18.0,0.0
42398,7582,12,72,12,96,24,13,6.0,0.0
42399,19344,32,236,32,300,64,34,7.375,0.0
42402,3944,5,45,5,55,10,6,9.0,0.0
42403,8450,9,72,9,90,18,10,8.0,0.0
42404,598578,0,7000,0,8000,1000,1001,7.0,0.0
42406,107115,126,756,126,1008,252,127,6.0,0.5
42408,35563,0,174,0,209,35,36,4.971,0.0
42409,13976,7,111,7,125,14,8,15.857,0.0
42410,1457,1,14,1,16,2,2,14.0,0.0
42411,4399,12,24,12,48,24,13,2.0,0.0
42413,453462,1000,7000,1000,9000,2000,1001,7.0,0.0
42419,7793,6,55,6,67,12,7,9.167,0.0
42421,10267,7,46,7,60,14,8,6.571,1.0
42423,10163,0,72,0,80,8,9,9.0,0.0
42426,3042709,0,37690,0,39690,2000,1329,37.69,0.0
42428,734901,1000,9999,1000,11999,2000,1001,9.999,0.0
42429,8627,0,56,0,66,10,11,5.6,0.5
42431,574255,1000,7854,1000,9854,2000,1001,7.854,0.0
42432,49441,0,194,0,233,39,40,4.974,0.0
42434,2197,4,16,4,24,8,5,4.0,1.0
42435,23273,0,375,0,400,25,26,15.0,0.0
42436,5129,6,37,6,49,12,7,6.167,0.0
42437,414501,850,5100,850,6800,1700,851,6.0,1.0
42438,648612,1000,9000,1000,11000,2000,1001,9.0,0.0
42439,4742,9,36,9,54,18,10,4.0,0.5
42440,4917,5,44,5,54,10,6,8.8,0.0
42441,7631,12,72,12,96,24,13,6.0,0.0
42442,7768,6,55,6,67,12,7,9.167,0.0
42443,6779,5,47,5,57,10,6,9.4,0.0
42445,8647,10,56,10,76,20,11,5.6,0.5
42449,6285,8,30,8,46,16,9,3.75,0.0
42451,1459,1,14,1,16,2,2,14.0,0.0
42453,8829,20,80,20,120,40,21,4.0,0.0
42456,8688,10,56,10,76,20,11,5.6,0.5
42458,43854,0,174,0,209,35,36,4.971,0.0
42459,112168,225,1350,225,1800,450,226,6.0,1.0
4246,290054,0,3000,0,3500,500,501,6.0,0.0
42460,6009,13,48,13,74,26,14,3.692,0.0
42461,9097,6,80,6,92,12,7,13.333,0.0
42468,23778,0,375,0,400,25,26,15.0,0.0
42470,62251,80,480,80,640,160,81,6.0,0.0
42476,3637,0,24,0,30,6,7,4.0,0.0
42477,8829,20,80,20,120,40,21,4.0,0.0
42479,344329,0,4208,0,4734,526,527,8.0,0.0
42482,243667,672,2646,672,3990,1344,673,3.938,0.0
42483,4778,5,34,5,44,10,6,6.8,0.0
42484,7582,12,72,12,96,24,13,6.0,0.0
4249,66295,0,667,0,834,167,168,3.994,0.0
42493,4055,4,28,4,36,8,5,7.0,0.0
42501,5635,7,28,7,42,14,8,4.0,0.0
42514,8792,13,52,13,78,26,14,4.0,0.0
42515,25210,13,199,13,225,26,14,15.308,0.0
42530,9097,6,80,6,92,12,7,13.333,0.0
42533,23683,0,375,0,400,25,26,15.0,0.0
42537,467424,1000,5445,1000,7445,2000,1001,5.445,0.5
42538,12979,7,166,7,180,14,8,23.714,0.0
42539,7089,3,63,3,69,6,4,21.0,0.0
42540,3923,5,45,5,55,10,6,9.0,0.0
42541,9355,6,86,6,98,12,7,14.333,0.0
42542,65561,119,595,119,833,238,120,5.0,0.0
42543,4683,7,27,7,41,14,8,3.857,0.0
42544,4217,6,24,6,36,12,7,4.0,0.0
42545,3659,6,24,6,36,12,7,4.0,0.0
42546,65796,119,595,119,833,238,120,5.0,0.0
42547,3101,6,23,6,35,12,7,3.833,0.0
4255,8750,0,75,0,100,25,26,3.0,0.0
42552,7973,4,72,4,80,8,5,18.0,0.0
42556,5894,9,36,9,54,18,10,4.0,0.0
42561,8210,12,48,12,72,24,13,4.0,0.0
42562,18881,9,144,9,162,18,10,16.0,0.0
42563,8647,10,56,10,76,20,11,5.6,0.5
42565,33583,0,130,0,156,26,27,5.0,0.0
42566,2723,4,20,4,28,8,5,5.0,0.0
42569,3448,7,28,7,42,14,8,4.0,0.0
42573,8450,9,72,9,90,18,10,8.0,0.0
42576,7089,3,63,3,69,6,4,21.0,0.0
42578,4705,9,36,9,54,18,10,4.0,0.0
42580,259596,1000,1000,1000,3000,2000,1001,1.0,0.0
42581,2237,3,15,3,21,6,4,5.0,0.0
42585,10124,25,104,25,154,50,26,4.16,0.0
42586,770154,1000,13000,1000,15000,2000,1001,13.0,0.0
42587,4748,7,27,7,41,14,8,3.857,0.0
42590,4023,6,30,6,42,12,7,5.0,0.0
42595,255595,1000,1000,1000,3000,2000,1001,1.0,0.0
42597,867457,63,6159,63,6378,219,152,97.762,0.0
42598,4755,7,47,7,61,14,8,6.714,0.0
42599,14005,7,111,7,125,14,8,15.857,0.0
42600,5781,7,60,7,74,14,8,8.571,0.0
42604,4339,5,50,5,60,10,6,10.0,0.0
42611,2197,4,16,4,24,8,5,4.0,0.0
42614,3521,7,28,7,42,14,8,4.0,0.0
42616,40375,156,156,156,468,312,157,1.0,0.0
42632,255595,1000,1000,1000,3000,2000,1001,1.0,0.0
42633,104355,0,1418,0,1568,150,151,9.453,0.0
42638,3217,6,24,6,36,12,7,4.0,0.0
4264,389129,0,5412,0,5573,161,162,33.615,0.0
42640,7089,3,63,3,69,6,4,21.0,0.0
42641,3241,6,23,6,35,12,7,3.833,0.0
42652,715112,1000,12199,1000,14199,2000,1001,12.199,0.0
42657,427798,1000,6000,1000,8000,2000,1001,6.0,0.0
42659,359808,1000,3910,1000,5910,2000,1001,3.91,0.0
42661,7089,3,63,3,69,6,4,21.0,0.0
42663,536456,1000,8565,1000,10565,2000,1001,8.565,0.5
42682,539410,1000,7000,1000,9000,2000,1001,7.0,0.0
42683,361264,1000,3919,1000,5919,2000,1001,3.919,0.0
42698,788758,1000,16000,1000,18000,2000,1001,16.0,0.5
42699,255595,1000,1000,1000,3000,2000,1001,1.0,0.0
42706,792920,0,11606,0,12606,1000,1001,11.606,0.0
42707,17593,48,158,48,254,96,49,3.292,0.5
42708,91160,195,775,195,1165,390,196,3.974,0.0
42709,216716,530,1590,530,2650,1060,531,3.0,0.75
4271,367329,0,5500,0,6000,500,501,11.0,0.0
42710,355806,551,3907,551,5009,1102,552,7.091,0.0
42711,849565,0,12418,0,13418,1000,1001,12.418,0.0
42713,356791,732,2196,732,4398,2202,1464,3.0,0.0
42716,456806,793,3178,793,5565,2387,1593,4.008,0.0
42722,586900,1000,9000,1000,11000,2000,1001,9.0,1.0
42723,69501,124,496,124,872,376,253,4.0,0.0
42728,427485,700,3500,700,5612,2112,1413,5.0,0.0
42733,1129520,741,11192,741,13453,2261,1028,15.104,0.0
42734,74466,153,943,153,1249,306,154,6.163,0.0
42739,774932,0,10946,0,12946,2000,1988,10.946,0.0
4274,2864,0,20,0,25,5,6,4.0,0.0
42746,199604,208,2458,208,2994,536,219,11.817,0.0
42748,28616,67,134,67,335,201,135,2.0,0.0
42749,263424,310,3854,310,4474,620,311,12.432,0.0
42750,60670,29,335,29,419,84,56,11.552,0.0
42751,716093,0,5000,0,7000,2000,1982,5.0,0.0
42755,241583,0,1000,0,2000,1000,1001,1.0,0.0
42758,68812,123,492,123,861,369,247,4.0,0.0
42763,211402,166,2483,166,2883,400,226,14.958,0.0
42772,444514,541,7014,541,8096,1082,542,12.965,0.0
42776,129722,238,942,238,1652,710,473,3.958,0.0
42794,56589,88,643,88,872,229,101,7.307,0.0
42795,441450,1000,5000,1000,7000,2000,1001,5.0,0.0
42799,405316,791,5719,791,7301,1582,792,7.23,1.0
42805,439765,1000,5000,1000,7000,2000,1001,5.0,0.0
42809,788265,1000,11661,1000,13661,2000,1001,11.661,0.0
42818,789014,1000,11044,1000,14044,3000,1994,11.044,0.0
42828,308765,381,3494,381,4630,1136,726,9.171,0.0
42830,311909,474,4518,474,5466,948,475,9.532,0.0
42838,170028,174,2056,174,2409,353,177,11.816,0.0
42842,788050,1000,11641,1000,13641,2000,1001,11.641,0.0
42844,639025,1000,7935,1000,9935,2000,1001,7.935,0.0
42851,1043821,671,4184,671,5667,1483,813,6.235,0.75
42852,793569,1000,11583,1000,13583,2000,1001,11.583,0.5
42860,799129,1000,11115,1000,14115,3000,1994,11.115,0.0
42861,895784,1000,9381,1000,12381,3000,2001,9.381,0.0
42863,792051,1000,11641,1000,13641,2000,1001,11.641,0.0
42868,855090,1000,11517,1000,13517,2000,1001,11.517,0.0
42869,849350,1000,12383,1000,14383,2000,1001,12.383,0.5
4287,18502,0,221,0,241,20,21,11.05,0.0
42878,849583,1000,12433,1000,14433,2000,1001,12.433,0.0
42881,843664,1000,12449,1000,14449,2000,1001,12.449,0.0
42884,786725,1000,11608,1000,13608,2000,1001,11.608,0.0
42885,938524,1000,6269,1000,8288,2019,1020,6.269,0.75
42886,1248,1,5,1,8,3,3,5.0,0.0
42887,850122,1000,12412,1000,14412,2000,1001,12.412,0.0
42888,57732,124,248,124,620,372,249,2.0,0.0
42889,796030,1000,11866,1000,13866,2000,1001,11.866,0.0
4289,20107,0,178,0,207,29,30,6.138,0.0
42895,849564,1000,12418,1000,14418,2000,1001,12.418,0.0
42897,473531,1000,3000,1000,6000,3000,1994,3.0,0.0
42899,130941,211,2045,211,2467,422,212,9.692,0.0
42911,77510,55,890,55,1102,212,65,16.182,0.0
42919,520127,1000,7129,1000,9129,2000,1001,7.129,0.0
42921,789468,1000,11539,1000,13539,2000,1001,11.539,0.0
42929,793692,1000,11590,1000,13590,2000,1001,11.59,0.0
42933,783843,1000,11638,1000,13638,2000,1001,11.638,0.0
42939,732803,1000,9381,1000,11381,2000,1001,9.381,0.0
42944,792449,1000,11586,1000,13586,2000,1001,11.586,0.0
42950,855090,1000,11517,1000,13517,2000,1001,11.517,0.0
42952,792051,1000,11641,1000,13641,2000,1001,11.641,0.0
42954,859819,1000,12460,1000,14460,2000,1001,12.46,0.0
42955,201567,320,2905,320,3545,640,321,9.078,0.0
42956,800719,1000,11714,1000,13714,2000,1001,11.714,0.0
42959,839105,1000,12454,1000,14454,2000,1001,12.454,0.0
42960,794920,1000,11606,1000,13606,2000,1001,11.606,0.0
42961,212786,327,3173,327,3827,654,328,9.703,0.0
42962,370080,842,4210,842,5894,1684,843,5.0,0.0
42965,790671,1000,11616,1000,13616,2000,1001,11.616,0.0
4297,2455,1,7,1,9,2,2,7.0,1.0
42971,633590,1000,9020,1000,11020,2000,1001,9.02,0.0
42973,22038,0,95,0,164,69,70,5.0,0.0
42974,842497,1000,12390,1000,14390,2000,1001,12.39,0.0
42978,543966,1000,6999,1000,8999,2000,1001,6.999,0.0
42979,12587,31,93,31,155,62,32,3.0,0.0
42985,891783,1000,9381,1000,12381,3000,2001,9.381,0.0
43,4984827,9622,57726,9622,76968,19242,9623,5.999,0.0
43006,1119375,1000,14429,1000,16678,2249,1161,14.429,0.0
43009,858969,1000,12539,1000,14539,2000,1001,12.539,1.0
43011,842588,1000,11216,1000,13216,2000,1001,11.216,0.0
43031,603650,1000,9049,1000,11049,2000,1001,9.049,0.0
43032,1264325,1000,13066,1000,15887,2821,1465,13.066,0.0
43034,878874,1000,13253,1000,15253,2000,1001,13.253,0.5
43038,843860,1000,12379,1000,14379,2000,1001,12.379,0.0
43043,81593,43,827,43,952,125,75,19.233,0.0
43044,185973,236,2706,236,3178,472,237,11.466,0.0
43046,353601,551,3907,551,5009,1102,552,7.091,0.0
43048,839835,1000,12372,1000,14372,2000,1001,12.372,0.0
43050,196089,152,2304,152,2671,367,207,15.158,0.0
43055,560065,1000,8020,1000,10020,2000,1001,8.02,0.0
43067,709920,530,7503,530,8599,1096,551,14.157,0.75
43069,451861,1000,5188,1000,7188,2000,1001,5.188,0.0
43071,594682,1000,8000,1000,10000,2000,1001,8.0,0.0
43076,767188,912,11254,912,13078,1824,913,12.34,0.0
43079,404710,337,1857,337,2531,674,338,5.51,0.5
43085,539859,200,4088,200,4488,400,201,20.44,0.0
43086,122002,187,1824,187,2198,374,188,9.754,0.0
43087,91914,103,685,103,960,275,173,6.65,0.6666666666666666
43089,199887,235,2919,235,3389,470,236,12.421,0.0
43092,103789,232,1188,232,1652,464,233,5.121,0.0
43095,24906,17,109,17,143,34,18,6.412,0.5
43099,1308701,1000,14267,1000,16999,2732,1382,14.267,0.0
43100,790932,1000,11547,1000,13547,2000,1001,11.547,0.0
43109,1842351,1000,20005,1000,23610,3605,1509,20.005,0.0
43110,25386,37,74,37,148,74,38,2.0,1.0
43111,186918,236,2706,236,3178,472,237,11.466,0.0
43116,176804,313,2026,313,2810,784,473,6.473,0.5
43136,137513,163,2008,163,2334,326,164,12.319,0.0
43138,232976,144,1793,144,2081,288,145,12.451,0.0
43139,65133,81,948,81,1110,162,82,11.704,0.0
43141,590681,1000,8000,1000,10000,2000,1001,8.0,0.0
43144,146325,183,2138,183,2504,366,184,11.683,0.0
43145,5723,12,36,12,72,36,25,3.0,0.0
43152,456806,793,3178,793,5565,2387,1593,4.008,0.0
43162,21318,15,255,15,285,30,16,17.0,0.0
4317,348113,0,5000,0,5500,500,501,10.0,0.0
43174,207433,166,2483,166,2863,380,207,14.958,0.0
43176,188145,143,2294,143,2701,407,169,16.042,0.0
43192,57024,72,826,72,970,144,73,11.472,0.0
43206,245616,740,2220,740,3700,1480,741,3.0,0.0
43215,280436,157,2520,157,3014,494,280,16.051,0.0
43219,4908,5,63,5,73,10,6,12.6,0.0
43220,786485,1000,11570,1000,13570,2000,1001,11.57,0.0
43224,1669200,1000,14783,1000,18138,3355,1756,14.783,0.0
43225,501452,1000,7174,1000,9174,2000,1001,7.174,0.0
43227,147931,185,2133,185,2503,370,186,11.53,0.0
43231,137882,146,1020,146,1312,292,147,6.986,0.0
43234,794920,1000,11606,1000,13606,2000,1001,11.606,0.0
43235,98472,56,1563,56,1675,112,57,27.911,0.0
4324,30222,0,270,0,324,54,55,5.0,0.0
43243,189651,226,2822,226,3274,452,227,12.487,0.0
43251,893756,1000,12287,1000,14287,2000,1001,12.287,0.0
43254,214633,186,2749,186,3360,611,198,14.78,0.0
43259,464916,1000,6060,1000,8060,2000,1001,6.06,0.0
43262,20974,19,123,19,170,47,29,6.474,0.5
43272,239672,184,3104,184,3615,511,220,16.87,0.0
43273,127139,0,2298,0,2507,209,210,10.995,0.0
43274,33916,34,421,34,503,82,45,12.382,0.0
43275,838806,1000,11833,1000,13833,2000,1001,11.833,0.0
43276,514793,370,5111,370,6127,1016,469,13.814,0.0
43279,48735,88,704,88,880,176,89,8.0,0.0
43283,588391,1000,7656,1000,9656,2000,1001,7.656,0.0
43284,173992,481,1442,481,2404,962,482,2.998,0.0
43285,729670,1000,10078,1000,12078,2000,1001,10.078,0.0
43287,416192,792,5957,792,7541,1584,793,7.521,0.0
43291,8228,9,81,9,108,27,19,9.0,0.0
43294,453921,243,4463,243,5116,653,296,18.366,0.0
43296,219915,115,460,115,690,230,116,4.0,0.0
43297,349928,278,4098,278,4760,662,327,14.741,0.0
43298,109083,133,842,133,1170,328,144,6.331,0.0
43300,400006,637,5754,637,7028,1274,638,9.033,0.0
43301,22288,25,310,25,360,50,26,12.4,0.0
43302,696713,529,6998,529,8474,1476,807,13.229,0.0
43303,1017171,1000,14351,1000,16351,2000,1001,14.351,0.0
43306,35681,34,437,34,528,91,53,12.853,0.0
4331,56936,0,1120,0,1190,70,71,16.0,0.0
43317,166520,162,2278,162,2622,344,173,14.062,0.0
4333,366620,0,5124,0,5624,500,501,10.248,0.0
4335,1190659,0,19038,0,19538,500,501,38.076,0.0
4337,12437,22,66,22,132,66,45,3.0,0.0
43376,4571,9,38,9,56,18,10,4.222,0.0
43377,137581,215,1990,215,2420,430,216,9.256,0.0
43379,8532,8,53,8,71,18,11,6.625,0.0
43382,848506,0,12708,0,13708,1000,1001,12.708,0.0
43388,853169,1000,12505,1000,14505,2000,1001,12.505,0.0
43391,56286,47,303,47,402,99,53,6.447,0.5
43392,38272,18,86,18,124,38,21,4.778,1.0
43396,471302,1000,6136,1000,8136,2000,1001,6.136,0.0
43397,788676,1000,11606,1000,13606,2000,1001,11.606,0.0
4341,509429,0,8063,0,8563,500,501,16.126,0.0
4342,308633,500,5500,500,6500,1000,501,11.0,0.0
4343,1584444,500,26844,500,27844,1000,501,53.688,0.0
43445,16544,14,181,14,218,37,23,12.929,0.0
43446,794920,1000,11606,1000,13606,2000,1001,11.606,0.0
43447,550193,700,8093,700,9493,1400,701,11.561,0.0
43448,707026,540,7177,540,8763,1586,885,13.291,0.0
43449,280436,157,2520,157,3014,494,280,16.051,0.0
43450,66675,54,869,54,977,108,55,16.093,0.0
43452,4731,5,61,5,71,10,6,12.2,0.0
43456,256986,187,2908,187,3448,540,342,15.551,0.0
43457,791562,1000,11636,1000,13636,2000,1001,11.636,0.0
43458,169115,215,2485,215,2915,430,216,11.558,0.0
4346,436824,0,9000,0,9500,500,501,18.0,0.0
43461,795602,1000,11642,1000,13642,2000,1001,11.642,0.0
43463,46164,78,624,78,780,156,79,8.0,0.0
43464,207787,323,2980,323,3626,646,324,9.226,0.0
43467,309871,488,4480,488,5456,976,489,9.18,0.0
4347,11443,12,192,12,216,24,13,16.0,0.0
43472,173992,481,1442,481,2404,962,482,2.998,0.0
43474,314174,400,4598,400,5398,800,401,11.495,0.0
43477,418944,533,6178,533,7244,1066,534,11.591,0.0
43479,13737,32,64,32,128,64,33,2.0,0.0
43480,202958,256,2988,256,3500,512,257,11.672,0.0
43481,87618,78,1078,78,1243,165,82,13.821,0.0
43482,619940,977,8982,977,10936,1954,978,9.193,0.0
43485,209861,152,2311,152,2779,468,237,15.204,0.0
43489,4699,5,63,5,73,10,6,12.6,0.0
4349,14238,4,224,4,232,8,5,56.0,0.0
43490,564660,980,8074,980,10034,1960,981,8.239,0.0
43492,23010,20,259,20,327,68,36,12.95,0.0
43493,786071,1000,11603,1000,13603,2000,1001,11.603,0.0
43495,6897,7,46,7,60,14,8,6.571,0.0
43496,703613,891,10321,891,12103,1782,892,11.584,0.0
43500,18935,39,195,39,273,78,40,5.0,0.0
43501,83446,341,341,341,1023,682,342,1.0,0.0
43502,4720,5,63,5,73,10,6,12.6,0.0
43504,430611,680,6226,680,7586,1360,681,9.156,0.0
43509,51823,96,686,96,878,192,97,7.146,0.0
43510,344834,433,5035,433,5901,866,434,11.628,0.0
43512,178926,204,2461,204,2869,408,205,12.064,0.0
43513,199837,253,2950,253,3456,506,254,11.66,0.0
43514,14831,21,84,21,177,93,73,4.0,0.0
43515,616625,775,9066,775,10616,1550,776,11.698,0.0
43516,147945,285,2126,285,2696,570,286,7.46,0.0
43524,4679,5,62,5,72,10,6,12.4,0.0
43529,4762,5,62,5,72,10,6,12.4,0.0
43530,40759,87,435,87,609,174,88,5.0,0.0
43531,7434,10,70,10,100,30,21,7.0,0.0
43532,198014,150,1500,150,1800,300,151,10.0,0.0
43536,514127,944,7606,944,9494,1888,945,8.057,0.5
43539,72091,130,780,130,1040,260,131,6.0,0.5
4355,20939,25,236,25,286,50,26,9.44,0.0
43573,94028,196,1218,196,1610,392,197,6.214,0.0
43589,663810,789,9759,789,11337,1578,790,12.369,0.0
43591,4762,5,63,5,73,10,6,12.6,0.0
43597,502327,1000,6141,1000,8141,2000,1001,6.141,0.0
43599,192190,258,2589,258,3105,516,259,10.035,0.0
4361,464048,500,7920,500,8920,1000,501,15.84,0.0
43612,112164,177,885,177,1239,354,178,5.0,0.0
43619,202584,241,2992,241,3474,482,242,12.415,0.0
4363,655077,500,10500,500,11500,1000,501,21.0,0.0
43631,793585,1000,11571,1000,13571,2000,1001,11.571,0.0
43636,182033,231,2651,231,3113,462,232,11.476,0.0
43651,468553,846,3384,846,5922,2538,1690,4.0,0.0
43653,4977,5,63,5,73,10,6,12.6,0.0
43657,79026,166,1020,166,1352,332,167,6.145,0.0
43667,165916,260,2384,260,2904,520,261,9.169,0.0
4367,550072,500,8955,500,9955,1000,501,17.91,0.0
43673,2537,4,20,4,28,8,5,5.0,0.0
43683,2195272,1000,31270,1000,33270,2000,1001,31.27,0.0
43687,7619,0,54,0,65,11,12,6.0,1.0
43689,45973,137,411,137,685,274,138,3.0,0.0
43691,792763,1000,11709,1000,13709,2000,1001,11.709,0.0
43693,4746,5,62,5,72,10,6,12.4,0.0
43698,955669,1000,6404,1000,11326,4922,1077,6.404,0.0
43706,60564,71,880,71,1022,142,72,12.394,0.0
43708,5059,3,42,3,53,11,9,14.0,0.0
43722,9987,17,34,17,119,85,53,2.0,0.0
43749,323289,411,4770,411,5592,822,412,11.606,0.0
4375,413161,0,8500,0,9000,500,501,17.0,0.0
4376,795954,0,6000,0,6500,500,501,12.0,0.0
43785,256986,187,2908,187,3448,540,342,15.551,0.0
43786,442437,1000,5134,1000,7134,2000,1001,5.134,0.0
43787,8862,11,72,11,95,23,13,6.545,0.5
43788,232399,144,1793,144,2081,288,145,12.451,0.0
4379,52910,21,345,21,387,42,22,16.429,0.875
43790,40047,85,216,85,471,255,170,2.541,0.0
43797,98792,104,1232,104,1440,208,105,11.846,0.0
43798,141696,109,1580,109,1885,305,135,14.495,0.0
4380,5261,12,48,12,72,24,13,4.0,0.0
43806,115645,148,1720,148,2016,296,149,11.622,0.0
4382,12500,25,125,25,175,50,26,5.0,0.0
4383,48973,16,832,16,864,32,17,52.0,0.0
4384,441826,500,6000,500,7000,1000,501,12.0,0.0
43841,4836,5,63,5,73,10,6,12.6,0.0
43847,369466,700,5050,700,6450,1400,701,7.214,0.0
43848,247902,531,3257,531,4319,1062,532,6.134,0.0
4385,507570,500,9062,500,10062,1000,502,18.124,0.0
4386,113319,0,2240,0,2380,140,141,16.0,0.0
43863,66187,86,1008,86,1180,172,87,11.721,0.0
4387,577308,500,9518,500,10518,1000,501,19.036,0.0
43876,1444,1,9,1,12,3,3,9.0,0.0
4388,5255,0,48,0,60,12,13,4.0,0.0
43882,1549,2,13,2,17,4,4,6.5,0.0
43888,94691,381,381,381,1143,762,382,1.0,0.0
4391,19839,0,152,0,228,76,77,4.0,0.0
43911,4756,5,61,5,71,10,6,12.2,0.0
43918,7870,8,56,8,72,16,9,7.0,0.5
43920,10082,9,58,9,79,21,13,6.444,0.5
4393,7757,12,84,12,108,24,13,7.0,0.0
43939,2383,0,23,0,27,4,5,5.75,0.0
4394,9110,6,62,6,98,36,31,10.333,0.0
43944,844095,0,12777,0,13777,1000,1001,12.777,0.0
4396,136365,223,1784,223,2230,446,225,8.0,0.0
43973,1191043,1000,22705,1000,24705,2000,1001,22.705,0.0
43976,1072180,1000,20621,1000,22621,2000,1001,20.621,0.0
4398,16551,25,75,25,180,105,80,3.0,0.0
43985,60193,32,671,32,735,64,33,20.969,0.0
44,608533,1087,3674,1087,5824,2150,1089,3.38,0.0
44005,39836,75,450,75,600,150,76,6.0,0.0
44007,339134,311,2412,311,4121,1709,1399,7.756,1.0
44009,12951,11,68,11,92,24,14,6.182,0.5
4401,1256403,10,150,10,170,20,12,15.0,0.0
44012,2396,4,12,4,24,12,9,3.0,0.0
44015,439030,373,4990,373,5988,998,388,13.378,0.0
44017,555978,705,8209,705,9619,1410,706,11.644,0.0
44018,216716,530,1590,530,2650,1060,531,3.0,0.5
44020,33105,32,267,32,431,164,116,8.344,0.0
44023,2755,5,22,5,32,10,6,4.4,0.0
44028,10523,14,90,14,118,28,15,6.429,0.75
4403,84487,192,1346,192,1730,384,195,7.01,0.0
44031,41362,57,602,57,716,114,58,10.561,0.0
44032,94146,35,1094,35,1164,70,36,31.257,0.0
44035,739037,1000,13048,1000,15048,2000,1001,13.048,0.0
44039,7903,13,80,13,115,35,23,6.154,1.0
44041,1090,1,7,1,9,2,2,7.0,0.0
44043,278168,531,3788,531,4850,1062,532,7.134,0.0
44044,41170,30,458,30,606,148,42,15.267,0.0
44045,4785,6,38,6,50,12,7,6.333,0.0
44047,11910,24,48,24,120,72,49,2.0,0.0
44049,21318,15,255,15,285,30,16,17.0,0.0
44059,34152,86,516,86,688,172,88,6.0,0.0
44063,13771,11,173,11,207,34,21,15.727,0.0
44064,659570,1000,9000,1000,11000,2000,1001,9.0,0.0
44065,27864,35,283,35,353,70,36,8.086,0.0
44069,2286,2,25,2,29,4,3,12.5,0.0
4408,773811,295,12944,295,13534,590,296,43.878,0.0
44086,413596,238,3326,238,4088,762,432,13.975,0.75
44095,232413,433,3092,433,3958,866,434,7.141,0.0
44096,1629,3,11,3,17,6,4,3.667,1.0
44097,178850,174,2051,174,2547,496,323,11.787,0.0
44098,2640,3,18,3,27,9,7,6.0,0.0
4410,428826,0,5000,0,5500,500,501,10.0,0.0
44106,255041,551,2201,551,3303,1102,552,3.995,0.0
44111,16145,63,63,63,189,126,64,1.0,0.0
4414,344691,500,5228,500,6228,1000,501,10.456,0.0
44151,3864,3,39,3,51,12,8,13.0,0.0
44152,16487,0,69,0,92,23,24,3.0,0.0
44153,2806,4,28,4,36,8,5,7.0,0.0
44155,4272,3,36,3,42,6,4,12.0,0.0
44157,107949,199,1194,199,1592,398,200,6.0,0.0
44159,486941,621,7213,621,8455,1242,622,11.615,0.0
44161,545093,700,7967,700,9367,1400,701,11.381,0.0
44162,280966,260,3658,260,4354,696,272,14.069,0.0
44164,19158,27,189,27,243,54,28,7.0,0.0
44165,56421,104,624,104,832,208,105,6.0,0.5
44169,3597,3,19,3,25,6,4,6.333,0.5
44170,16913,25,200,25,250,50,26,8.0,0.0
44173,22966,42,252,42,336,84,43,6.0,0.0
44175,1003,0,6,0,7,1,2,6.0,0.0
44176,20609,37,259,37,333,74,38,7.0,0.0
44177,1768865,1000,20337,1000,23469,3132,1482,20.337,0.0
44189,831781,1000,12272,1000,14272,2000,1001,12.272,0.0
4419,1558517,0,33000,0,33500,500,501,66.0,0.0
44191,2251,3,17,3,25,8,6,5.667,0.0
44196,727852,1000,10150,1000,12150,2000,1001,10.15,0.0
44199,530958,1000,7100,1000,9100,2000,1001,7.1,0.0
4420,414711,0,8500,0,9000,500,501,17.0,0.0
44205,85867,110,1262,110,1482,220,111,11.473,0.0
44207,790841,1000,11552,1000,13552,2000,1001,11.552,0.0
4421,388795,500,5390,500,6390,1000,501,10.78,0.0
44211,36408,54,432,54,540,108,55,8.0,0.0
4423,479491,500,7419,500,8419,1000,501,14.838,0.0
44233,323289,411,4770,411,5592,822,412,11.606,0.0
44238,647148,1000,9084,1000,11084,2000,1001,9.084,0.0
44245,602630,384,5425,384,6606,1181,605,14.128,0.0
44252,243583,1000,1000,1000,3000,2000,1001,1.0,0.0
44253,2514,3,21,3,27,6,4,7.0,0.0
4426,109691,30,1822,30,1882,60,31,60.733,0.0
44261,30721,23,380,23,449,69,28,16.522,0.0
44268,129616,531,531,531,1593,1062,532,1.0,0.0
4427,85464,127,1016,127,1270,254,128,8.0,0.0
4428,28393,7,466,7,480,14,8,66.571,0.0
44291,849564,1000,12418,1000,14418,2000,1001,12.418,0.0
4430,243400,500,3500,500,4500,1000,501,7.0,0.0
44302,199837,253,2950,253,3456,506,254,11.66,0.0
4431,187698,500,1532,500,2532,1000,501,3.064,0.0
44317,789760,1000,11583,1000,13583,2000,1001,11.583,0.0
4432,937308,500,15784,500,16784,1000,501,31.568,0.0
44322,16260,0,195,0,220,25,26,7.8,0.0
44327,2614,4,24,4,32,8,5,6.0,0.0
4434,597810,446,9098,446,9990,892,447,20.399,0.0
44340,247584,1000,1000,1000,3000,2000,1001,1.0,0.0
44348,5992,13,55,13,81,26,14,4.231,0.0
4435,168687,500,1629,500,2629,1000,501,3.258,0.0
44351,27624,31,401,31,463,62,32,12.935,0.0
44359,11698,19,123,19,161,38,20,6.474,0.5
44361,300119,376,4355,376,5107,752,377,11.582,0.0
44364,27241,21,327,21,385,58,29,15.571,0.0
44369,21423,30,210,30,270,60,31,7.0,0.0
4438,16539,5,264,5,274,10,6,52.8,0.0
44382,6658,10,54,10,79,25,16,5.4,0.0
44387,16756,39,156,39,234,78,40,4.0,0.0
4439,4027,6,42,6,54,12,7,7.0,0.0
44394,18651,38,190,38,266,76,39,5.0,0.0
44398,9997,16,76,16,108,32,17,4.75,0.0
4440,3139,4,28,4,36,8,5,7.0,0.0
44400,1550143,1000,23929,1000,25929,2000,1001,23.929,0.0
44405,21719,0,320,0,356,36,37,8.889,0.0
44406,91843,92,1012,92,1286,274,168,11.0,0.0
44407,6749,8,93,8,109,16,9,11.625,0.0
44408,186721,766,766,766,2298,1532,767,1.0,0.0
44409,102562,82,1309,82,1555,246,95,15.963,0.0
4441,6953,12,72,12,96,24,13,6.0,0.0
44412,7058,9,85,9,103,18,10,9.444,0.0
44413,6054,5,68,5,83,15,10,13.6,0.0
44414,456746,1000,4000,1000,6000,2000,1001,4.0,0.0
44416,18129,27,216,27,270,54,28,8.0,0.0
4442,2666,4,24,4,32,8,5,6.0,0.0
44420,120773,150,1763,150,2063,300,151,11.753,0.0
44422,75081,107,1013,107,1227,214,109,9.467,0.0
44423,2142,2,23,2,27,4,3,11.5,0.0
44427,693520,1000,11000,1000,13000,2000,1001,11.0,0.0
4443,7225,9,90,9,108,18,10,10.0,0.0
44432,27788,12,444,12,468,24,13,37.0,0.0
44435,203882,243,3001,243,3487,486,244,12.35,0.0
44436,243583,1000,1000,1000,3000,2000,1001,1.0,0.0
44439,1140595,0,22656,0,23656,1000,1001,22.656,0.0
4444,1716,3,9,3,15,6,4,3.0,0.0
4445,7931,20,60,20,100,40,21,3.0,0.0
44454,783605,1000,11606,1000,13606,2000,1001,11.606,0.0
44459,6453,10,90,10,110,20,11,9.0,0.0
4446,33384,80,320,80,480,160,81,4.0,0.0
44462,12798,15,158,15,188,30,16,10.533,0.0
44466,21516,36,275,36,347,72,37,7.639,0.0
4447,38505,96,288,96,480,192,97,3.0,0.0
44482,13207,18,162,18,198,36,19,9.0,0.0
44484,8402,14,90,14,118,28,15,6.429,0.0
44485,112052,162,1415,162,1740,325,164,8.735,1.0
44486,17875,27,216,27,270,54,28,8.0,0.5
44487,12224,0,162,0,189,27,28,6.0,0.0
44489,2869,3,30,3,36,6,4,10.0,0.0
4449,1479,2,8,2,12,4,3,4.0,0.0
44491,81580,117,1106,117,1340,234,119,9.453,0.0
44496,21481,86,86,86,258,172,87,1.0,0.0
4450,12071,20,120,20,160,40,21,6.0,0.0
44503,10141,0,81,0,108,27,28,3.0,0.0
44517,16069,0,155,0,186,31,32,5.0,0.0
44518,11513,0,135,0,162,27,28,5.0,0.0
44522,25936,22,264,22,308,44,23,12.0,0.0
44523,24556,35,245,35,315,70,36,7.0,0.0
44525,127673,113,1675,113,1995,320,123,14.823,0.0
44531,243583,1000,1000,1000,3000,2000,1001,1.0,0.0
4454,300574,500,2865,500,3865,1000,501,5.73,0.0
44544,18796,0,185,0,222,37,38,5.0,0.5
4455,46452,0,407,0,491,84,85,4.845,0.5
44559,5929,22,22,22,66,44,23,1.0,0.0
44565,11890,16,154,16,186,32,18,9.625,0.0
44568,4796,0,63,0,70,7,8,9.0,0.0
4457,79878,157,785,157,1099,314,158,5.0,0.0
4458,310073,0,4500,0,5000,500,501,9.0,0.0
44586,22236,0,217,0,248,31,32,7.0,0.0
4459,328882,500,5000,500,6000,1000,501,10.0,0.0
44593,163636,671,671,671,2013,1342,672,1.0,0.0
44599,17350,69,69,69,207,138,70,1.0,0.0
4460,237426,217,3472,217,3906,434,218,16.0,0.0
44600,25160,35,245,35,315,70,36,7.0,0.0
44601,788265,1000,11661,1000,13661,2000,1001,11.661,0.0
44603,724290,1000,10614,1000,12614,2000,1001,10.614,0.0
44605,8845,17,102,17,136,34,18,6.0,0.5
44608,730549,1000,10606,1000,12606,2000,1001,10.606,0.0
4461,386748,0,5000,0,5500,500,501,10.0,0.0
44613,1583,3,9,3,15,6,4,3.0,0.0
44619,17708,36,141,36,213,72,37,3.917,0.0
4462,608280,500,8494,500,9494,1000,501,16.988,0.0
44622,17683,22,154,22,198,44,23,7.0,0.0
44623,896365,1000,13025,1000,15025,2000,1001,13.025,0.0
4463,129179,180,2340,180,2700,360,181,13.0,0.0
4464,352958,500,4500,500,5500,1000,501,9.0,0.0
44641,55584,26,650,26,702,52,27,25.0,0.0
44647,55584,26,650,26,702,52,27,25.0,0.0
44648,28253,0,272,0,312,40,41,6.8,0.0
4465,190583,500,1500,500,2500,1000,501,3.0,0.0
44654,37033,150,150,150,450,300,151,1.0,0.0
44656,3226,3,15,3,21,6,4,5.0,0.0
44657,849564,1000,12418,1000,14418,2000,1001,12.418,0.0
4466,303708,500,4000,500,5000,1000,502,8.0,0.0
44660,18176,0,175,0,210,35,36,5.0,0.0
44663,845380,1000,12433,1000,14433,2000,1001,12.433,0.0
4467,209202,377,2771,377,3525,754,379,7.35,0.0
44676,21423,30,210,30,270,60,31,7.0,0.0
44678,243583,1000,1000,1000,3000,2000,1001,1.0,0.0
4468,282538,500,3540,500,4540,1000,502,7.08,0.0
44683,12862,35,105,35,175,70,36,3.0,0.0
44685,243583,1000,1000,1000,3000,2000,1001,1.0,0.0
44688,39677,31,310,31,372,62,32,10.0,0.0
4469,67893,40,317,40,644,327,132,7.925,0.0
44693,16648,31,155,31,217,62,32,5.0,0.0
44696,243583,1000,1000,1000,3000,2000,1001,1.0,0.0
44698,47204,37,217,37,403,186,49,5.865,0.0
44699,219542,256,1350,256,2490,1140,285,5.273,0.0
4470,557296,500,3987,500,4987,1000,502,7.974,0.0
4471,129722,238,942,238,1652,710,473,3.958,0.0
44711,496785,1000,5261,1000,7261,2000,1001,5.261,0.0
44713,33188,132,132,132,396,264,133,1.0,0.0
44715,37074,27,270,27,324,54,28,10.0,0.0
44716,683522,1000,11000,1000,13000,2000,1001,11.0,0.0
4472,26298,0,270,0,324,54,55,5.0,0.0
44721,243583,1000,1000,1000,3000,2000,1001,1.0,0.0
44728,243583,1000,1000,1000,3000,2000,1001,1.0,0.0
4473,246349,284,1751,284,2319,568,286,6.165,0.0
44730,2166008,1000,30617,1000,32617,2000,1001,30.617,0.5
44738,50287,39,390,39,468,78,40,10.0,0.0
44739,247584,1000,1000,1000,3000,2000,1001,1.0,0.0
4474,41672,79,237,79,487,250,171,3.0,0.0
44747,35347,26,260,26,312,52,27,10.0,0.0
44748,243583,1000,1000,1000,3000,2000,1001,1.0,0.0
44749,243583,1000,1000,1000,3000,2000,1001,1.0,0.0
44751,243583,1000,1000,1000,3000,2000,1001,1.0,0.0
44753,17708,36,141,36,213,72,37,3.917,0.0
44757,55744,227,227,227,681,454,228,1.0,0.0
4476,324247,500,4000,500,5000,1000,501,8.0,0.0
44761,243583,1000,1000,1000,3000,2000,1001,1.0,0.0
44763,243583,1000,1000,1000,3000,2000,1001,1.0,0.0
44765,243583,1000,1000,1000,3000,2000,1001,1.0,0.0
44771,220895,301,2275,301,3174,899,576,7.558,0.0
44772,492610,1000,6000,1000,8000,2000,1001,6.0,0.0
44773,17744,22,181,22,243,62,41,8.227,0.0
44777,19777,14,140,14,168,28,15,10.0,0.0
44778,9958,7,70,7,84,14,8,10.0,0.0
44779,243583,1000,1000,1000,3000,2000,1001,1.0,0.0
4478,351823,500,4500,500,5500,1000,501,9.0,0.0
44781,24085,17,170,17,204,34,18,10.0,0.0
44784,685119,1000,11000,1000,13000,2000,1001,11.0,0.0
44788,3440055,1000,17116,1000,19116,2000,1001,17.116,0.0
44789,243583,1000,1000,1000,3000,2000,1001,1.0,0.0
4479,351079,500,4500,500,5500,1000,501,9.0,0.0
44790,1075735,1000,19000,1000,21000,2000,1001,19.0,0.0
44796,36965,27,270,27,324,54,28,10.0,0.5
4480,350270,500,4500,500,5500,1000,501,9.0,0.0
4481,349325,500,4500,500,5500,1000,501,9.0,0.0
44811,153611,203,1041,203,1863,822,214,5.128,0.0
44814,81710,0,372,0,620,248,249,1.5,0.5
44816,82702,248,372,248,868,496,249,1.5,0.0
44817,11740,0,78,0,104,26,27,3.0,0.5
44818,4572,0,27,0,36,9,10,3.0,0.5
44819,3624,0,21,0,28,7,8,3.0,0.0
4482,357865,500,4500,500,5500,1000,501,9.0,0.0
44820,5531,0,33,0,44,11,12,3.0,0.5
44825,5561,0,33,0,44,11,12,3.0,0.0
44826,8328,0,48,0,64,16,17,3.0,0.5
4483,344855,500,4000,500,5000,1000,501,8.0,0.0
44830,962,0,3,0,4,1,2,3.0,0.0
44832,1865,0,9,0,12,3,4,3.0,0.0
44836,33567,56,280,56,392,112,57,5.0,0.0
44838,5317,9,45,9,63,18,10,5.0,0.0
4484,347290,500,4500,500,5500,1000,501,9.0,0.0
44840,25115,51,204,51,306,102,52,4.0,0.0
44841,4456,6,32,6,44,12,7,5.333,0.0
44842,5024,6,60,6,72,12,7,10.0,0.0
44845,726247,1000,11000,1000,13000,2000,1001,11.0,0.0
44847,45949,63,575,63,701,126,64,9.127,0.0
44850,981583,0,15638,0,16638,1000,1001,15.638,0.0
44851,1010638,1000,11172,1000,14161,2989,1957,11.172,0.0
44853,89706,94,539,94,764,225,132,5.734,0.0
44855,861328,0,13000,0,14000,1000,1001,13.0,0.0
44856,243719,389,1824,389,2991,1167,709,4.689,0.0
44858,211722,329,1563,329,2550,987,659,4.751,0.0
4486,214048,0,2597,0,2934,337,317,12.136,0.0
44866,10198,20,40,20,100,60,41,2.0,0.0
44867,19488,38,114,38,228,114,77,3.0,0.0
4487,188332,209,2508,209,2926,418,210,12.0,0.0
44870,269609,1000,1000,1000,3000,2000,1001,1.0,0.0
44872,269609,1000,1000,1000,3000,2000,1001,1.0,0.0
44876,886972,1000,8968,1000,11968,3000,1053,8.968,0.0
4488,48515,82,574,82,738,164,83,7.0,0.0
44889,2818436,1000,64566,1000,66566,2000,1001,64.566,0.0
4489,7599,12,84,12,108,24,13,7.0,0.0
44892,27208,50,148,50,298,150,101,2.96,0.0
44905,8645,15,60,15,105,45,31,4.0,0.0
4492,360173,500,4397,500,5397,1000,501,8.794,0.0
44929,624569,0,9999,0,10999,1000,1001,9.999,0.0
44932,32339,0,192,0,320,128,129,3.0,0.5
44933,1325928,0,18847,0,19847,1000,1001,18.847,0.0
44934,291217,0,2020,0,3030,1010,1010,4.0,0.0
44936,20670,0,136,0,204,68,69,4.0,0.0
44937,14424,0,100,0,150,50,51,4.0,0.0
4494,43877,67,134,67,335,201,135,2.0,0.0
44941,884297,0,9000,0,10000,1000,1001,9.0,0.0
44943,415366,0,5000,0,6000,1000,1001,5.0,0.0
44945,47814,0,420,0,560,140,141,6.0,0.0
44949,936995,1000,14662,1000,16662,2000,1001,14.662,0.0
44950,1354638,0,20000,0,21000,1000,1001,20.0,0.5
44954,586557,1000,7000,1000,9000,2000,1001,7.0,0.0
44956,1407398,0,18898,0,19898,1000,1001,18.898,0.0
44957,387896,0,5331,0,5564,233,224,33.319,0.0
44958,50643,186,186,186,558,372,187,1.0,0.0
4496,369417,500,5973,500,6973,1000,501,11.946,0.0
4497,285497,500,4000,500,5000,1000,501,8.0,0.0
44970,17556,63,63,63,189,126,64,1.0,0.0
44971,5994,9,36,9,63,27,19,4.0,0.0
44974,543514,0,7000,0,8000,1000,1001,7.0,0.0
44976,1316202,0,19000,0,20000,1000,1001,19.0,0.0
44978,698149,0,7000,0,9000,2000,2001,7.0,0.0
44979,531108,0,10000,0,11000,1000,1001,10.0,0.0
4498,393667,500,6447,500,7447,1000,501,12.894,0.0
44981,1170587,1000,18768,1000,22730,3962,2241,9.384,0.0
44982,112613,0,977,0,1140,163,164,5.994,0.0
44983,1869309,0,26924,0,27924,1000,1001,26.924,0.0
44984,2169,0,12,0,16,4,5,3.0,0.0
44985,269609,1000,1000,1000,3000,2000,1001,1.0,0.0
44986,787390,1000,13000,1000,15000,2000,1001,13.0,0.0
44987,413609,0,5000,0,6000,1000,1001,5.0,0.0
4499,1190659,0,19038,0,19538,500,501,38.076,0.0
44993,50699,0,414,0,552,138,139,3.0,0.0
44995,1278174,0,22366,0,23264,898,899,24.906,0.0
44997,269609,1000,1000,1000,3000,2000,1001,1.0,0.0
45,44966,182,458,182,776,318,186,3.343,0.0
45001,75064,0,615,0,820,205,206,3.0,0.0
45002,390495,118,3368,118,4604,1236,1120,3.013,0.0
45004,1477461,2000,21882,2000,26882,5000,3002,7.294,0.0
45007,52795,194,194,194,582,388,195,1.0,0.0
45008,274179,0,6541,0,6983,442,443,14.799,0.0
4501,371834,500,5962,500,6962,1000,501,11.924,0.0
45014,951844,0,15808,0,16808,1000,1001,15.808,0.0
45017,6854,0,46,0,62,16,17,2.875,0.0
45018,550232,3,11012,3,12018,1006,1005,10.979,0.0
45019,44115,0,472,0,531,59,60,8.0,0.0
4502,364034,500,5500,500,6500,1000,501,11.0,0.0
45020,1326039,0,19147,0,20147,1000,1001,19.147,0.0
45022,695104,1000,9000,1000,12000,3000,2002,4.5,0.0
45023,6641,0,78,0,90,12,13,6.5,0.0
45027,169363,0,2232,0,2418,186,187,12.0,0.5
4503,370224,500,5963,500,6963,1000,501,11.926,0.0
45030,269609,1000,1000,1000,3000,2000,1001,1.0,0.0
45032,650778,0,8382,0,9221,839,840,9.99,0.0
45033,692334,1000,9000,1000,12000,3000,2002,4.5,0.0
45035,936683,1000,14671,1000,16671,2000,1001,14.671,0.0
45036,212476,0,3555,0,3972,417,418,8.525,0.0
45037,1450271,0,19775,0,20775,1000,1001,19.775,0.0
4504,333168,500,4869,500,5869,1000,501,9.738,0.0
45040,3732375,846,6768,846,8460,1692,847,8.0,0.0
45041,8562,0,165,0,176,11,12,15.0,0.0
45042,549711,0,11000,0,12000,1000,1001,11.0,0.0
45044,104485,0,1470,0,1680,210,211,7.0,0.0
45048,2000136,0,33699,0,34699,1000,1001,33.699,0.0
4505,1638635,500,27763,500,28763,1000,501,55.526,0.0
45052,217926,0,4020,0,4355,335,336,12.0,0.0
45059,164262,0,2124,0,2478,354,355,6.0,0.0
4506,49409,111,555,111,777,222,112,5.0,0.0
45062,3419,0,23,0,29,6,7,3.833,0.0
45063,222932,1,4274,1,4703,429,430,9.986,0.5
45065,77404,0,475,0,551,76,77,6.25,0.0
4507,39809,67,469,67,603,134,68,7.0,0.0
45070,80783,126,1008,126,1260,252,127,8.0,0.0
45072,34341,0,448,0,504,56,57,8.0,0.0
45076,47435,38,559,38,673,114,77,14.711,0.0
45077,39693,0,413,0,472,59,60,7.0,0.0
4508,7911,18,72,18,108,36,19,4.0,0.5
45080,987704,1000,13714,1000,15714,2000,1001,13.714,0.0
45081,158205,0,5124,0,5137,13,14,394.154,0.0
45082,33514,0,234,0,328,94,95,2.489,0.0
45084,29948,34,457,34,568,111,79,8.961,0.0
45085,10217,0,92,0,115,23,24,4.0,0.0
45088,87465,0,880,0,970,90,91,9.778,0.0
45089,22758,0,301,0,344,43,44,7.0,0.0
4509,46511,68,544,68,680,136,69,8.0,0.0
45090,7137,0,96,0,108,12,13,8.0,0.0
45091,6360,0,97,0,109,12,13,8.083,0.0
45092,1403,0,8,0,10,2,3,4.0,0.0
45094,90059,0,1054,0,1265,211,212,4.995,0.0
45095,26805,0,494,0,509,15,16,32.933,0.0
45096,20107,0,178,0,207,29,30,6.138,0.0
45097,71482,0,660,0,825,165,166,4.0,0.0
4510,1368928,500,38651,500,39651,1000,501,77.302,0.0
45101,191395,217,2682,217,3365,683,468,5.755,0.0
45105,78775,0,695,0,869,174,175,3.994,0.0
45108,6271,0,77,0,84,7,8,11.0,0.0
4511,263579,500,3000,500,4000,1000,501,6.0,0.0
45113,10296,0,112,0,126,14,15,8.0,0.0
45118,257537,0,3012,0,3514,502,503,6.0,0.0
4512,943,1,3,1,5,2,2,3.0,0.0
45120,1684,0,20,0,22,2,3,10.0,0.0
45123,998665,0,14378,0,15378,1000,1001,14.378,0.0
4513,1999,5,10,5,20,10,7,2.0,0.0
4514,8736,14,98,14,126,28,15,7.0,0.0
45147,2986,0,20,0,25,5,6,4.0,0.0
45148,5602,0,52,0,65,13,14,4.0,0.0
4515,4202,10,30,10,50,20,11,3.0,0.0
45151,3606,0,23,0,29,6,7,3.833,0.0
45152,175823,0,3370,0,3707,337,338,10.0,0.0
45158,6710,0,98,0,111,13,14,7.538,0.0
45162,9160,0,84,0,101,17,18,4.941,0.0
45163,6042,0,120,0,128,8,9,15.0,0.0
45166,13794,0,40,0,75,35,36,4.0,0.0
45167,6339,0,96,0,108,12,13,8.0,0.0
45168,10759,0,170,0,186,16,17,10.625,0.0
45169,9635,0,172,0,187,15,16,11.467,0.0
4517,322242,1000,4500,1000,6500,2000,1002,4.5,0.0
45170,3742,0,32,0,40,8,9,4.0,0.0
45171,21357,0,240,0,288,48,49,5.0,0.0
45172,6273,0,60,0,70,10,11,6.0,0.0
45174,8900,0,159,0,172,13,14,12.231,0.0
4518,455508,192,11904,192,12288,384,193,62.0,0.0
45180,10759,0,170,0,186,16,17,10.625,0.0
45181,8828,0,159,0,172,13,14,12.231,0.0
45182,53909,0,570,0,627,57,58,10.0,0.0
45184,1889,0,30,0,32,2,3,15.0,0.0
45185,6318,0,96,0,108,12,13,8.0,0.0
45186,3531,0,23,0,29,6,7,3.833,0.0
45187,2427,0,16,0,20,4,5,4.0,0.0
45188,10792,0,170,0,186,16,17,10.625,0.0
45189,40451,0,444,0,480,36,37,12.333,0.0
4519,635210,500,9000,500,10000,1000,501,18.0,0.0
45190,15541,0,141,0,179,38,39,3.711,0.0
45191,2921,0,27,0,31,4,5,6.75,0.0
45192,6310,0,96,0,108,12,13,8.0,0.0
45193,7767,0,75,0,90,15,16,5.0,1.0
45194,10759,0,170,0,186,16,17,10.625,0.0
45195,485378,0,5932,0,6932,1000,1001,5.932,0.0
45196,8985,0,92,0,104,12,13,7.667,0.0
45198,10492,0,169,0,184,15,16,11.267,0.0
45199,1799,0,12,0,15,3,4,4.0,0.0
4520,284039,500,4000,500,5000,1000,501,8.0,0.0
45200,1738,0,12,0,15,3,4,4.0,0.0
45201,10759,0,170,0,186,16,17,10.625,0.0
45202,10792,0,170,0,186,16,17,10.625,0.0
45203,68577,0,680,0,765,85,86,8.0,0.0
45204,11106,0,172,0,189,17,18,10.118,0.0
45205,15151,0,131,0,170,39,40,3.359,0.0
45206,6186,0,56,0,70,14,15,4.0,0.0
45208,55242,0,508,0,593,85,86,5.976,0.0
4521,19886,24,408,24,456,48,25,17.0,0.0
45215,10792,0,170,0,186,16,17,10.625,0.0
45219,40997,0,432,0,468,36,37,12.0,0.0
4522,260702,500,3000,500,4000,1000,501,6.0,0.0
45224,487838,0,5853,0,6853,1000,1001,5.853,0.0
45227,800762,1000,9875,1000,11875,2000,1001,9.875,0.0
4523,341253,500,5500,500,6500,1000,501,11.0,0.0
4524,656868,500,9500,500,10500,1000,501,19.0,0.0
45240,742656,1000,10000,1000,12000,2000,1001,10.0,0.0
45243,911306,1000,17841,1000,19841,2000,1001,17.841,0.0
4525,192477,270,2700,270,3240,540,271,10.0,0.0
45255,31816,44,568,44,656,88,45,12.909,0.0
4526,372141,500,5500,500,6500,1000,501,11.0,0.0
45266,107832,293,1142,293,1728,586,294,3.898,0.0
4527,17759,25,350,25,400,50,26,14.0,0.0
4528,127698,180,2340,180,2700,360,181,13.0,0.0
4529,21931,25,425,25,475,50,26,17.0,0.0
4530,448832,192,11904,192,12288,384,193,62.0,0.0
4531,482252,500,8000,500,9000,1000,501,16.0,0.0
45313,10633,25,149,25,199,50,26,5.96,0.0
4532,448832,192,11904,192,12288,384,193,62.0,0.0
45324,20140,24,168,24,216,48,25,7.0,0.0
4533,379995,500,6000,500,7000,1000,501,12.0,0.0
4534,637971,0,9500,0,10000,500,501,19.0,0.0
45342,92125,144,1364,144,1652,288,145,9.472,0.0
45345,95849,144,2016,144,2304,288,145,14.0,0.5
45347,46782,144,576,144,864,288,145,4.0,0.0
45348,130503,144,2562,144,2850,288,145,17.792,0.0
4535,495330,192,11904,192,12288,384,193,62.0,0.0
45352,930997,1000,17759,1000,19759,2000,1001,17.759,0.0
45357,200445,423,2621,423,3467,846,425,6.196,0.0
4536,20244,24,408,24,456,48,25,17.0,0.0
45361,862035,812,14528,812,16152,1624,813,17.892,0.5
45363,580739,1000,8000,1000,10000,2000,1001,8.0,0.0
45364,53851,0,696,0,812,116,117,6.0,0.0
45365,1672708,1000,32835,1000,34835,2000,1001,32.835,0.0
45366,1486197,1000,24738,1000,26738,2000,1001,24.738,0.5
45367,1269305,1000,17980,1000,19980,2000,1001,17.98,0.0
45369,1952909,1000,30217,1000,32217,2000,1001,30.217,0.0
4537,657275,275,17050,275,17600,550,276,62.0,0.0
45375,477589,1000,5000,1000,7000,2000,1001,5.0,0.0
45376,478382,1000,5000,1000,7000,2000,1001,5.0,0.0
45377,477737,1000,5000,1000,7000,2000,1001,5.0,0.0
4538,444761,500,6500,500,7500,1000,501,13.0,0.0
45380,160616,65,1629,65,1844,215,145,25.062,0.0
45388,538243,1000,7000,1000,9000,2000,1001,7.0,0.0
45390,1007866,1000,15376,1000,17376,2000,1001,15.376,0.5
45392,554932,1000,9167,1000,11167,2000,1001,9.167,0.0
4540,1212276,909,9454,909,11272,1818,911,10.4,0.0
45400,838295,1000,9000,1000,11000,2000,1001,9.0,0.0
45401,303515,543,4344,543,5430,1086,544,8.0,1.0
45402,39053,57,512,57,626,114,58,8.982,0.0
45403,502623,1000,8000,1000,10000,2000,1001,8.0,0.0
45405,83371,125,1125,125,1375,250,126,9.0,0.0
45407,764622,1000,13848,1000,15848,2000,1001,13.848,0.0
4541,948105,909,11954,909,13772,1818,911,13.151,0.0
45411,571538,1000,11000,1000,13000,2000,1001,11.0,0.0
45412,52612,127,762,127,1016,254,128,6.0,0.0
45413,423837,0,4373,0,4951,578,579,7.566,0.0
45418,838193,1000,9000,1000,11000,2000,1001,9.0,0.0
45420,50314,115,805,115,1035,230,116,7.0,0.0
45421,10386,18,147,18,183,36,19,8.167,0.0
45423,63295,149,596,149,894,298,150,4.0,0.0
45424,476815,1000,5000,1000,7000,2000,1001,5.0,0.0
45425,63551,148,592,148,888,296,149,4.0,0.0
45426,157885,5,85,5,95,10,6,17.0,0.5
45429,512008,1000,6000,1000,8000,2000,1001,6.0,0.0
45431,421535,576,4341,576,5493,1152,577,7.536,0.0
45434,585155,1000,7000,1000,9000,2000,1001,7.0,0.0
45435,579585,1000,7000,1000,9000,2000,1001,7.0,0.0
4544,3732760,500,75273,500,76273,1000,501,150.546,0.0
45441,58913,51,753,51,855,102,52,14.765,0.0
45442,566615,787,6918,787,8492,1574,788,8.79,0.0
45443,233134,483,2898,483,3864,966,484,6.0,0.0
45444,260401,116,5425,116,5657,232,117,46.767,0.0
45447,41304,50,750,50,850,100,52,15.0,0.0
45448,52910,21,345,21,387,42,22,16.429,0.875
45449,61437,59,836,59,954,118,60,14.169,0.0
4545,430874,500,7500,500,8500,1000,502,15.0,0.5
45451,66751,157,628,157,942,314,158,4.0,0.0
45452,32162,27,417,27,471,54,28,15.444,0.5
45454,66680,157,628,157,942,314,158,4.0,0.0
45457,1488704,1000,24698,1000,26698,2000,1001,24.698,0.0
45458,499935,1000,6000,1000,8000,2000,1001,6.0,0.5
45459,5407,7,63,7,77,14,8,9.0,0.0
4546,392855,500,8000,500,9000,1000,501,16.0,0.5
45460,66679,157,628,157,942,314,158,4.0,0.0
45462,476812,1000,5000,1000,7000,2000,1001,5.0,0.0
45463,1867230,961,28991,961,30913,1922,962,30.168,0.0
45464,584046,1000,7000,1000,9000,2000,1001,7.0,0.0
45465,2009,3,13,3,22,9,7,4.333,0.0
45466,67309,157,628,157,942,314,158,4.0,0.0
45467,66680,157,628,157,942,314,158,4.0,0.0
45468,1063229,1000,16390,1000,18390,2000,1001,16.39,0.0
45469,476812,1000,5000,1000,7000,2000,1001,5.0,0.0
4547,804227,0,13885,0,14385,500,501,27.77,0.0
45470,476812,1000,5000,1000,7000,2000,1001,5.0,0.0
45471,581141,1000,7000,1000,9000,2000,1001,7.0,0.0
45472,585287,1000,7000,1000,9000,2000,1001,7.0,0.0
45473,499018,1000,6000,1000,8000,2000,1001,6.0,0.0
45474,579781,1000,7000,1000,9000,2000,1001,7.0,0.0
45475,584181,1000,7000,1000,9000,2000,1001,7.0,0.0
45476,499515,1000,6000,1000,8000,2000,1001,6.0,0.0
45477,586159,1000,7000,1000,9000,2000,1001,7.0,0.0
45478,136170,577,577,577,1731,1154,578,1.0,0.0
45479,45110,115,575,115,805,230,116,5.0,0.0
4548,830802,0,13883,0,14383,500,501,27.766,0.5
45480,500209,1000,6000,1000,8000,2000,1001,6.0,0.0
45481,581300,1000,7000,1000,9000,2000,1001,7.0,0.0
45483,503678,1000,6000,1000,8000,2000,1001,6.0,0.0
45486,499520,1000,6000,1000,8000,2000,1001,6.0,0.0
45488,583475,1000,7000,1000,9000,2000,1001,7.0,0.0
45489,582613,1000,7000,1000,9000,2000,1001,7.0,0.0
45490,581179,1000,7000,1000,9000,2000,1001,7.0,0.0
45491,584921,1000,7000,1000,9000,2000,1001,7.0,0.0
45492,583208,1000,7000,1000,9000,2000,1001,7.0,0.0
45493,582332,1000,7000,1000,9000,2000,1001,7.0,0.0
45495,504416,1000,6000,1000,8000,2000,1001,6.0,0.0
45498,500803,1000,6000,1000,8000,2000,1001,6.0,0.0
45499,581759,1000,7000,1000,9000,2000,1001,7.0,0.0
45500,499507,1000,6000,1000,8000,2000,1001,6.0,0.0
45501,503922,1000,6000,1000,8000,2000,1001,6.0,0.0
45503,581838,1000,7000,1000,9000,2000,1001,7.0,0.0
45505,508171,1000,6000,1000,8000,2000,1001,6.0,0.0
45506,593463,1000,7000,1000,9000,2000,1001,7.0,0.0
45516,260183,5,150,5,160,10,6,30.0,0.0
45517,2190970,2,34,2,38,4,3,17.0,0.0
45518,733755,268,5136,268,5672,536,269,19.164,0.0
45519,5522,0,48,0,56,8,9,6.0,0.0
4552,295059,500,5000,500,6000,1000,501,10.0,0.0
4553,73032,114,1140,114,1368,228,115,10.0,0.0
45530,2170416,1000,37753,1000,39753,2000,1001,37.753,1.0
45533,5264890,1000,59227,1000,62227,3000,2001,59.227,0.0
45534,916937,1000,12980,1000,14980,2000,1001,12.98,0.5
45538,1314535,1000,22999,1000,24999,2000,1001,22.999,0.0
45539,241581,1000,1000,1000,3000,2000,1001,1.0,0.0
4554,297717,500,5000,500,6000,1000,501,10.0,0.0
45540,241581,1000,1000,1000,3000,2000,1001,1.0,0.0
45544,590602,1000,8000,1000,10000,2000,1001,8.0,0.0
4555,552914,0,6998,0,7498,500,501,13.996,0.0
45550,874889,1000,14825,1000,16825,2000,1001,14.825,0.0
45551,1662812,2000,28953,2000,32953,4000,2002,14.476,0.0
45552,846600,1000,11994,1000,13994,2000,1001,11.994,0.0
45554,55693,0,538,0,678,140,141,7.686,0.0
45559,833767,962,13187,962,15111,1924,964,13.708,0.0
4556,479492,500,9500,500,10500,1000,502,19.0,0.0
45560,1387174,1000,13286,1000,15286,2000,1001,13.286,0.0
45562,2206900,1000,65000,1000,67000,2000,1001,65.0,0.0
45563,1393745,1000,23000,1000,25000,2000,1001,23.0,0.0
45568,595952,1000,9863,1000,11863,2000,1001,9.863,0.0
4557,1022674,0,16973,0,17473,500,501,33.946,1.0
45570,570688,890,9748,890,11528,1780,892,10.953,0.0
45571,1514556,1160,23859,1160,26560,2701,1531,20.568,0.0
45574,12616,29,116,29,174,58,30,4.0,0.0
45576,1282758,1416,21496,1416,24328,2832,1418,15.181,0.0
45577,575158,1000,6971,1000,8971,2000,1001,6.971,0.0
45581,903336,1000,12999,1000,14999,2000,1001,12.999,0.0
45582,4017382,1000,43729,1000,45729,2000,1001,43.729,0.0
45583,1132313,1997,18967,1997,22961,3994,1999,9.498,0.0
45584,1080183,2000,16894,2000,20894,4000,2002,8.447,0.5
45585,1726485,1000,16698,1000,19288,2590,1591,16.698,1.0
45589,458040,1000,6000,1000,8000,2000,1001,6.0,0.0
4559,12326,0,111,0,149,38,39,5.842,0.0
45590,210544,217,2231,217,2665,434,218,10.281,0.8
45592,285582,1000,2000,1000,4000,2000,1001,2.0,0.0
45595,678740,759,9096,759,10614,1518,760,11.984,0.0
45596,241581,1000,1000,1000,3000,2000,1001,1.0,0.0
4560,327981,500,4500,500,5500,1000,502,9.0,0.0
45601,43961,180,180,180,540,360,181,1.0,0.0
45605,844713,1000,13000,1000,15000,2000,1001,13.0,0.0
4561,455892,500,6500,500,7500,1000,502,13.0,0.0
45610,239581,0,1000,0,2000,1000,1001,1.0,0.0
45613,1400608,1558,25428,1558,28544,3116,1560,16.321,0.0
45614,1737177,2000,26637,2000,30637,4000,2002,13.319,0.0
4562,76291,0,700,0,980,280,281,5.0,0.0
45620,938,1,3,1,5,2,2,3.0,0.0
45621,932357,1000,13603,1000,15603,2000,1001,13.603,0.0
4563,495322,0,7000,0,7500,500,501,14.0,0.0
45634,2126248,1000,32334,1000,34334,2000,1001,32.334,0.0
4564,43267,68,404,68,608,204,137,5.941,0.0
45640,137771,0,1442,0,1730,288,269,10.014,0.0
45641,18406,52,156,52,260,104,53,3.0,0.5
45642,1716168,2000,28094,2000,32094,4000,2002,14.047,0.0
45643,995506,578,15569,578,16725,1156,579,26.936,0.5
45644,1354048,1082,24071,1082,26773,2702,1607,22.247,0.0
45645,20512,56,224,56,336,112,57,4.0,0.0
45646,23498,35,314,35,384,70,36,8.971,0.0
45647,975813,2000,19000,2000,23000,4000,2002,9.5,0.0
45648,602404,180,6113,180,6473,360,181,33.961,0.0
45649,1152026,714,17007,714,18435,1428,715,23.819,0.0
4565,290884,380,4133,380,4893,760,382,10.876,0.0
45651,36776,53,477,53,583,106,54,9.0,0.0
45652,1415977,2000,18982,2000,22982,4000,2002,9.491,0.0
45653,1386978,2000,19929,2000,23929,4000,2002,9.964,0.0
45656,3660,8,32,8,48,16,9,4.0,0.0
45657,2761474,1000,72984,1000,74984,2000,1001,72.984,0.0
45658,736690,982,13840,982,15804,1964,983,14.094,0.0
45659,387284,1000,3979,1000,5979,2000,1001,3.979,0.0
4566,75205,86,344,86,768,424,334,4.0,0.0
45660,1284898,1000,19396,1000,21396,2000,1001,19.396,0.0
45662,656568,1000,9676,1000,11676,2000,1001,9.676,0.0
45664,1188379,2000,16663,2000,20663,4000,2002,8.332,0.0
45665,7137,9,90,9,108,18,10,10.0,0.0
45666,1403,1,11,1,13,2,2,11.0,0.5
45668,454885,1000,6000,1000,8000,2000,1001,6.0,0.0
45669,1512865,2000,20780,2000,24780,4000,2002,10.39,0.0
4567,297633,500,3979,500,4979,1000,501,7.958,0.0
45679,48964,111,555,111,777,222,112,5.0,0.0
45680,966563,1000,15998,1000,17998,2000,1001,15.998,0.0
45684,571574,1000,6000,1000,8000,2000,1001,6.0,0.0
45685,69159,79,814,79,972,158,80,10.304,0.0
45686,4739,9,43,9,61,18,10,4.778,0.0
4569,484570,500,9500,500,10500,1000,502,19.0,0.0
45690,1405047,2000,19997,2000,24180,4183,2185,9.998,0.0
45691,479250,463,5487,463,6413,926,464,11.851,0.5
45694,412612,1000,5261,1000,7261,2000,1001,5.261,0.0
4570,493866,0,7143,0,7643,500,501,14.286,0.5
45700,65460,156,913,156,1225,312,158,5.853,0.5
45701,767002,588,15466,588,16642,1176,589,26.303,0.0
45706,56841,20,233,20,273,40,21,11.65,0.0
45707,1742805,1000,30045,1000,32045,2000,1001,30.045,0.0
4571,440620,500,6000,500,7000,1000,501,12.0,0.0
45710,590905,1000,8000,1000,10000,2000,1001,8.0,0.0
45711,1650382,1480,28772,1480,31732,2960,1482,19.441,0.0
45712,562563,139,1628,139,1906,278,140,11.712,0.0
45713,1200581,2000,16777,2000,20777,4000,2002,8.389,0.0
45715,5789,12,60,12,84,24,13,5.0,0.0
45717,2205057,2000,48512,2000,52512,4000,2002,24.256,0.0
45718,322245,1000,3000,1000,5000,2000,1001,3.0,0.0
45720,797025,1000,7165,1000,9374,2209,1210,7.165,0.0
45724,790405,1501,11818,1501,14820,3002,1503,7.873,0.0
45726,1735702,2000,30645,2000,34645,4000,2002,15.322,0.0
45728,1191455,2000,20010,2000,24024,4014,2009,10.005,0.0
45735,444170,1000,4000,1000,6000,2000,1001,4.0,0.0
45737,123244,151,1630,151,1932,302,152,10.795,0.0
45739,39809,67,469,67,603,134,68,7.0,0.0
4574,340989,500,5465,500,6465,1000,502,10.93,0.0
45744,447299,1000,5997,1000,7997,2000,1001,5.997,0.0
45746,1188543,1000,14229,1000,16229,2000,1001,14.229,0.0
45748,1267901,1000,18339,1000,20339,2000,1001,18.339,0.0
45749,1550776,998,28449,998,31445,2996,2000,14.239,0.0
4575,79344,86,1045,86,1217,172,88,12.151,0.0
45752,1218943,1000,25644,1000,27644,2000,1001,25.644,0.0
45753,13519,1,10,1,12,2,2,10.0,0.0
45755,2236613,1000,59137,1000,61137,2000,1001,59.137,0.0
45756,203356,147,2531,147,2825,294,148,17.218,0.0
45759,1264842,2000,20270,2000,24270,4000,2002,10.135,0.0
45760,1463441,2000,19974,2000,24675,4701,2703,9.987,0.5
45762,911792,1756,13953,1756,17465,3512,1758,7.946,0.0
45769,5090,12,48,12,72,24,13,4.0,0.0
4577,318899,500,4616,500,5616,1000,501,9.232,0.0
45770,85442,192,1344,192,1728,384,193,7.0,0.0
45773,1397851,2000,20865,2000,25865,5000,3002,10.432,0.0
45778,5953,13,52,13,78,26,14,4.0,0.0
4578,695882,500,8027,500,9027,1000,501,16.054,0.5
45781,750614,46,322,46,414,92,47,7.0,0.0
45785,1161222,1998,17810,1998,21806,3996,2000,8.914,0.0
45786,1217269,1989,21072,1989,25050,3978,1991,10.594,0.0
45787,4156907,1000,105970,1000,107970,2000,1001,105.97,0.0
4579,312399,0,3839,0,4322,483,484,7.948,0.0
45790,2738763,1000,77383,1000,79383,2000,1001,77.383,0.0
45791,21652,86,86,86,258,172,87,1.0,0.0
45792,767614,1000,10000,1000,12000,2000,1001,10.0,0.0
45794,150129,273,1365,273,1911,546,274,5.0,0.0
45795,1470512,2000,22737,2000,26737,4000,2002,11.368,0.0
45796,241581,1000,1000,1000,3000,2000,1001,1.0,0.0
4580,347690,500,5000,500,6000,1000,501,10.0,0.0
45802,662448,1000,9767,1000,11767,2000,1001,9.767,0.0
45804,2326619,1000,24397,1000,27397,3000,2001,24.397,0.0
45805,241581,1000,1000,1000,3000,2000,1001,1.0,0.0
45811,722328,1000,9983,1000,11983,2000,1001,9.983,0.0
45813,49485,109,545,109,763,218,110,5.0,0.0
45814,460026,702,6318,702,7722,1404,704,9.0,0.0
45817,6633,20,70,20,110,40,22,3.5,0.0
45818,947463,1000,14285,1000,16285,2000,1001,14.285,0.0
45819,1338,2,8,2,12,4,3,4.0,0.0
4582,520830,500,7393,500,8393,1000,501,14.786,0.0
45820,1344293,2000,24753,2000,28753,4000,2002,12.377,0.0
45824,14306,38,114,38,190,76,39,3.0,0.0
45825,32879,66,330,66,462,132,67,5.0,0.0
45830,158455,229,1877,229,2335,458,230,8.197,1.0
45831,58421,240,240,240,720,480,241,1.0,0.0
45833,5081,12,48,12,72,24,13,4.0,0.0
45838,1397536,2000,20037,2000,24037,4000,2002,10.018,0.0
45840,38750,105,315,105,525,210,106,3.0,0.0
45841,199680,229,2519,229,2977,458,230,11.0,0.0
45842,559572,1000,6000,1000,8000,2000,1001,6.0,0.0
45845,8736,14,98,14,126,28,15,7.0,0.0
45849,46695,114,512,114,740,228,115,4.491,0.0
4585,1117869,500,21000,500,22000,1000,501,42.0,0.0
45858,375996,1000,4000,1000,6000,2000,1001,4.0,0.0
4586,286039,500,5500,500,6500,1000,501,11.0,0.0
45862,1305751,1000,17658,1000,19658,2000,1001,17.658,0.0
45864,9103,19,75,19,113,38,20,3.947,0.0
45867,575548,1000,8491,1000,10491,2000,1001,8.491,0.0
45868,214048,0,2597,0,2934,337,317,12.136,0.0
45869,888719,1000,14783,1000,16783,2000,1001,14.783,0.0
4587,58913,51,753,51,855,102,52,14.765,0.0
45870,245582,1000,1000,1000,3000,2000,1001,1.0,0.0
45874,525831,1000,7068,1000,9068,2000,1001,7.068,0.0
45877,227929,369,2952,369,3690,738,370,8.0,0.0
45880,382611,395,6176,395,7362,1186,793,7.808,0.0
45881,376245,1000,4000,1000,6000,2000,1001,4.0,0.0
45882,241581,1000,1000,1000,3000,2000,1001,1.0,0.0
45883,84882,90,810,90,1080,270,181,9.0,0.0
45884,588758,1000,8000,1000,10000,2000,1001,8.0,0.0
45886,383403,791,6176,791,7758,1582,793,7.808,0.0
45889,894123,1000,22943,1000,24943,2000,1001,22.943,0.0
4589,907164,500,14691,500,15691,1000,501,29.382,0.5
45890,63876,65,635,65,765,130,66,9.769,0.5
45891,38750,105,315,105,525,210,106,3.0,0.0
45892,6633,20,70,20,110,40,22,3.5,0.0
45893,1420174,1000,28048,1000,30048,2000,1001,28.048,0.0
45896,127252,175,1925,175,2275,350,176,11.0,0.0
45897,30165,58,290,58,406,116,59,5.0,0.0
45905,241581,1000,1000,1000,3000,2000,1001,1.0,0.0
45907,245582,1000,1000,1000,3000,2000,1001,1.0,0.0
4591,144992,236,2174,236,2646,472,237,9.212,0.0
45910,10151,23,92,23,138,46,24,4.0,0.0
45912,3145670,1000,7931,1000,9931,2000,1001,7.931,0.0
45913,1592,2,8,2,12,4,3,4.0,0.0
45914,387608,550,5500,550,6600,1100,552,10.0,0.0
45917,142682,580,580,580,1740,1160,581,1.0,0.0
4592,191766,215,3432,215,3862,430,216,15.963,0.0
45920,24156,53,159,53,265,106,54,3.0,0.0
45923,253113,175,3325,175,3675,350,176,19.0,0.0
45924,2727819,1000,76994,1000,78994,2000,1001,76.994,0.0
45927,241581,1000,1000,1000,3000,2000,1001,1.0,0.0
4593,712630,500,12992,500,13992,1000,501,25.984,0.0
45931,20149,39,195,39,273,78,40,5.0,0.0
45933,4202,10,30,10,50,20,11,3.0,0.0
45935,349452,662,3972,662,5296,1324,663,6.0,0.0
45939,748585,725,10875,725,12325,1450,726,15.0,0.0
4594,3903722,1975,34356,1975,40402,6046,4073,17.395,0.5
45940,241581,1000,1000,1000,3000,2000,1001,1.0,0.0
45942,808665,1000,13661,1000,15661,2000,1001,13.661,0.0
45943,55918,86,688,86,860,172,87,8.0,0.0
45944,1673,3,9,3,15,6,4,3.0,0.0
45945,144087,144,1585,144,2017,432,269,11.007,0.0
45947,6090,16,48,16,80,32,17,3.0,0.0
4595,742829,500,12361,500,13361,1000,501,24.722,0.5
45951,798492,1000,14065,1000,16065,2000,1001,14.065,0.0
45954,943,1,3,1,5,2,2,3.0,0.0
4596,499999,500,7695,500,8695,1000,501,15.39,0.5
45983,53769,52,676,52,780,104,53,13.0,1.0
45986,954239,1000,13565,1000,15565,2000,1001,13.565,0.0
45987,1880818,841,62236,841,63918,1682,842,74.002,0.0
45988,1901858,1000,37824,1000,39824,2000,1001,37.824,0.0
45989,199680,229,2519,229,2977,458,230,11.0,0.0
45990,2740,5,20,5,30,10,6,4.0,0.0
45993,1118064,1000,19211,1000,21211,2000,1001,19.211,0.5
45994,49409,111,555,111,777,222,112,5.0,0.0
45998,42756,175,175,175,525,350,176,1.0,0.0
45999,70799,172,671,172,1015,344,173,3.901,0.0
4600,61437,59,836,59,954,118,60,14.169,0.0
46000,8112,17,81,17,115,34,18,4.765,0.0
46001,19692,78,78,78,234,156,79,1.0,0.0
46004,14325,34,136,34,204,68,35,4.0,0.0
46006,279770,536,3752,536,4824,1072,537,7.0,0.0
46007,301938,264,2915,264,3707,792,529,11.042,0.0
46008,241581,1000,1000,1000,3000,2000,1001,1.0,0.0
46009,34554,58,406,58,522,116,59,7.0,0.0
4601,103567,0,1350,0,1485,135,136,10.0,0.8
46010,573868,1000,6000,1000,8000,2000,1001,6.0,0.0
46011,3628,0,27,0,36,9,10,3.0,0.0
46013,397534,821,4105,821,5747,1642,822,5.0,0.0
46014,80881,79,893,79,1051,158,80,11.304,0.0
46016,352513,227,2845,227,3526,681,455,12.533,0.0
46020,112164,463,463,463,1389,926,464,1.0,0.0
46021,448700,1000,4976,1000,6976,2000,1001,4.976,0.0
46022,1636115,1000,30323,1000,32323,2000,1001,30.323,0.0
46023,63710,178,533,178,889,356,179,2.994,0.5
46024,805538,1000,15472,1000,17472,2000,1001,15.472,0.0
46025,306334,276,3091,276,3643,552,277,11.199,0.0
46026,11792,28,112,28,168,56,29,4.0,0.0
46029,1856,3,12,3,18,6,4,4.0,0.0
4603,20806,23,220,23,266,46,24,9.565,0.0
46033,3071820,1000,7931,1000,9931,2000,1001,7.931,0.0
46035,412445,103,411,103,617,206,104,3.99,0.0
46038,107068,339,1017,339,1695,678,340,3.0,0.0
4604,144992,236,2174,236,2646,472,237,9.212,0.0
46044,63710,178,533,178,889,356,179,2.994,0.5
46046,1371645,1806,18298,1806,22243,3945,2141,10.132,0.0
46047,1662565,2000,23970,2000,28467,4497,2499,11.985,0.0
46048,60341,125,625,125,875,250,126,5.0,0.0
46049,241581,1000,1000,1000,3000,2000,1001,1.0,0.0
4605,109083,133,842,133,1170,328,144,6.331,0.0
46051,3646,9,27,9,45,18,10,3.0,0.0
46057,1646372,2000,23997,2000,28379,4382,2384,11.998,0.0
46061,463473,1000,5746,1000,7746,2000,1001,5.746,0.0
46066,546691,704,11244,704,12652,1408,705,15.972,0.0
4607,5047,14,42,14,70,28,15,3.0,0.0
4608,397068,500,4225,500,5725,1500,546,8.45,0.0
4609,144992,236,2174,236,2646,472,237,9.212,0.0
46090,8736,14,98,14,126,28,15,7.0,0.0
46094,19731,47,188,47,282,94,48,4.0,0.0
46095,2396179,1000,68353,1000,70353,2000,1001,68.353,0.0
4610,361399,500,5000,500,6000,1000,501,10.0,0.0
46100,1718,3,12,3,18,6,4,4.0,0.0
46101,29932,58,290,58,406,116,59,5.0,0.0
46105,1626962,2000,23932,2000,28236,4304,2306,11.966,0.0
46106,29260,119,119,119,357,238,120,1.0,0.0
4611,352098,500,5000,500,6000,1000,501,10.0,0.0
4612,285692,500,3406,500,4406,1000,501,6.812,0.0
4613,308326,0,4500,0,5000,500,501,9.0,0.5
4614,322109,500,5500,500,6500,1000,501,11.0,0.0
4615,245261,500,3707,500,4707,1000,501,7.414,0.0
4616,421151,500,6500,500,7500,1000,502,13.0,0.0
4617,186459,136,2746,136,3018,272,137,20.191,0.0
4619,750614,46,322,46,414,92,47,7.0,0.0
4622,371710,500,5497,500,6497,1000,501,10.994,0.0
4623,363132,290,2131,290,2711,580,292,7.348,0.0
46239,10151,23,92,23,138,46,24,4.0,0.0
4624,30528,0,276,0,345,69,70,4.0,0.0
46241,228034,19,95,19,133,38,20,5.0,0.0
46244,944,1,3,1,5,2,2,3.0,0.0
46247,24814,51,255,51,357,102,52,5.0,0.0
46248,35285,144,144,144,432,288,145,1.0,0.0
46249,810463,1000,4031,1000,6031,2000,1001,4.031,0.0
4625,7214445,0,92024,0,92524,500,501,184.048,0.5
46250,19287,29,232,29,290,58,30,8.0,0.0
46252,4266,6,30,6,42,12,7,5.0,0.0
46253,2391,2,29,2,33,4,3,14.5,0.0
46254,119349,139,1899,139,2177,278,140,13.662,0.0
46258,1538404,27,351,27,405,54,28,13.0,0.0
46259,245582,1000,1000,1000,3000,2000,1001,1.0,0.0
4626,27482,0,466,0,513,47,48,9.915,0.0
46261,5873,4,12,4,20,8,5,3.0,0.0
46262,245582,1000,1000,1000,3000,2000,1001,1.0,0.0
46263,113061,9,72,9,90,18,10,8.0,0.0
46265,49192,56,774,56,886,112,57,13.821,0.5
46266,134004,151,1782,151,2084,302,152,11.801,0.0
46268,1489019,71,331,71,473,142,72,4.662,0.75
4627,202875,500,2500,500,3500,1000,501,5.0,0.5
46270,32879,66,330,66,462,132,67,5.0,0.0
46271,2152102,1000,40240,1000,42240,2000,1001,40.24,0.0
46272,1319368,1000,18316,1000,20316,2000,1001,18.316,0.5
46273,5230,11,44,11,66,22,12,4.0,0.0
46274,18656,75,75,75,225,150,76,1.0,0.0
46275,91932,10,39,10,59,20,11,3.9,1.0
46276,22949,27,189,27,243,54,28,7.0,0.0
46277,212051,214,2636,214,3064,428,215,12.318,0.0
46278,9543,20,100,20,140,40,21,5.0,0.0
46279,1461,2,8,2,12,4,3,4.0,0.0
4628,280357,202,2424,202,2828,404,203,12.0,0.0
46280,485052,536,6879,536,7951,1072,537,12.834,0.0
46286,1201380,147,1028,147,1322,294,148,6.993,0.0
4629,290785,0,3999,0,4499,500,501,7.998,0.0
46293,88619,3,27,3,33,6,4,9.0,0.0
46294,8577,16,80,16,112,32,17,5.0,0.0
46299,3123,3,42,3,48,6,4,14.0,0.0
4630,3180180,0,37080,0,37299,219,220,169.315,0.5
46301,241581,1000,1000,1000,3000,2000,1001,1.0,0.0
46303,1726587,1000,26978,1000,28978,2000,1001,26.978,0.0
46305,1964536,1000,35922,1000,37922,2000,1001,35.922,0.0
46306,241581,1000,1000,1000,3000,2000,1001,1.0,0.0
4631,91490,0,752,0,903,151,152,4.98,0.0
46315,27332,111,111,111,333,222,112,1.0,0.0
46317,588896,505,5594,505,6604,1010,506,11.077,0.0
4632,529895,0,6500,0,7000,500,501,13.0,0.0
46320,2811,5,20,5,30,10,6,4.0,0.0
46321,11667,46,46,46,138,92,47,1.0,0.0
46324,1325,2,8,2,12,4,3,4.0,0.0
46326,5482,20,20,20,60,40,21,1.0,0.0
4633,260482,0,3360,0,3860,500,501,6.72,0.0
46336,1410128,0,19950,0,21591,1641,1642,19.95,0.0
46337,7254,8,108,8,124,16,9,13.5,0.0
46339,3232,11,11,11,33,22,12,1.0,0.0
4634,219608,500,3500,500,4500,1000,501,7.0,0.0
46340,20149,39,195,39,273,78,40,5.0,0.0
46341,1363795,1000,23000,1000,25000,2000,1001,23.0,0.0
46344,837224,511,13189,511,14211,1022,512,25.81,0.0
46345,59137,239,239,239,717,478,240,1.0,0.5
46349,24847,29,398,29,456,58,30,13.724,0.0
4635,78391,0,1002,0,1137,135,134,14.735,0.0
46351,323616,472,4711,472,5655,944,473,9.981,0.0
46352,241581,1000,1000,1000,3000,2000,1001,1.0,0.0
46353,267330,17,68,17,102,34,18,4.0,0.0
46354,2502,2,29,2,33,4,3,14.5,0.0
46356,245582,1000,1000,1000,3000,2000,1001,1.0,0.0
46358,1765,1,15,1,17,2,2,15.0,0.0
46359,6448,14,56,14,84,28,15,4.0,0.0
4636,106492,0,1639,0,1788,149,150,11.0,0.0
46361,1545,4,4,4,12,8,5,1.0,0.0
46362,24006,31,370,31,432,62,32,11.935,0.0
46363,1760,1,8,1,10,2,2,8.0,0.0
46366,1626,2,8,2,12,4,3,4.0,0.0
46369,4853,10,40,10,60,20,11,4.0,0.0
4637,356939,0,4997,0,5497,500,501,9.994,0.0
46370,3220,3,41,3,47,6,4,13.667,0.0
46373,241581,1000,1000,1000,3000,2000,1001,1.0,0.0
46374,1415,1,14,1,16,2,2,14.0,0.0
46375,2440,2,29,2,33,4,3,14.5,0.0
46379,1670,1,15,1,17,2,2,15.0,0.0
4638,1137052,500,10243,500,11243,1000,501,20.486,0.0
46382,4032,4,55,4,63,8,5,13.75,0.0
46385,1695030,2000,23931,2000,28367,4436,2438,11.966,0.0
46387,13354,53,53,53,159,106,54,1.0,0.0
4639,51459,0,498,0,581,83,84,6.0,0.0
46390,1464,1,14,1,16,2,2,14.0,0.0
46393,10228,11,151,11,173,22,12,13.727,0.0
46394,245582,1000,1000,1000,3000,2000,1001,1.0,0.0
46395,56565,87,696,87,870,174,88,8.0,0.0
46397,18126,20,276,20,316,40,21,13.8,0.0
46398,109325,159,954,159,1431,477,319,6.0,0.0
46399,1610,1,15,1,17,2,2,15.0,0.0
4640,539913,0,6500,0,7000,500,501,13.0,0.0
46401,124307,505,505,505,1515,1010,506,1.0,0.0
46403,3626,3,44,3,50,6,4,14.667,0.0
46404,574917,546,17505,546,18597,1092,547,32.06,0.0
46405,1831,2,10,2,16,6,5,5.0,0.5
46406,2475,2,29,2,33,4,3,14.5,0.0
46407,3925,4,56,4,64,8,5,14.0,0.0
46408,1760,1,15,1,17,2,2,15.0,0.0
46409,26609,108,108,108,324,216,109,1.0,0.0
4641,347727,0,5974,0,6474,500,501,11.948,0.0
46410,58180,239,239,239,717,478,240,1.0,0.0
46411,1552,1,15,1,17,2,2,15.0,0.0
46412,241581,1000,1000,1000,3000,2000,1001,1.0,0.0
46413,2475,2,29,2,33,4,3,14.5,0.0
46416,1421,1,14,1,16,2,2,14.0,0.0
46417,11360,10,120,10,150,30,21,12.0,0.0
46419,2589,2,29,2,33,4,3,14.5,0.0
4642,166140,396,1980,396,2772,792,397,5.0,0.0
46420,4812,10,40,10,60,20,11,4.0,0.0
46421,1464,1,14,1,16,2,2,14.0,0.0
46422,1491,1,14,1,16,2,2,14.0,0.0
46423,3352,3,42,3,48,6,4,14.0,0.0
46425,2415,2,29,2,33,4,3,14.5,0.0
46426,1433,1,14,1,16,2,2,14.0,0.0
46427,1700495,2000,24900,2000,29422,4522,2524,12.45,0.0
46428,3121,3,41,3,47,6,4,13.667,0.0
46429,2991,10,10,10,30,20,11,1.0,0.0
4643,147689,0,1820,0,1993,173,174,10.52,0.0
46430,999,1,4,1,6,2,2,4.0,0.0
46432,2589,2,29,2,33,4,3,14.5,0.0
46433,2859801,1000,27683,1000,29683,2000,1001,27.683,0.0
46435,15523,62,62,62,186,124,63,1.0,0.0
4644,33101,0,472,0,531,59,60,8.0,0.0
46440,19585,28,310,28,366,56,30,11.071,0.0
46442,30947,10,49,10,69,20,11,4.9,0.0
46446,113203,156,1768,156,2080,312,157,11.333,0.0
46448,15990,13,166,13,205,39,27,12.769,0.0
46449,1573729,1000,11035,1000,13035,2000,1001,11.035,0.0
46450,241581,1000,1000,1000,3000,2000,1001,1.0,0.0
46452,241581,1000,1000,1000,3000,2000,1001,1.0,0.0
46453,241581,1000,1000,1000,3000,2000,1001,1.0,0.0
46454,80697,327,327,327,981,654,328,1.0,0.0
46456,20232,32,256,32,320,64,33,8.0,0.0
46458,9431,25,75,25,125,50,26,3.0,0.0
4646,68304,98,784,98,980,196,99,8.0,0.0
46462,90987,369,369,369,1107,738,370,1.0,0.0
46463,66487,269,269,269,807,538,270,1.0,0.0
46464,5725,7,49,7,70,21,15,7.0,0.0
46465,551475,1000,5981,1000,7981,2000,1001,5.981,0.0
46466,555482,1000,5979,1000,7979,2000,1001,5.979,0.0
46467,5754,7,49,7,70,21,15,7.0,0.0
46468,5725,7,49,7,70,21,15,7.0,0.0
46469,2959,6,18,6,30,12,7,3.0,0.0
46470,17997,44,110,44,220,110,49,2.5,0.0
46471,1696,3,9,3,15,6,4,3.0,0.0
46472,2521,5,15,5,25,10,6,3.0,0.0
46473,17997,44,110,44,220,110,49,2.5,0.0
46474,2521,5,15,5,25,10,6,3.0,0.0
46475,15876,44,110,44,198,88,46,2.5,0.0
46476,2977,6,18,6,30,12,7,3.0,0.0
46477,2977,6,18,6,30,12,7,3.0,0.0
46478,2887,6,18,6,30,12,7,3.0,0.0
4648,378607,0,6000,0,6500,500,501,12.0,0.0
46480,259599,1000,1000,1000,3000,2000,1001,1.0,0.0
46483,239404,908,908,908,2724,1816,909,1.0,0.0
46485,1203029,0,20323,0,21323,1000,1001,20.323,0.0
46488,2182540,0,36984,0,37984,1000,1001,36.984,0.0
46489,1688582,0,27998,0,28998,1000,1001,27.998,0.0
4649,486816,500,6568,500,7568,1000,501,13.136,0.0
46490,2838,0,25,0,30,5,6,5.0,0.0
46491,257533,0,3889,0,4291,402,403,9.674,0.0
46497,1922747,1000,27211,1000,30211,3000,1129,27.211,0.0
4650,481293,0,7020,0,7488,468,469,15.0,0.0
46500,1189367,0,21549,0,22549,1000,1001,21.549,1.0
4651,746123,500,8500,500,9500,1000,501,17.0,0.0
46515,685460,499,8022,499,9519,1497,999,16.076,0.0
4652,19778,0,186,0,248,62,63,3.0,0.0
46522,1358656,0,23314,0,24314,1000,1001,23.314,0.0
46526,267607,1000,1000,1000,3000,2000,1001,1.0,0.0
46530,842560,1000,8305,1000,11305,3000,2001,8.305,0.0
46534,455098,1324,6620,1324,9268,2648,1326,5.0,0.0
46537,545195,0,8171,0,8971,800,801,10.214,0.0
4654,107970,233,1165,233,1631,466,234,5.0,0.75
46541,1068458,1000,17419,1000,19419,2000,1002,17.419,0.0
46558,980813,1000,15599,1000,17599,2000,1001,15.599,0.0
46559,271608,1000,1000,1000,3000,2000,1001,1.0,0.0
4656,147392,0,1645,0,1974,329,330,5.0,0.0
46561,644578,0,9509,0,10509,1000,1001,9.509,0.0
46563,428685,0,5000,0,6000,1000,1001,5.0,0.0
46566,1695089,1000,29050,1000,31050,2000,1002,29.05,0.5
46568,642174,0,9955,0,10905,950,951,10.479,1.0
4657,91366,222,1110,222,1554,444,223,5.0,0.0
46573,47628,0,662,0,712,50,51,13.24,0.0
4658,388868,500,4994,500,5994,1000,501,9.988,0.0
46582,963252,0,16154,0,17154,1000,1001,16.154,0.0
46583,267607,1000,1000,1000,3000,2000,1001,1.0,0.0
4659,530032,0,6500,0,7000,500,501,13.0,0.0
46598,32113,118,118,118,354,236,119,1.0,0.0
4660,350070,206,2265,206,2883,618,413,10.995,1.0
46603,1607135,1000,25211,1000,27211,2000,1002,25.211,0.0
4661,512694,0,6000,0,6500,500,501,12.0,1.0
46628,1119710,1000,19890,1000,21890,2000,1002,19.89,0.0
4663,229934,500,3500,500,4500,1000,501,7.0,0.0
46630,456707,0,4998,0,5998,1000,1001,4.998,0.0
46635,637787,1000,8000,1000,10000,2000,1001,8.0,0.0
4664,2114640,0,34000,0,34500,500,501,68.0,0.0
4665,415677,0,9500,0,10000,500,501,19.0,0.0
46655,137137,123,2530,123,2776,246,124,20.569,0.0
46658,1014923,0,17426,0,18426,1000,1001,17.426,0.0
46661,1868863,0,30432,0,31432,1000,1001,30.432,0.0
46662,1933076,0,30450,0,31450,1000,1001,30.45,0.0
46664,657230,1000,7201,1000,9201,2000,1001,7.201,0.0
46674,966729,555,15409,555,16519,1110,556,27.764,0.0
46678,115711,114,1221,114,1563,342,229,10.711,0.0
46682,306879,1000,2000,1000,4000,2000,1001,2.0,0.0
46692,1282075,785,19569,785,21139,1570,786,24.929,0.0
46694,790964,0,6056,0,6813,757,758,8.0,0.0
4670,24889,38,326,38,402,76,39,8.579,0.0
46700,710119,0,9000,0,10000,1000,1001,9.0,0.0
46704,963878,0,13000,0,14000,1000,1001,13.0,0.0
46707,514933,0,7306,0,7747,441,442,16.567,0.0
4671,519419,0,6000,0,6500,500,501,12.0,1.0
46711,5835,7,77,7,98,21,15,11.0,0.0
46715,625018,0,8048,0,8578,530,531,15.185,0.0
4672,431809,0,7627,0,8127,500,501,15.254,0.0
46720,10273,12,144,12,168,24,13,12.0,0.0
46723,590861,915,5443,915,7273,1830,917,5.949,0.0
46731,54958,33,859,33,925,66,34,26.03,0.0
46732,181141,173,2734,173,3253,519,348,7.902,0.0
46733,276390,342,4104,342,4788,684,343,12.0,0.0
46736,811646,1000,10440,1000,12440,2000,1002,10.44,0.0
46738,104754,0,1357,0,1495,138,139,9.833,0.5
46739,89869,45,1530,45,1620,90,46,34.0,0.0
4674,1259152,0,15479,0,15979,500,501,30.958,0.0
46740,32586,118,118,118,354,236,119,1.0,0.0
46741,27477,33,396,33,462,66,34,12.0,0.0
46742,32113,118,118,118,354,236,119,1.0,0.0
46745,1430505,0,25047,0,26047,1000,1001,25.047,0.0
46747,267607,1000,1000,1000,3000,2000,1001,1.0,0.0
4675,253228,0,2500,0,3000,500,501,5.0,0.0
46750,109525,103,1227,103,1433,206,105,11.913,0.0
46751,21101,0,165,0,220,55,56,3.0,0.0
4676,62913,88,875,88,1051,176,89,9.943,0.0
46764,267607,1000,1000,1000,3000,2000,1001,1.0,0.0
46766,1106545,2000,18455,2000,22455,4000,2003,9.227,0.0
4677,522699,0,7500,0,8000,500,501,15.0,0.0
46771,636838,974,7792,974,9740,1948,976,8.0,0.0
4678,662891,500,8134,500,9134,1000,501,16.268,0.5
46781,116168,114,1221,114,1563,342,229,10.711,0.0
46785,728499,0,10000,0,11000,1000,1001,10.0,0.0
46787,485971,0,6357,0,6846,489,490,13.0,1.0
46793,2395,3,21,3,30,9,8,3.5,0.0
46794,83730,0,1346,0,1429,83,84,16.217,0.0
46795,89869,45,1530,45,1620,90,46,34.0,0.0
4680,347416,0,5592,0,6542,950,949,11.184,0.0
46804,737820,0,8928,0,9928,1000,1001,8.928,0.0
4681,163937,396,1980,396,2772,792,397,5.0,0.0
46812,1314214,0,24701,0,25701,1000,1001,24.701,0.0
46814,124904,143,1283,143,1712,429,288,4.518,0.0
46815,267607,1000,1000,1000,3000,2000,1001,1.0,0.0
46817,47120,108,540,108,756,216,109,5.0,0.0
4682,310320,500,4500,500,5500,1000,501,9.0,0.5
46822,965003,1000,8155,1000,12155,4000,3002,8.155,0.6
46825,1299268,0,24604,0,25604,1000,1001,24.604,0.0
46832,267607,1000,1000,1000,3000,2000,1001,1.0,0.0
46833,90769,45,1530,45,1620,90,46,34.0,0.0
46834,1026461,1000,11100,1000,13100,2000,1002,11.1,0.0
46835,678175,1000,10000,1000,12000,2000,1001,10.0,0.0
4684,190090,0,2385,0,2862,477,478,5.0,0.0
46840,16017,14,224,14,266,42,30,8.0,0.0
46843,852507,1000,13153,1000,15153,2000,1001,13.153,0.0
4685,17392,0,232,0,261,29,30,8.0,0.0
46850,737793,1000,9000,1000,11000,2000,1001,9.0,0.0
46851,3831,0,27,0,36,9,10,3.0,0.0
46854,13026,0,104,0,139,35,36,2.971,0.0
46856,267607,1000,1000,1000,3000,2000,1001,1.0,0.0
4686,538593,0,6500,0,7000,500,501,13.0,0.0
46865,267607,1000,1000,1000,3000,2000,1001,1.0,0.0
46867,293459,0,2867,0,3588,721,722,3.976,0.0
46868,45626,123,369,123,615,246,124,3.0,1.0
4687,771821,1500,12988,1500,15988,3000,1502,8.659,0.0
46872,267607,1000,1000,1000,3000,2000,1001,1.0,0.0
46875,28225,0,270,0,324,54,55,5.0,0.0
46876,796533,0,10000,0,11000,1000,1001,10.0,0.0
46878,271608,1000,1000,1000,3000,2000,1001,1.0,0.0
46887,3157,0,23,0,31,8,9,2.875,0.0
46888,801067,1600,13438,1600,16638,3200,1602,8.399,0.0
46889,70511,84,1052,84,1220,168,85,12.524,0.0
46891,90252,0,548,0,824,276,277,1.986,0.0
46892,8141,4,112,4,124,12,10,14.0,0.0
46894,476641,0,2700,0,3600,900,901,3.0,0.0
46895,779607,1000,10000,1000,12000,2000,1001,10.0,0.0
4690,20497,0,207,0,263,56,57,7.393,0.0
46913,8083,28,28,28,84,56,29,1.0,0.0
46916,267607,1000,1000,1000,3000,2000,1001,1.0,0.0
46917,179043,290,2026,290,2896,870,582,3.505,0.0
4692,159765,195,2144,195,2534,390,196,10.995,0.5
46924,607604,0,7792,0,8766,974,975,8.0,0.0
46941,45139,124,491,124,739,248,126,3.96,0.0
46942,271608,1000,1000,1000,3000,2000,1001,1.0,0.0
4695,514191,0,6000,0,6500,500,501,12.0,0.0
4696,319682,0,4680,0,4992,312,313,15.0,0.0
4698,45817,0,549,0,657,108,109,5.083,0.0
4699,518704,0,6000,0,6500,500,501,12.0,1.0
47,210704,936,2055,936,3689,1634,940,2.907,0.0
4700,246912,0,3000,0,3500,500,501,6.0,0.0
4702,320345,0,3555,0,4555,1000,1001,7.11,0.0
4703,373142,0,5463,0,5963,500,501,10.926,0.0
4704,515964,0,7500,0,8000,500,501,15.0,0.0
4707,203219,500,2500,500,3500,1000,501,5.0,0.0
4708,16417,35,105,35,210,105,71,3.0,0.0
4709,240586,0,3500,0,4000,500,501,7.0,0.0
47098,5680,19,19,19,57,38,20,1.0,0.0
47105,46531,90,708,90,888,180,92,7.867,0.0
4711,481590,0,5275,0,5775,500,501,10.55,0.0
4712,328763,500,6000,500,7000,1000,501,12.0,0.0
47126,5871,12,60,12,84,24,13,5.0,0.0
47127,63490,0,928,0,994,66,67,14.061,0.0
47128,8752,2,6,2,10,4,3,3.0,0.0
47129,61486,0,765,0,876,111,112,6.892,1.0
4713,115957,240,1440,240,1920,480,241,6.0,0.0
47130,469778,1000,6000,1000,8000,2000,1001,6.0,0.0
47131,254257,950,950,950,2850,1900,951,1.0,0.0
47133,1159604,0,12535,0,13535,1000,1001,12.535,0.5
47134,473749,1000,6189,1000,8189,2000,1001,6.189,0.0
47135,1723,3,9,3,15,6,4,3.0,0.0
47136,39258,84,584,84,752,168,86,6.952,0.0
47138,3723,0,28,0,35,7,8,4.0,0.0
47139,63619,236,236,236,708,472,237,1.0,0.0
47140,46616,42,666,42,792,126,86,7.929,0.0
47141,3463,10,30,10,50,20,12,3.0,0.0
47145,13971,32,116,32,180,64,33,3.625,0.0
47146,4756,5,60,5,75,15,12,6.0,0.5
47149,251441,368,2574,368,3648,1074,556,6.995,0.0
4715,25418,0,276,0,322,46,47,6.0,0.0
47153,25539,0,310,0,341,31,32,10.0,0.875
47154,51939,0,480,0,600,120,121,4.0,0.5
47157,31418,29,464,29,551,87,60,8.0,0.0
47160,2864,5,20,5,30,10,6,4.0,0.0
47161,10185,22,141,22,185,44,24,6.409,0.0
47164,8230,0,72,0,90,18,19,4.0,0.0
47166,249586,404,2020,404,3229,1209,781,5.0,0.0
47167,1346854,1000,22441,1000,25441,3000,2002,11.22,0.0
47168,45982,46,666,46,758,92,47,14.478,0.0
47169,13743,28,196,28,252,56,30,7.0,0.0
4717,768774,396,12277,396,13569,1292,898,13.702,0.75
47170,26973,45,224,45,314,90,46,4.978,0.5
47171,684464,0,10000,0,11000,1000,1001,10.0,0.0
47175,14204,21,210,21,252,42,22,10.0,0.0
47178,585685,430,12040,430,12900,860,432,28.0,0.0
47179,29437,46,230,46,368,138,93,5.0,0.0
47180,23144,56,280,56,392,112,58,5.0,0.0
47182,70121,130,910,130,1170,260,132,7.0,0.0
47183,72700,62,1105,62,1229,124,63,17.823,0.0
4719,317980,500,3913,500,4913,1000,501,7.826,0.0
47190,85678,0,1057,0,1208,151,152,7.0,0.0
4720,1154928,500,14228,500,15228,1000,501,28.456,0.0
47201,277283,0,4070,0,4477,407,408,10.0,0.0
47207,267607,1000,1000,1000,3000,2000,1001,1.0,0.0
4721,3467133,0,36354,0,36573,219,220,166.0,0.0
47210,50524,102,542,102,746,204,103,5.314,0.0
47214,16755,10,451,10,471,20,11,45.1,0.0
4722,292636,0,4000,0,4500,500,501,8.0,0.0
47225,3442,10,30,10,50,20,12,3.0,0.0
47229,4325065,614,21490,614,22718,1228,615,35.0,0.0
4723,221136,500,2500,500,3500,1000,501,5.0,0.0
47238,16366,0,229,0,246,17,18,13.471,0.0
47241,271608,1000,1000,1000,3000,2000,1001,1.0,0.0
47244,3544,11,11,11,33,22,12,1.0,0.0
4725,399520,500,5994,500,6994,1000,501,11.988,0.0
4726,458721,0,7460,0,7960,500,501,14.92,0.0
47266,108475,404,404,404,1212,808,405,1.0,0.0
47268,267607,1000,1000,1000,3000,2000,1001,1.0,0.0
4727,509788,0,6000,0,6500,500,501,12.0,0.0
47271,267607,1000,1000,1000,3000,2000,1001,1.0,0.0
47274,493607,1000,5000,1000,7000,2000,1001,5.0,0.0
4728,50174,102,395,102,701,306,187,3.873,0.0
47281,5146,17,17,17,51,34,18,1.0,0.0
47287,267607,1000,1000,1000,3000,2000,1001,1.0,0.0
47288,267607,1000,1000,1000,3000,2000,1001,1.0,0.0
4729,69769,0,962,0,1101,139,140,6.921,0.0
47297,267607,1000,1000,1000,3000,2000,1001,1.0,0.0
4730,140352,384,1920,384,2688,768,385,5.0,0.0
47307,4612,15,15,15,45,30,16,1.0,0.0
4731,532169,0,10050,0,10550,500,501,20.1,0.0
47310,271608,1000,1000,1000,3000,2000,1001,1.0,0.0
47311,267607,1000,1000,1000,3000,2000,1001,1.0,0.0
47316,11287,40,40,40,120,80,41,1.0,0.0
47317,271608,1000,1000,1000,3000,2000,1001,1.0,0.0
47323,57901,98,488,98,684,196,99,4.98,0.0
47325,7015,24,24,24,72,48,25,1.0,0.0
47326,67629,106,636,106,848,212,107,6.0,0.0
47327,208009,132,4301,132,4565,264,133,32.583,0.0
47328,345909,417,4170,417,5004,834,418,10.0,0.0
47330,5837,12,56,12,80,24,13,4.667,0.0
47331,721259,1000,10858,1000,12858,2000,1001,10.858,0.75
47333,62015,88,792,88,968,176,89,9.0,0.0
47335,4717,12,40,12,64,24,13,3.333,0.0
47337,602026,1000,8037,1000,10037,2000,1001,8.037,0.0
4734,517417,0,6000,0,6500,500,501,12.0,1.0
47342,61694,88,792,88,968,176,89,9.0,0.0
47343,35360,0,470,0,517,47,48,10.0,0.0
47344,82558,185,880,185,1250,370,186,4.757,0.0
47347,5060,12,40,12,64,24,13,3.333,0.0
47348,104262,180,1592,180,1952,360,181,8.844,0.0
47349,3726,6,36,6,48,12,7,6.0,0.0
4735,49955,125,625,125,875,250,126,5.0,0.0
47358,3159,6,24,6,36,12,7,4.0,0.0
4736,537049,0,7500,0,8000,500,501,15.0,0.0
47364,13579,37,111,37,185,74,38,3.0,0.0
4737,404748,0,7723,0,8223,500,501,15.446,0.75
47371,164383,230,3220,230,3680,460,231,14.0,0.0
47373,3751,6,36,6,48,12,7,6.0,0.0
47375,38771,115,345,115,575,230,116,3.0,0.0
4738,8847,16,76,16,108,32,17,4.75,0.0
47380,5963,16,44,16,76,32,17,2.75,0.0
47381,47616,84,336,84,504,168,85,4.0,0.0
47385,85429,150,1326,150,1626,300,151,8.84,0.0
47386,3891,10,30,10,50,20,11,3.0,0.0
47387,345909,417,4170,417,5004,834,418,10.0,0.0
47389,71719,96,960,96,1152,192,97,10.0,0.0
4739,300271,0,6000,0,6500,500,501,12.0,0.0
47391,5109,12,40,12,64,24,13,3.333,0.0
47392,86030,150,1326,150,1626,300,151,8.84,0.0
47393,41071,88,528,88,704,176,89,6.0,0.0
47394,50188,77,711,77,865,154,78,9.234,0.0
47396,35680,84,252,84,420,168,85,3.0,0.0
47398,124398,0,2282,0,2377,95,96,24.021,0.0
47399,20458,32,311,32,375,64,33,9.719,0.0
4740,241961,0,3510,0,3744,234,235,15.0,0.0
47400,7314,19,57,19,95,38,20,3.0,0.0
47401,48988,88,792,88,968,176,89,9.0,0.0
47402,255592,1000,1000,1000,3000,2000,1001,1.0,0.0
47403,5687,14,56,14,84,28,15,4.0,0.0
47406,80087,138,1242,138,1518,276,139,9.0,0.0
47408,13041,33,132,33,198,66,34,4.0,0.0
4742,89418,164,656,164,1142,486,322,4.0,0.0
47424,4694,13,31,13,57,26,14,2.385,0.0
4743,33724,0,303,0,404,101,102,3.0,0.5
47439,7612,15,90,15,120,30,16,6.0,0.0
47444,4701,0,40,0,50,10,11,4.0,0.0
47445,63341,250,250,250,750,500,251,1.0,0.0
47446,133119,528,528,528,1584,1056,529,1.0,0.0
47451,153315,252,1764,252,2268,504,253,7.0,0.0
47459,3891,10,30,10,50,20,11,3.0,0.0
4746,217006,500,3000,500,4000,1000,501,6.0,0.0
4747,551163,0,5796,0,6279,483,484,12.0,0.5
47470,146713,218,1744,218,2180,436,219,8.0,0.0
47475,410810,1000,4935,1000,6935,2000,1001,4.935,0.0
4748,515474,500,7952,500,8952,1000,501,15.904,0.0
47481,1637675,1000,16038,1000,20038,4000,1003,16.038,0.0
47483,2193583,1000,36274,1000,38274,2000,1001,36.274,0.0
47484,126170,340,1360,340,2040,680,341,4.0,0.0
47486,265602,1000,1000,1000,3000,2000,1001,1.0,0.0
47487,454471,0,5000,0,6000,1000,1001,5.0,0.0
47489,4851,10,40,10,60,20,11,4.0,0.0
4749,555936,0,7457,0,7957,500,501,14.914,0.0
47491,6831,0,72,0,83,11,12,6.545,0.0
47494,261635,384,2859,384,3627,768,385,7.445,0.0
47498,55420,163,489,163,815,326,164,3.0,0.0
4750,5023090,0,71523,0,72023,500,501,143.046,0.0
47509,33103,80,400,80,560,160,81,5.0,0.0
4751,70556,0,1152,0,1248,96,97,12.0,0.5
47513,33103,80,400,80,560,160,81,5.0,0.0
47514,86517,102,1224,102,1530,306,205,12.0,0.0
4752,769337,500,9736,500,10736,1000,501,19.472,0.0
47524,261601,1000,1000,1000,3000,2000,1001,1.0,0.0
47528,576805,1000,6888,1000,8888,2000,1001,6.888,0.0
47535,3122,7,21,7,35,14,8,3.0,0.0
47536,3817,8,40,8,56,16,9,5.0,0.0
47539,3852,8,40,8,56,16,9,5.0,0.0
4754,193557,0,2750,0,3025,275,276,10.0,0.5
47540,3818,8,40,8,56,16,9,5.0,0.0
47541,412769,483,5796,483,6762,966,484,12.0,0.0
47543,3818,8,40,8,56,16,9,5.0,0.0
47544,3853,8,40,8,56,16,9,5.0,0.0
47545,3818,8,40,8,56,16,9,5.0,0.0
47548,54889,208,208,208,624,416,209,1.0,0.0
4755,135645,0,2123,0,2248,125,126,16.984,0.0
47551,57650,149,596,149,894,298,150,4.0,0.0
47552,5002,11,44,11,66,22,12,4.0,0.0
47553,3852,8,40,8,56,16,9,5.0,0.0
47554,110891,262,1310,262,1834,524,263,5.0,0.0
47555,32782,80,400,80,560,160,81,5.0,0.0
47556,4261,10,30,10,50,20,11,3.0,0.0
47557,254032,971,971,971,2913,1942,972,1.0,0.0
47558,4851,10,40,10,60,20,11,4.0,0.0
47559,774775,1000,10527,1000,12527,2000,1001,10.527,0.0
4756,517747,0,6000,0,6500,500,501,12.0,0.0
47566,1388,2,8,2,12,4,3,4.0,0.0
47568,2757,0,18,0,24,6,7,3.0,0.0
4757,11581,0,72,0,120,48,49,3.0,0.75
47571,18680,0,240,0,264,24,25,10.0,0.0
47578,35812,17,586,17,620,34,18,34.471,0.0
4758,862522,500,10648,500,11648,1000,501,21.296,0.0
47583,1677,3,9,3,15,6,4,3.0,0.0
47586,9254,21,84,21,126,42,22,4.0,0.0
47589,8279,20,80,20,120,40,21,4.0,0.0
4759,219277,0,3500,0,4000,500,501,7.0,0.0
47592,10289,0,101,0,127,26,27,3.885,0.0
47593,14542,30,150,30,210,60,31,5.0,0.0
47594,7052,17,68,17,102,34,18,4.0,0.0
47596,12274,30,120,30,180,60,31,4.0,0.0
47598,1844363,1000,12789,1000,15789,3000,1034,12.789,0.5
4760,538604,0,6499,0,6999,500,501,12.998,0.0
47600,3719,0,27,0,36,9,10,3.0,0.0
47601,12998,30,120,30,180,60,31,4.0,0.0
47603,7121,17,68,17,102,34,18,4.0,0.0
47606,8267,20,80,20,120,40,21,4.0,0.0
47607,265602,1000,1000,1000,3000,2000,1001,1.0,0.0
4761,239842,0,3429,0,3929,500,501,6.858,0.0
47611,257917,971,971,971,2913,1942,972,1.0,0.5
47617,6277,15,60,15,90,30,16,4.0,0.0
4762,749836,0,12500,0,13000,500,501,25.0,0.0
47621,5535,0,52,0,65,13,14,4.0,0.0
47623,8267,20,80,20,120,40,21,4.0,0.0
47627,5133,0,48,0,60,12,13,4.0,0.0
4763,84155,240,960,240,1440,480,241,4.0,0.0
47631,1567487,1864,28311,1864,32039,3728,1866,15.188,0.0
47632,46447,173,173,173,519,346,174,1.0,0.0
47637,45754,173,173,173,519,346,174,1.0,0.0
4764,309895,0,6000,0,6500,500,501,12.0,0.0
47641,45754,173,173,173,519,346,174,1.0,0.0
47642,261601,1000,1000,1000,3000,2000,1001,1.0,0.0
47643,261601,1000,1000,1000,3000,2000,1001,1.0,0.0
47644,46447,173,173,173,519,346,174,1.0,0.0
47647,261601,1000,1000,1000,3000,2000,1001,1.0,0.0
47648,261601,1000,1000,1000,3000,2000,1001,1.0,0.0
4765,239854,500,3000,500,4000,1000,501,6.0,0.5
47651,55722,208,208,208,624,416,209,1.0,0.0
47652,265602,1000,1000,1000,3000,2000,1001,1.0,0.0
47655,45754,173,173,173,519,346,174,1.0,0.0
47656,46447,173,173,173,519,346,174,1.0,0.0
47657,261601,1000,1000,1000,3000,2000,1001,1.0,0.0
47659,265602,1000,1000,1000,3000,2000,1001,1.0,0.0
4766,63583,192,768,192,1152,384,193,4.0,0.0
47660,261601,1000,1000,1000,3000,2000,1001,1.0,0.0
47661,261601,1000,1000,1000,3000,2000,1001,1.0,0.0
47662,261601,1000,1000,1000,3000,2000,1001,1.0,0.0
4768,9094,0,104,0,130,26,27,4.0,0.5
47681,426790,1000,6147,1000,8147,2000,1001,6.147,0.0
47687,6579,18,54,18,90,36,19,3.0,0.0
47688,232904,445,2225,445,3115,890,446,5.0,0.0
4769,65645,0,836,0,912,76,77,11.0,0.0
4770,272134,0,2352,0,2548,196,197,12.0,0.0
47704,9526,21,105,21,147,42,22,5.0,0.0
4773,511350,0,6000,0,6500,500,501,12.0,1.0
4774,366315,0,5500,0,6000,500,501,11.0,0.0
4775,538714,0,6500,0,7000,500,501,13.0,0.0
4776,530770,0,6500,0,7000,500,501,13.0,0.0
4779,6645,0,42,0,49,7,8,6.0,0.0
4780,525929,0,7000,0,7500,500,501,14.0,0.0
4781,166007,0,2340,0,2496,156,157,15.0,0.0
4782,337106,500,3960,500,4960,1000,501,7.92,0.0
4783,239977,500,3000,500,4000,1000,501,6.0,0.0
4784,478197,500,6500,500,7500,1000,501,13.0,1.0
4785,365963,0,6000,0,6500,500,501,12.0,1.0
4787,246352,0,4000,0,4500,500,501,8.0,0.0
4788,237518,0,2500,0,3000,500,501,5.0,0.0
4789,533034,500,2499,500,3999,1500,1001,4.998,0.5
4790,173330,0,1485,0,1980,495,496,3.0,0.0
47900,2171,4,16,4,24,8,5,4.0,0.0
47901,2261,4,16,4,24,8,5,4.0,0.0
47902,2171,4,16,4,24,8,5,4.0,0.0
47903,9937,16,96,16,128,32,17,6.0,0.0
47904,36550,60,360,60,480,120,61,6.0,0.0
47905,273610,1000,1000,1000,3000,2000,1001,1.0,0.0
47906,11706,0,114,0,133,19,20,6.0,0.0
47907,3082,7,21,7,35,14,8,3.0,0.0
47908,2725,4,24,4,32,8,5,6.0,0.0
47909,31418,51,306,51,408,102,52,6.0,0.0
4791,15428,0,188,0,206,18,19,10.444,0.0
47910,4228,10,30,10,50,20,11,3.0,0.0
47911,12205,19,114,19,152,38,20,6.0,0.0
47912,116169,0,1152,0,1344,192,193,6.0,0.0
47913,73505,0,732,0,854,122,123,6.0,0.0
47914,4450,4,60,4,68,8,5,15.0,0.0
47915,273610,1000,1000,1000,3000,2000,1001,1.0,0.0
47916,90103,0,906,0,1057,151,152,6.0,0.0
47917,2205,4,20,4,28,8,5,5.0,0.0
47918,40517,0,402,0,469,67,68,6.0,0.0
47919,50616,0,498,0,581,83,84,6.0,0.0
4792,913904,500,12042,500,13042,1000,501,24.084,0.0
47920,39612,0,396,0,462,66,67,6.0,0.0
47921,220952,0,2238,0,2611,373,374,6.0,0.0
47922,269609,1000,1000,1000,3000,2000,1001,1.0,0.0
47923,2725,4,24,4,32,8,5,6.0,0.0
47924,269609,1000,1000,1000,3000,2000,1001,1.0,0.0
47925,269609,1000,1000,1000,3000,2000,1001,1.0,0.0
47926,237381,398,2388,398,3184,796,399,6.0,0.0
47927,55418,0,552,0,644,92,93,6.0,0.0
47928,269609,1000,1000,1000,3000,2000,1001,1.0,0.0
47929,51916,86,516,86,688,172,87,6.0,0.0
47930,41804,0,420,0,490,70,71,6.0,0.0
47931,273610,1000,1000,1000,3000,2000,1001,1.0,0.0
47932,4228,10,30,10,50,20,11,3.0,0.0
47933,269609,1000,1000,1000,3000,2000,1001,1.0,0.0
47934,269609,1000,1000,1000,3000,2000,1001,1.0,0.0
47935,35780,59,354,59,472,118,60,6.0,0.0
47936,53331,88,528,88,704,176,89,6.0,0.0
47937,269609,1000,1000,1000,3000,2000,1001,1.0,0.0
47938,74040,125,750,125,1000,250,126,6.0,0.0
4794,472624,0,6578,0,7578,1000,512,13.156,0.0
47940,1126695,0,9272,0,10272,1000,1001,9.272,0.0
47942,351094,0,2967,0,3286,319,320,9.301,0.0
47943,661672,1000,6992,1000,8992,2000,1001,6.992,0.0
47944,1343895,1000,25999,1000,27999,2000,1001,25.999,0.0
47945,5034889,0,107282,0,108036,754,755,142.284,0.5
47946,2320423,1000,37377,1000,39377,2000,1001,37.377,0.0
47947,3384414,864,96576,864,99304,2728,1866,51.811,0.0
47949,694162,0,8000,0,9000,1000,1001,8.0,0.0
4795,228593,500,1500,500,3000,1500,1001,3.0,0.0
47950,3271305,0,96388,0,97388,1000,1001,96.388,0.0
47951,8366,16,96,16,128,32,17,6.0,0.5
47952,450604,0,5523,0,6523,1000,1001,5.523,0.0
47953,417136,1000,5424,1000,7424,2000,1001,5.424,0.0
47954,286077,0,3647,0,4255,608,609,5.998,0.5
47955,1215496,0,8946,0,9946,1000,1001,8.946,0.5
47956,1012237,0,9804,0,10804,1000,1001,9.804,0.0
47957,845561,0,11000,0,12000,1000,1001,11.0,0.0
47958,702819,1000,11000,1000,13000,2000,1001,11.0,0.0
47959,1216738,0,13087,0,14087,1000,1001,13.087,0.0
4796,198297,286,1745,286,2791,1046,741,6.101,0.0
47960,788082,1000,12950,1000,14950,2000,1001,12.95,0.5
47961,549015,0,7000,0,8000,1000,1001,7.0,0.0
47962,823224,0,14000,0,15000,1000,1001,14.0,0.0
47963,1208897,0,8905,0,9905,1000,1001,8.905,0.0
47964,31527,0,475,0,549,74,75,12.838,0.0
47965,1194827,0,14385,0,15385,1000,1001,14.385,0.0
47968,813690,0,8671,0,9671,1000,1001,8.671,0.0
47969,814838,0,13000,0,14000,1000,1001,13.0,0.0
4797,193504,0,2240,0,2688,448,449,5.0,0.5
47970,220715,206,2926,206,3338,412,207,14.204,0.0
47971,534400,0,7796,0,8796,1000,1001,7.796,0.0
47972,647108,0,8726,0,9726,1000,1001,8.726,0.0
47973,595911,1000,8552,1000,10552,2000,1001,8.552,0.0
47974,1159505,0,10375,0,11375,1000,1001,10.375,0.0
47976,25707,0,336,0,384,48,49,7.0,0.0
47977,1065909,0,10234,0,11234,1000,1001,10.234,0.0
47978,8029743,0,169712,0,170712,1000,1001,169.712,0.0
47979,1635629,0,15646,0,16646,1000,1001,15.646,1.0
4798,411776,0,9500,0,10000,500,501,19.0,0.0
47980,769100,0,8000,0,9000,1000,1001,8.0,1.0
47981,866324,0,8967,0,9967,1000,1001,8.967,1.0
47983,685528,0,9575,0,10575,1000,1001,9.575,0.0
47984,704558,0,11000,0,12000,1000,1001,11.0,0.0
47985,181322,0,2045,0,2350,305,306,6.705,0.5
47986,827945,0,9178,0,10178,1000,1001,9.178,0.0
47987,367488,0,3728,0,4335,607,608,6.142,0.0
47988,22390,40,320,40,400,80,41,8.0,0.0
47989,3360922,0,34232,0,35232,1000,1001,34.232,0.5
4799,11066,32,128,32,192,64,33,4.0,0.0
47990,590406,0,11862,0,12862,1000,1001,11.862,0.75
47991,52790,0,858,0,936,78,79,11.0,0.0
47992,607139,0,2075,0,2083,8,9,259.375,1.0
47993,970115,1000,13745,1000,15745,2000,1001,13.745,0.0
47994,112415,0,1704,0,1917,213,214,8.0,0.0
47997,20006,42,252,42,336,84,43,6.0,0.0
47998,654409,0,3834,0,4211,377,378,10.17,0.0
47999,1939847,1000,27394,1000,29394,2000,1001,27.394,0.0
4800,354816,0,4500,0,5000,500,501,9.0,0.0
48000,57650,91,637,91,819,182,92,7.0,0.0
48001,297694,0,4154,0,4675,521,522,7.973,0.0
48002,4098345,0,68830,0,69830,1000,1001,68.83,0.0
48003,1736798,0,19837,0,20837,1000,1001,19.837,0.0
48004,6311039,0,236243,0,237243,1000,1001,236.243,0.0
48005,7202694,0,289384,0,290384,1000,1001,289.384,0.0
48006,241972,0,3136,0,3332,196,197,16.0,0.5
48007,55671,32,352,32,416,64,33,11.0,0.0
48008,160292,0,2100,0,2404,304,305,6.908,0.0
48009,74049,42,456,42,540,84,43,10.857,0.0
48010,21301,44,264,44,352,88,45,6.0,0.0
48013,12169,0,108,0,126,18,19,6.0,0.0
48014,52638,28,308,28,364,56,29,11.0,0.0
48015,12559,0,198,0,216,18,19,11.0,0.0
48016,55259,50,454,50,554,100,51,9.08,0.0
48017,825306,0,17084,0,17294,210,211,81.352,0.0
4802,309634,0,6000,0,6500,500,501,12.0,0.0
48021,118362,0,1888,0,2007,119,120,15.866,0.0
48023,18164,38,228,38,304,76,39,6.0,0.0
48024,1132135,0,22137,0,22448,311,312,71.18,0.0
48025,19613,0,170,0,187,17,18,10.0,0.0
48026,40054,0,823,0,886,63,64,13.063,0.0
48027,215905,180,3444,180,3804,360,181,19.133,0.0
48028,9500,19,114,19,152,38,20,6.0,0.0
48029,2067,0,21,0,24,3,4,7.0,0.0
48030,400457,1000,5212,1000,7212,2000,1001,5.212,0.0
48031,251782,212,4043,212,4467,424,213,19.071,0.0
48032,12559,0,198,0,216,18,19,11.0,0.0
48033,2903682,1000,63894,1000,65894,2000,1001,63.894,0.0
48034,5074,2,76,2,80,4,3,38.0,0.0
48035,3254,5,40,5,50,10,6,8.0,0.0
48036,2807681,404,63288,404,64096,808,405,156.653,0.0
48037,3212209,554,103801,554,104909,1108,555,187.366,0.0
48038,238375,202,3849,202,4253,404,203,19.054,0.5
48039,1969222,422,41391,422,42235,844,423,98.083,0.0
4804,613920,0,9960,0,10460,500,501,19.92,0.0
48040,11677378,937,271671,937,273545,1874,938,289.937,0.0
48043,279616,1000,1000,1000,3000,2000,1001,1.0,0.0
48046,279616,1000,1000,1000,3000,2000,1001,1.0,0.0
48048,275615,1000,1000,1000,3000,2000,1001,1.0,0.0
4805,101103,0,1320,0,1452,132,133,10.0,0.0
48050,275615,1000,1000,1000,3000,2000,1001,1.0,0.0
48051,20415,72,72,72,216,144,73,1.0,0.0
48052,2875099,1000,42203,1000,47199,4996,1794,42.203,0.0
48056,2840377,1000,42254,1000,47254,5000,1489,42.254,0.0
48057,3042126,1000,44880,1000,49875,4995,2027,44.88,0.0
48061,3114922,1000,46191,1000,51181,4990,1905,46.191,0.0
48062,279616,1000,1000,1000,3000,2000,1001,1.0,0.0
48064,3086934,1000,46393,1000,51392,4999,1875,46.393,0.0
48065,275615,1000,1000,1000,3000,2000,1001,1.0,0.0
48066,3344310,1000,49843,1000,54843,5000,1897,49.843,0.0
48068,3322737,1000,49583,1000,54583,5000,2098,49.583,0.0
48069,2961969,1000,43842,1000,48838,4996,1640,43.842,0.0
4807,551369,500,6083,500,7083,1000,501,12.166,0.0
48070,275615,1000,1000,1000,3000,2000,1001,1.0,0.0
48072,279616,1000,1000,1000,3000,2000,1001,1.0,0.0
48073,279616,1000,1000,1000,3000,2000,1001,1.0,0.0
48074,275615,1000,1000,1000,3000,2000,1001,1.0,0.0
48075,261865,950,950,950,2850,1900,951,1.0,0.0
48076,2923154,1000,43105,1000,48105,5000,1644,43.105,0.0
48079,212915,772,772,772,2316,1544,773,1.0,0.0
4808,343903,500,4487,500,5487,1000,501,8.974,0.0
48080,3115191,1000,46833,1000,51827,4994,1711,46.833,0.0
48081,279616,1000,1000,1000,3000,2000,1001,1.0,0.0
48082,2963890,1000,43998,1000,48998,5000,1773,43.998,0.0
48083,275615,1000,1000,1000,3000,2000,1001,1.0,0.0
48086,3008753,1000,44594,1000,49593,4999,1659,44.594,0.0
48088,48190,173,173,173,519,346,174,1.0,0.0
48089,37740,135,135,135,405,270,136,1.0,0.0
4809,96945,0,1475,0,1534,59,60,25.0,0.0
48091,116959,417,417,417,1251,834,418,1.0,0.0
48094,59740,215,215,215,645,430,216,1.0,0.0
48095,35265,126,126,126,378,252,127,1.0,0.0
48097,269840,979,979,979,2937,1958,980,1.0,0.0
48098,126290,457,457,457,1371,914,458,1.0,0.0
48099,3182742,1000,47358,1000,52358,5000,1771,47.358,0.0
4810,306451,500,3500,500,4500,1000,501,7.0,0.0
48100,172490,625,625,625,1875,1250,626,1.0,0.0
48101,17665,62,62,62,186,124,63,1.0,0.0
48102,23990,85,85,85,255,170,86,1.0,0.0
48103,28795,101,101,101,303,202,102,1.0,0.0
48104,119191,425,425,425,1275,850,426,1.0,0.0
48106,19030,66,66,66,198,132,67,1.0,0.0
48107,3365,10,10,10,30,20,11,1.0,0.0
48109,275615,1000,1000,1000,3000,2000,1001,1.0,0.0
48110,3001615,1000,44740,1000,49739,4999,1778,44.74,0.0
48111,3264794,1000,48697,1000,53676,4979,1908,48.697,0.0
48112,30190,106,106,106,318,212,107,1.0,0.0
48113,29074,102,102,102,306,204,103,1.0,0.0
48115,28390,101,101,101,303,202,102,1.0,0.0
48116,61717,219,219,219,657,438,220,1.0,0.0
48117,27121,95,95,95,285,190,96,1.0,0.0
48118,188941,675,675,675,2025,1350,676,1.0,0.0
48119,25090,89,89,89,267,178,90,1.0,0.0
48120,8428,28,28,28,84,56,29,1.0,0.0
48121,3070811,1000,45926,1000,50925,4999,1591,45.926,0.0
48122,140590,509,509,509,1527,1018,510,1.0,0.0
48123,151834,542,542,542,1626,1084,543,1.0,0.0
48124,80640,291,291,291,873,582,292,1.0,0.0
48126,65515,236,236,236,708,472,237,1.0,0.0
4813,424095,500,5998,500,6998,1000,501,11.996,0.0
48130,50278,178,178,178,534,356,179,1.0,0.0
48131,3060968,1000,45561,1000,50561,5000,1708,45.561,0.0
48132,3066818,1000,45854,1000,50854,5000,1699,45.854,0.0
48135,1520621,509,22563,509,25108,2545,843,44.328,0.0
48136,2883697,950,43011,950,47761,4750,1608,45.275,0.0
4814,350453,293,5114,293,5700,586,294,17.454,0.0
48141,2418925,796,36015,796,39995,3980,1371,45.245,0.0
48142,1831346,625,27265,625,30390,3125,921,43.624,0.0
48143,1609764,542,23886,542,26596,2710,910,44.07,0.0
48148,1966886,648,29248,648,32488,3240,1081,45.136,0.0
4815,387982,500,5999,500,6999,1000,501,11.998,0.0
48153,1415002,457,21174,457,23459,2285,774,46.333,0.0
48154,998731,325,14586,325,16210,1624,570,44.88,0.0
48156,1302163,417,19416,417,21501,2085,706,46.561,0.0
48157,1426635,1000,18576,1000,20576,2000,1001,18.576,0.0
48158,185606,66,2722,66,3052,330,93,41.242,0.0
4816,346888,500,4500,500,5500,1000,501,9.0,0.0
48160,1162008,388,17341,388,19281,1940,637,44.693,0.0
48162,689509,236,10210,236,11390,1180,371,43.263,0.0
48163,1238664,417,18387,417,20472,2085,687,44.094,0.0
48164,278301,95,4123,95,4598,475,158,43.4,0.0
48165,420756,135,6277,135,6952,675,240,46.496,0.0
48166,507196,173,7510,173,8375,865,273,43.41,0.0
48167,216393,72,3203,72,3562,359,124,44.486,0.0
48168,651815,215,9743,215,10818,1075,361,45.316,0.0
4817,363686,500,6500,500,7500,1000,501,13.0,0.0
48171,928996,291,13906,291,15361,1455,546,47.787,0.0
48174,296419,102,4374,102,4884,510,164,42.882,0.0
48175,291084,101,4301,101,4806,505,155,42.584,0.0
48176,77208,28,1123,28,1263,140,43,40.107,0.0
48177,305830,106,4520,106,5050,530,167,42.642,0.0
48179,252018,85,3759,85,4184,425,159,44.224,0.0
4818,204912,500,2500,500,3500,1000,501,5.0,0.0
48180,744337,1000,9714,1000,11714,2000,1001,9.714,0.0
48182,632544,1000,8000,1000,10000,2000,1001,8.0,0.0
48183,1026450,1000,13419,1000,15419,2000,1001,13.419,0.0
48184,279616,1000,1000,1000,3000,2000,1001,1.0,0.0
48187,10764,0,175,0,189,14,15,12.5,0.0
48188,7574,0,115,0,126,11,12,10.455,0.0
48189,13651,0,165,0,184,19,20,8.684,0.0
4819,617500,500,8500,500,9500,1000,501,17.0,0.0
48192,14457,21,191,21,233,42,22,9.095,0.0
48198,29846,20,398,20,438,40,21,19.9,0.0
4820,386428,0,5500,0,6000,500,501,11.0,0.0
48206,8750,0,82,0,98,16,17,5.125,0.0
48207,12772,21,161,21,203,42,22,7.667,0.0
48209,4664,6,66,6,78,12,7,11.0,0.0
4821,231020,500,3000,500,4000,1000,501,6.0,0.0
48210,17946,25,217,25,267,50,26,8.68,0.0
48212,7294,13,69,13,95,26,14,5.308,0.0
48213,7136,11,107,11,129,22,12,9.727,0.0
48214,29847,0,398,0,418,20,21,19.9,0.0
48216,14415,0,191,0,212,21,22,9.095,0.0
48219,25007,0,320,0,335,15,16,21.333,0.0
48220,1728,0,11,0,14,3,4,3.667,0.0
48224,18922,0,201,0,228,27,28,7.444,0.0
48227,11659,18,136,18,172,36,19,7.556,0.0
48228,7277,14,69,14,97,28,15,4.929,0.0
48229,10364,0,176,0,187,11,12,16.0,0.0
48231,30207,13,305,13,331,26,14,23.462,0.0
48236,25236,33,412,33,478,66,34,12.485,0.0
48237,2949,0,19,0,26,7,8,2.714,0.0
48239,11651,14,164,14,192,28,15,11.714,0.0
4824,1030244,500,11223,500,12223,1000,501,22.446,0.0
48242,5327,0,42,0,55,13,14,3.231,0.0
48244,39671,24,398,24,446,48,25,16.583,0.0
4825,88296,170,952,170,1292,340,171,5.6,0.0
48253,7091,11,107,11,129,22,12,9.727,0.0
48255,10143,0,118,0,136,18,19,6.556,0.0
48256,7220,14,69,14,97,28,15,4.929,0.0
4826,272440,500,3500,500,4500,1000,501,7.0,0.0
48262,25369,33,412,33,478,66,34,12.485,0.0
48263,15326,0,204,0,231,27,28,7.556,0.0
48265,1890,0,9,0,13,4,5,2.25,0.0
48266,941,0,3,0,4,1,2,3.0,0.0
48267,12494,0,199,0,214,15,16,13.267,0.0
48268,16197,19,267,19,305,38,20,14.053,0.0
48269,27587,0,440,0,480,40,41,11.0,0.0
4827,545618,500,9000,500,10000,1000,501,18.0,0.5
48271,14457,21,191,21,233,42,22,9.095,0.0
48276,6727,0,68,0,78,10,11,6.8,0.0
48278,2262,0,18,0,21,3,4,6.0,0.0
48279,1480,0,8,0,10,2,3,4.0,0.0
4828,318181,500,3800,500,4800,1000,501,7.6,0.0
48284,1572,0,12,0,14,2,3,6.0,0.0
48285,24791,0,352,0,371,19,20,18.526,0.0
48286,11708,14,164,14,192,28,15,11.714,0.0
48289,7076,0,60,0,80,20,21,3.0,0.0
48292,29846,20,398,20,438,40,21,19.9,0.0
48296,8295,0,117,0,120,3,4,39.0,0.0
4830,359403,500,5000,500,6000,1000,501,10.0,0.0
48303,15342,0,190,0,210,20,21,9.5,0.0
48306,29846,20,398,20,438,40,21,19.9,0.0
48308,7347,13,69,13,95,26,14,5.308,0.0
48310,10764,0,175,0,189,14,15,12.5,0.0
48311,35150,0,522,0,544,22,23,23.727,0.0
48312,2747,0,25,0,30,5,6,5.0,0.0
48314,6051,0,53,0,62,9,10,5.889,0.0
48316,7192,0,69,0,83,14,15,4.929,0.0
48317,7394,0,66,0,88,22,23,3.0,0.0
48318,14918,0,189,0,209,20,21,9.45,0.0
48320,18970,46,186,46,278,92,47,4.043,0.0
48321,15761,0,197,0,217,20,21,9.85,0.0
48326,22974,0,340,0,354,14,15,24.286,0.0
48327,14457,21,191,21,233,42,22,9.095,0.0
48328,15309,0,185,0,205,20,21,9.25,0.0
48329,2636,0,22,0,25,3,4,7.333,0.0
4833,426348,500,6000,500,7000,1000,501,12.0,0.0
48336,8696,0,75,0,100,25,26,3.0,0.0
48337,11708,14,164,14,192,28,15,11.714,0.0
48338,14923,19,186,19,224,38,20,9.789,0.0
48339,954,0,3,0,4,1,2,3.0,0.0
4834,27797,70,280,70,420,140,71,4.0,0.0
48341,11659,18,136,18,172,36,19,7.556,0.0
48349,416853,1000,4000,1000,6000,2000,1001,4.0,0.0
48354,740802,0,11783,0,12783,1000,1001,11.783,0.5
48355,235575,1000,1000,1000,3000,2000,1001,1.0,0.0
48358,1627746,1000,26726,1000,29726,3000,1349,26.726,0.0
4836,380539,500,5000,500,6000,1000,501,10.0,0.0
48361,233575,0,1000,0,2000,1000,1001,1.0,0.0
48362,513003,1000,6000,1000,8000,2000,1001,6.0,0.0
48364,1347399,1000,20297,1000,22297,2000,1001,20.297,0.0
48365,303919,669,3345,669,4683,1338,670,5.0,0.5
48366,753599,0,12211,0,13211,1000,1001,12.211,0.0
48367,1500797,1000,21702,1000,24702,3000,1193,21.702,0.0
48369,233575,0,1000,0,2000,1000,1001,1.0,0.0
4837,235136,500,3000,500,4000,1000,501,6.0,0.0
48370,353388,1000,3997,1000,5997,2000,1001,3.997,0.0
48371,1573991,1000,24490,1000,27490,3000,1238,24.49,1.0
48372,1440216,1000,25755,1000,27755,2000,1001,25.755,0.0
48373,956401,0,16000,0,17000,1000,1001,16.0,0.5
48375,4117,11,33,11,55,22,12,3.0,0.0
48377,4848,11,44,11,66,22,12,4.0,0.0
48381,2459515,1000,45877,1000,47877,2000,1001,45.877,0.0
48388,759683,0,12254,0,13254,1000,1001,12.254,0.0
48389,1076679,1000,14869,1000,17869,3000,2002,14.869,0.0
48392,2018243,1000,28987,1000,30987,2000,1001,28.987,0.0
48395,760541,1000,9999,1000,11999,2000,1001,9.999,0.0
48396,2458269,1000,45803,1000,47803,2000,1001,45.803,0.0
48398,738771,0,11840,0,12840,1000,1001,11.84,0.0
48399,8731,7,63,7,84,21,15,9.0,0.0
48401,1593330,1000,25000,1000,27000,2000,1001,25.0,0.0
48402,11629,0,132,0,143,11,12,12.0,0.5
48403,2363755,1000,37857,1000,40857,3000,1909,37.857,0.5
48405,39713,49,498,49,651,153,104,10.163,0.0
48406,633889,0,9000,0,10000,1000,1001,9.0,0.0
48407,643568,0,7146,0,8146,1000,1001,7.146,0.0
48408,1311639,1000,13949,1000,15949,2000,1001,13.949,0.0
48409,239576,1000,1000,1000,3000,2000,1001,1.0,0.0
4841,199959,500,1500,500,2500,1000,501,3.0,0.0
48411,1882067,1000,30269,1000,32269,2000,1001,30.269,0.0
48413,216322,99,2175,99,2373,198,100,21.97,0.75
48414,573053,0,10000,0,11000,1000,1001,10.0,0.0
48415,2684638,1000,35060,1000,37060,2000,1001,35.06,0.6666666666666666
48416,239576,1000,1000,1000,3000,2000,1001,1.0,0.0
48417,42057,0,542,0,581,39,40,13.897,1.0
48419,1270116,1000,17813,1000,19813,2000,1001,17.813,0.0
4842,127298,188,1684,188,2060,376,189,8.957,0.0
48421,50425,61,226,61,455,229,139,3.705,0.0
48422,2432499,1000,39745,1000,41745,2000,1001,39.745,0.0
48423,2663285,0,35775,0,36775,1000,1001,35.775,0.0
48424,1299988,1000,13818,1000,15818,2000,1001,13.818,0.0
48425,2546162,0,61491,0,62491,1000,1001,61.491,0.0
48426,2411689,1000,45232,1000,47232,2000,1001,45.232,0.0
48428,1161334,0,20000,0,21000,1000,1001,20.0,0.0
48429,539172,1000,8000,1000,10002,2002,1003,8.0,0.0
48433,508210,0,7707,0,8092,385,386,20.018,0.0
48436,2082012,1000,28895,1000,31895,3000,1525,28.895,0.0
48443,7719984,0,246483,0,247483,1000,1001,246.483,0.0
48446,758992,0,12536,0,13536,1000,1001,12.536,0.0
48453,594892,0,9000,0,10000,1000,1001,9.0,0.0
48456,1416996,1000,21473,1000,24473,3000,1241,21.473,0.0
48458,1106933,0,8855,0,8893,38,39,233.026,0.0
48459,584774,0,4987,0,5987,1000,1001,4.987,0.0
4846,837979,925,11972,925,13822,1850,927,12.943,1.0
48461,235575,1000,1000,1000,3000,2000,1001,1.0,0.0
48462,1279098,1000,26753,1000,28753,2000,1001,26.753,0.0
48464,314882,113,2484,113,2710,226,114,21.982,1.0
48469,759577,1000,12540,1000,14540,2000,1001,12.54,0.0
48470,1336142,1000,15997,1000,17997,2000,1001,15.997,0.0
48471,706178,0,7986,0,8986,1000,1001,7.986,0.0
48475,556895,1000,6000,1000,8000,2000,1001,6.0,0.0
48476,115040,0,1392,0,1494,102,103,13.647,0.0
48478,486250,146,6575,146,6867,292,147,45.034,0.0
48479,1196531,1000,13222,1000,15222,2000,1001,13.222,0.0
4848,238740,500,3415,500,4415,1000,501,6.83,0.0
48480,765793,0,12422,0,13422,1000,1001,12.422,0.0
48483,525855,0,6870,0,7870,1000,1001,6.87,0.0
48485,425681,326,6138,326,6790,652,327,18.828,0.0
48486,1621849,1000,24901,1000,26901,2000,1001,24.901,0.0
48490,777035,0,12556,0,13556,1000,1001,12.556,0.0
48492,235575,1000,1000,1000,3000,2000,1001,1.0,0.0
48493,1400299,1000,24272,1000,26272,2000,1001,24.272,0.5
48494,5364417,880,130240,880,132000,1760,881,148.0,0.0
48499,838820,0,12814,0,13814,1000,1001,12.814,0.5
48500,1365066,1000,20590,1000,23590,3000,1319,20.59,0.0
48504,999,0,5,0,6,1,2,5.0,0.0
48506,1642433,1000,29511,1000,31511,2000,1001,29.511,0.5
48510,1467588,0,6714,0,6752,38,39,176.684,0.0
48522,1590170,1000,25000,1000,27000,2000,1001,25.0,0.0
48529,50090,0,440,0,451,11,12,40.0,0.5
48532,1467588,0,6714,0,6752,38,39,176.684,0.0
48539,798094,695,9494,695,10884,1390,696,13.66,0.0
48550,1281,0,11,0,12,1,2,11.0,0.0
4856,633569,970,8664,970,10604,1940,972,8.932,1.0
48565,235575,1000,1000,1000,3000,2000,1001,1.0,0.0
4857,791087,928,9494,928,11350,1856,930,10.231,0.0
4859,436426,500,4980,500,5980,1000,501,9.96,0.0
4860,534635,0,6846,0,7346,500,501,13.692,0.5
4861,413979,500,5000,500,6000,1000,501,10.0,0.0
4862,255593,500,3603,500,4603,1000,501,7.206,0.0
48620,1510147,1000,28721,1000,30721,2000,1002,28.721,1.0
48628,266099,191,3449,191,3831,382,192,18.058,0.0
48647,1708938,1000,30996,1000,32996,2000,1001,30.996,0.0
4865,676023,500,7769,500,8769,1000,501,15.538,0.0
48650,733208,1000,8840,1000,10840,2000,1001,8.84,0.0
48653,2913,0,38,0,41,3,4,12.667,0.0
48658,13323,0,117,0,156,39,40,3.0,1.0
4866,434937,500,7489,500,8489,1000,501,14.978,0.0
48660,1711243,1000,15748,1000,20748,5000,1726,15.748,0.0
48666,1077515,37,8621,37,8695,74,38,233.0,0.0
4867,353069,0,4500,0,5000,500,501,9.0,0.0
48675,63474,0,664,0,830,166,167,4.0,0.0
48676,69460,60,808,60,1044,236,176,13.467,0.0
4868,697470,500,7500,500,8500,1000,501,15.0,0.0
48680,1149867,0,13963,0,14963,1000,1001,13.963,0.0
48682,3026873,0,40666,0,41666,1000,1001,40.666,0.5
48697,404874,335,5934,335,6604,670,336,17.713,0.0
4870,556252,0,7610,0,8110,500,501,15.22,0.0
48702,2430006,1000,34917,1000,36917,2000,1001,34.917,0.0
48703,1287571,1000,21528,1000,23528,2000,1001,21.528,0.0
48705,564639,0,9937,0,10932,995,996,9.987,0.5
48707,1224746,1000,19391,1000,23471,4080,3082,19.391,0.5
48708,1510620,1000,25927,1000,27927,2000,1001,25.927,0.5
4871,613920,0,9960,0,10460,500,501,19.92,0.0
48713,554469,0,4989,0,5989,1000,1001,4.989,0.0
48715,128292,0,2049,0,2218,169,170,12.124,0.0
48717,314882,113,2484,113,2710,226,114,21.982,1.0
4872,471603,0,7716,0,8216,500,501,15.432,0.0
48720,141316,0,2166,0,2385,219,220,9.89,0.0
48725,309826,0,4959,0,5374,415,416,11.949,0.0
48727,29310,0,350,0,375,25,26,14.0,0.0
4873,75524,0,1225,0,1345,120,121,10.208,0.0
48731,43938,137,274,137,548,274,138,2.0,0.5
48732,8525568,492,94512,492,95496,984,493,192.098,0.0
48735,3696,0,50,0,54,4,5,12.5,0.0
48737,85827,0,1004,0,1106,102,103,9.843,0.0
4874,7632,16,80,16,112,32,17,5.0,0.0
48740,232735,256,3805,256,4573,768,482,14.863,0.0
48742,1783566,1000,32364,1000,34364,2000,1001,32.364,0.5
48744,113236,0,1645,0,1835,190,191,8.658,0.0
48745,1791046,1000,32483,1000,34483,2000,1001,32.483,0.0
48748,1323802,1000,21643,1000,23643,2000,1002,21.643,0.5
4875,159144,156,2652,156,2964,312,157,17.0,0.0
48750,1829280,1000,32684,1000,34684,2000,1001,32.684,0.0
48758,1379076,1000,23679,1000,25679,2000,1001,23.679,0.0
48763,1594590,1000,24473,1000,26473,2000,1001,24.473,0.0
48769,12567,0,191,0,207,16,17,11.938,0.0
4877,655301,500,4667,500,5667,1000,501,9.334,0.0
48771,103567,0,1350,0,1485,135,136,10.0,0.9
48773,11672,0,105,0,140,35,36,3.0,0.0
48776,70448,117,1247,117,1481,234,118,10.658,0.0
48779,2283237,1000,39559,1000,41559,2000,1001,39.559,0.0
4878,451967,500,6000,500,7000,1000,501,12.0,0.0
48785,1772546,1000,29000,1000,31000,2000,1001,29.0,0.0
48786,775856,1000,11719,1000,13789,2070,1031,11.719,0.5
48788,38599,0,608,0,655,47,48,12.936,0.0
4879,194457,500,2500,500,3500,1000,501,5.0,0.0
48792,3606,0,48,0,52,4,5,12.0,0.0
48798,239576,1000,1000,1000,3000,2000,1001,1.0,0.0
48799,2212,5,15,5,25,10,6,3.0,0.0
48804,1169689,523,20502,523,21548,1046,524,39.201,0.0
4881,199421,500,2500,500,3500,1000,501,5.0,0.0
4882,408261,500,6000,500,7000,1000,501,12.0,0.5
4883,84589,120,1080,120,1320,240,121,9.0,0.5
48830,2333389,0,37812,0,38812,1000,1001,37.812,0.0
48832,1515041,1000,27133,1000,29133,2000,1001,27.133,0.5
4884,544776,0,7426,0,8223,797,795,14.852,0.0
48848,2759141,1000,37000,1000,39000,2000,1001,37.0,0.5
4887,208098,500,3000,500,4000,1000,501,6.0,0.0
48870,2265988,1000,39167,1000,41167,2000,1001,39.167,0.0
48871,1271519,729,22020,729,23478,1458,730,30.206,0.0
48875,1999,0,16,0,20,4,5,4.0,0.0
4888,207332,500,3000,500,4000,1000,501,6.0,0.0
48884,3080080,1000,40998,1000,42998,2000,1001,40.998,0.5
48889,686403,0,8577,0,9577,1000,1001,8.577,0.0
4889,1419867,995,12464,995,14454,1990,997,12.527,0.0
48897,2122,0,25,0,27,2,3,12.5,0.0
48915,29990,0,234,0,235,1,2,234.0,0.0
48919,239576,1000,1000,1000,3000,2000,1001,1.0,0.0
48922,4590,0,40,0,50,10,11,4.0,0.0
48928,1229351,0,12984,0,13984,1000,1001,12.984,0.0
4893,296717,500,4500,500,5500,1000,501,9.0,1.0
48932,13729,0,200,0,210,10,11,20.0,0.0
48934,2479,0,36,0,40,4,5,9.0,0.0
4894,297547,500,5000,500,6000,1000,501,10.0,0.0
48942,59560,251,251,251,753,502,252,1.0,0.0
48946,522659,1000,5989,1000,7989,2000,1001,5.989,0.0
4895,292228,500,5000,500,6000,1000,501,10.0,0.0
48953,1942,0,16,0,20,4,5,4.0,0.0
48955,1365,0,13,0,14,1,2,13.0,0.0
4896,1220460,907,11942,907,13756,1814,909,13.166,0.0
48961,781260,0,12401,0,13401,1000,1001,12.401,0.0
48963,210481,0,2076,0,2175,99,100,20.97,0.6666666666666666
48969,724460,1000,10941,1000,12941,2000,1001,10.941,0.0
4897,885059,925,11988,925,13838,1850,927,12.96,1.0
48975,33091,0,491,0,515,24,25,20.458,0.0
48978,1326,0,12,0,13,1,2,12.0,0.0
4898,325603,500,5000,500,6000,1000,501,10.0,0.0
48983,1363,0,13,0,14,1,2,13.0,0.0
48984,2774938,0,40028,0,41028,1000,1001,40.028,0.0
4899,279824,500,4500,500,5500,1000,501,9.0,0.0
48990,227121,585,2339,585,3509,1170,586,3.998,0.0
48993,308734,0,4858,0,5283,425,426,11.431,0.0
48996,454241,1000,4995,1000,6995,2000,1001,4.995,0.5
49,608216,1086,3673,1086,5821,2148,1088,3.382,0.0
4900,292397,500,5000,500,6000,1000,501,10.0,0.0
49000,6543,0,96,0,104,8,9,12.0,0.0
49009,29400,0,264,0,396,132,102,8.0,0.0
49010,1045,2,2,2,6,4,3,1.0,0.0
49012,186850,282,2967,282,3531,564,283,10.521,0.0
49019,720812,0,9930,0,10930,1000,1001,9.93,0.0
4902,1096558,500,10500,500,11500,1000,501,21.0,0.0
49026,5430658,1000,52242,1000,54242,2000,1001,52.242,0.0
4903,273543,500,4500,500,5500,1000,501,9.0,0.0
49032,882695,480,11499,480,12459,960,481,23.956,0.0
49037,1547533,1000,24670,1000,26670,2000,1001,24.67,0.0
4904,375763,500,5000,500,6000,1000,501,10.0,0.0
49043,1951,0,16,0,20,4,5,4.0,0.0
4905,549894,500,7000,500,8000,1000,501,14.0,0.0
49050,5950,0,72,0,84,12,13,6.0,0.0
49059,286063,0,4624,0,4983,359,360,12.88,0.0
4906,379282,500,6500,500,7500,1000,501,13.0,0.5
49061,2463550,1000,45899,1000,47899,2000,1001,45.899,0.0
49065,1100701,0,8634,0,9028,394,395,21.914,0.0
49073,1424,0,12,0,14,2,3,6.0,0.0
49074,2992,0,33,0,37,4,5,8.25,0.0
49078,360058,0,4000,0,5000,1000,1001,4.0,0.0
4908,534600,500,8771,500,9771,1000,501,17.542,0.0
49081,10461,17,85,17,153,68,53,2.5,0.0
49082,1187504,1000,20276,1000,22276,2000,1001,20.276,0.0
49085,323888,181,5617,181,5979,362,182,31.033,0.0
49089,1962,0,16,0,20,4,5,4.0,0.0
49090,77525,62,992,62,1116,124,63,16.0,0.0
49096,1900,2,10,2,14,4,3,5.0,0.0
4910,88843,0,1140,0,1330,190,191,6.0,0.0
49102,1366,0,13,0,14,1,2,13.0,0.0
49103,35627,27,512,27,566,54,28,18.963,0.0
49104,8076,0,96,0,119,23,24,8.0,0.0
4911,187628,0,2494,0,2994,500,501,4.988,0.5
49110,286063,0,4624,0,4983,359,360,12.88,0.0
49111,235576,0,1000,0,2000,1000,1001,1.0,0.0
49118,177539,354,2742,354,3450,708,355,7.746,0.0
4912,204659,0,2774,0,3244,470,471,5.902,0.5
49120,1933,0,21,0,23,2,3,10.5,0.0
49121,48362,142,425,142,709,284,143,2.993,0.5
49123,1969,0,16,0,20,4,5,4.0,0.0
49124,239576,1000,1000,1000,3000,2000,1001,1.0,0.0
49125,1366,0,13,0,14,1,2,13.0,0.0
49127,352522,1000,4000,1000,6000,2000,1001,4.0,0.0
49128,551342,1000,8177,1000,10177,2000,1001,8.177,0.0
4913,330851,0,5000,0,5500,500,501,10.0,0.5
49131,235575,1000,1000,1000,3000,2000,1001,1.0,0.0
49134,797420,1000,14000,1000,16000,2000,1001,14.0,0.0
49136,105928,108,1728,108,1944,216,109,16.0,0.0
49137,328703,120,4104,120,4344,240,121,34.2,0.0
49138,1171024,1000,18329,1000,20329,2000,1001,18.329,0.0
49139,7476,5,65,5,75,10,6,13.0,0.0
4914,189357,500,2494,500,3494,1000,501,4.988,0.75
49140,235575,1000,1000,1000,3000,2000,1001,1.0,0.0
49142,61418,100,894,100,1094,200,101,8.94,0.0
49143,16296,0,192,0,240,48,49,4.0,1.0
49146,368786,1000,5000,1000,7000,2000,1001,5.0,0.0
49149,1537091,1000,24520,1000,26520,2000,1001,24.52,0.0
4915,47474,0,550,0,660,110,111,5.0,0.0
49151,10680,43,43,43,129,86,44,1.0,0.0
49154,796530,1000,11000,1000,13000,2000,1001,11.0,0.0
49156,727095,1000,11000,1000,13000,2000,1001,11.0,0.0
4916,244103,0,3500,0,4000,500,501,7.0,0.0
49162,302610,372,5206,372,5950,744,373,13.995,0.0
49164,1856,4,12,4,20,8,5,3.0,0.0
49165,4058,0,54,0,60,6,7,9.0,0.0
49167,531180,240,4506,240,4986,480,241,18.775,0.0
4917,80256,0,920,0,1150,230,231,4.0,0.0
49170,1376,0,13,0,14,1,2,13.0,0.0
49172,29361,0,350,0,375,25,26,14.0,0.0
49175,1330,0,12,0,13,1,2,12.0,0.0
49176,1888,4,12,4,20,8,5,3.0,0.0
49177,2836,0,36,0,39,3,4,12.0,0.0
49179,847454,1000,10992,1000,12992,2000,1001,10.992,0.0
4918,166517,0,1876,0,2345,469,470,4.0,0.0
49182,24453,0,452,0,491,39,40,11.59,0.0
4919,70850,0,792,0,990,198,199,4.0,0.0
49194,2863,0,37,0,40,3,4,12.333,0.0
49197,224276,135,3936,135,4206,270,136,29.156,0.0
49198,890102,474,15889,474,16837,948,475,33.521,0.0
4920,68217,0,792,0,990,198,199,4.0,0.0
49205,754626,1000,11670,1000,13670,2000,1001,11.67,0.5
49206,2134,0,25,0,27,2,3,12.5,0.0
4921,88147,0,1140,0,1330,190,191,6.0,0.0
49212,157679,97,2755,97,2949,194,98,28.402,0.0
49218,4556,0,64,0,69,5,6,12.8,0.0
4922,512672,500,7288,500,8288,1000,501,14.576,0.0
49221,2531875,1000,22847,1000,25847,3000,1011,22.847,1.0
49223,135306,74,2405,74,2553,148,75,32.5,0.0
49225,328222,120,4104,120,4344,240,121,34.2,0.0
4923,305097,0,4500,0,5000,500,501,9.0,0.0
49230,145477,111,1491,111,1713,222,112,13.432,0.0
49235,233575,0,1000,0,2000,1000,1001,1.0,0.0
49239,2445,0,20,0,25,5,6,4.0,0.0
4924,292070,0,4000,0,4500,500,501,8.0,0.0
49245,2495,0,20,0,25,5,6,4.0,0.0
4925,693013,0,9495,0,9995,500,501,18.99,0.0
49256,1372,0,13,0,14,1,2,13.0,0.0
4926,191539,0,2000,0,2500,500,501,4.0,0.0
49262,2977,0,39,0,42,3,4,13.0,0.0
49263,2498,2,16,2,24,8,6,8.0,0.0
49264,1876,4,12,4,20,8,5,3.0,0.0
49267,66219,144,719,144,1007,288,145,4.993,0.5
49269,1876,4,12,4,20,8,5,3.0,0.0
4927,65620,0,812,0,963,151,152,5.377,0.0
49273,2116,0,25,0,27,2,3,12.5,0.0
49277,39533,120,360,120,600,240,121,3.0,0.0
49279,2548,0,20,0,25,5,6,4.0,0.0
49280,12240,39,117,39,195,78,40,3.0,1.0
49281,18746,18,126,18,213,87,69,7.0,0.0
49285,155037,120,2220,120,2460,240,121,18.5,0.0
4929,180230,0,2472,0,2972,500,501,4.944,0.0
49290,182095,476,1828,476,2780,952,477,3.84,0.0
49293,713934,1000,13000,1000,15000,2000,1001,13.0,0.0
49297,796933,1000,14000,1000,16000,2000,1001,14.0,0.0
4930,59022,0,672,0,840,168,169,4.0,0.0
49302,1367,0,13,0,14,1,2,13.0,0.0
49305,1340,0,12,0,13,1,2,12.0,0.0
49309,2106,0,25,0,27,2,3,12.5,0.0
4931,174556,0,2000,0,2500,500,501,4.0,1.0
49312,35627,27,512,27,566,54,28,18.963,0.0
49319,235575,1000,1000,1000,3000,2000,1001,1.0,0.0
4932,275231,0,4500,0,5000,500,501,9.0,0.0
49321,73042,26,910,26,962,52,27,35.0,0.0
49326,2713573,1000,39156,1000,41156,2000,1001,39.156,0.0
49329,10495,34,85,34,170,85,53,2.5,0.5
4933,426372,0,6990,0,7490,500,501,13.98,0.75
49331,235575,1000,1000,1000,3000,2000,1001,1.0,0.0
49338,1831997,1000,28991,1000,31991,3000,2000,28.991,0.0
4934,730304,500,9960,500,10960,1000,501,19.92,0.0
49341,2356,0,18,0,27,9,8,9.0,0.0
49347,2538652,1000,38787,1000,40787,2000,1001,38.787,0.5
49349,18710,0,126,0,195,69,69,7.0,0.0
4935,633487,500,8500,500,9500,1000,501,17.0,0.0
49356,5561,12,48,12,72,24,13,4.0,0.0
49359,56555,20,699,20,739,40,21,34.95,0.0
4936,292353,500,5000,500,6000,1000,501,10.0,0.0
49360,270044,121,2205,121,2447,242,122,18.223,0.5
49362,186657,362,2931,362,3655,724,363,8.097,0.0
4937,292368,500,5000,500,6000,1000,501,10.0,0.0
49377,142872,79,2519,79,2677,158,80,31.886,0.0
4938,292005,500,5000,500,6000,1000,501,10.0,1.0
49387,57463,46,736,46,828,92,47,16.0,0.0
49388,25683,0,400,0,434,34,35,11.765,0.0
4939,290350,500,5000,500,6000,1000,501,10.0,0.0
49390,442963,255,7661,255,8171,510,256,30.043,0.0
49393,11058,12,72,12,120,48,36,6.0,0.0
49397,60463,62,868,62,992,124,63,14.0,0.0
4940,479242,500,5808,500,6808,1000,502,11.616,0.0
4941,367096,500,4929,500,5929,1000,502,9.858,0.5
49416,8215,12,132,12,156,24,13,11.0,0.0
4942,784685,500,17000,500,18000,1000,502,34.0,0.0
4943,1648,3,9,3,15,6,5,3.0,0.0
49432,607693,1000,8000,1000,10000,2000,1001,8.0,0.0
4944,370198,500,4919,500,5919,1000,502,9.838,0.0
49445,11484,13,77,13,127,50,37,5.923,0.0
49448,355826,1000,2924,1000,4924,2000,1001,2.924,0.0
4945,451946,500,7000,500,8000,1000,502,14.0,0.0
49450,9699,0,98,0,121,23,24,4.261,0.0
49454,235576,0,1000,0,2000,1000,1001,1.0,0.0
4946,4191,8,40,8,56,16,10,5.0,0.0
49460,1327,0,12,0,13,1,2,12.0,0.0
49465,1319728,1000,22184,1000,24184,2000,1001,22.184,0.0
4947,6391,8,80,8,96,16,10,10.0,0.0
49471,683431,405,12354,405,13164,810,406,30.504,0.0
49477,1999,0,16,0,20,4,5,4.0,0.0
49479,646597,1000,8000,1000,10000,2000,1001,8.0,0.0
4948,274500,228,3746,228,4470,724,498,7.552,0.0
49481,14608,0,222,0,238,16,17,13.875,0.0
49486,671552,1000,10950,1000,12950,2000,1001,10.95,0.0
4949,692683,985,8728,985,10698,1970,987,8.861,0.0
49492,6509,0,94,0,101,7,8,13.429,0.0
4950,1073559,985,10726,985,12696,1970,987,10.889,0.0
49503,4165,12,36,12,60,24,13,3.0,0.0
4951,441122,500,6500,500,7500,1000,502,13.0,0.0
49510,1196987,1000,18000,1000,20000,2000,1001,18.0,0.0
4952,397767,437,5681,437,6555,874,439,13.0,0.0
4953,401567,437,5670,437,6544,874,439,12.975,0.5
4954,44609,59,531,59,649,118,61,9.0,0.5
49545,2448,1,34,1,36,2,2,34.0,0.0
4955,4915,6,60,6,72,12,8,10.0,0.5
4956,4037,11,33,11,55,22,13,3.0,0.0
49564,458402,574,6888,574,8036,1148,575,12.0,0.0
4957,2262,4,16,4,24,8,6,4.0,0.0
4958,30042,40,445,40,525,80,42,11.125,0.0
4960,114929,139,1740,139,2018,278,141,12.518,0.5
49607,1001,1,5,1,7,2,2,5.0,0.0
4961,431475,500,6500,500,7500,1000,502,13.0,0.0
49623,70612,84,822,84,990,168,85,9.786,0.0
49624,1428,2,12,2,16,4,3,6.0,0.0
49626,6933,23,46,23,92,46,24,2.0,0.0
49628,19700,0,288,0,312,24,25,12.0,0.0
49630,801937,1000,11000,1000,13000,2000,1001,11.0,0.0
4964,353314,500,4921,500,5921,1000,502,9.842,0.5
49643,11107,12,72,12,120,48,36,6.0,0.0
49644,12795,52,52,52,156,104,53,1.0,0.0
49645,10985,0,156,0,169,13,14,12.0,0.0
49648,1436,2,12,2,16,4,3,6.0,0.0
4965,229324,446,2651,446,3543,892,448,5.944,0.0
49654,4117,11,33,11,55,22,12,3.0,0.0
49658,25697,72,274,72,418,144,73,3.806,0.0
4966,66153,138,1235,138,1511,276,140,8.949,0.0
49663,394831,574,5740,574,6888,1148,575,10.0,0.0
49666,3395,12,12,12,36,24,13,1.0,0.5
49667,1257317,1000,17531,1000,19531,2000,1001,17.531,0.0
49668,10363,14,84,14,112,28,15,6.0,0.0
4968,459200,500,7000,500,8000,1000,502,14.0,0.0
49680,579652,1000,8000,1000,10000,2000,1001,8.0,0.0
49682,235575,1000,1000,1000,3000,2000,1001,1.0,0.0
49687,7392,0,66,0,77,11,12,6.0,0.0
4969,70030,141,1268,141,1550,282,143,8.993,0.5
49692,14037,14,166,14,208,42,29,11.857,0.0
49693,15849,0,224,0,241,17,18,13.176,0.0
49695,18732,0,278,0,299,21,22,13.238,0.0
49696,6822,0,96,0,104,8,9,12.0,0.0
49697,30518,101,303,101,505,202,102,3.0,0.0
49698,11771,12,120,12,144,24,13,10.0,0.5
49699,2500243,0,24904,0,25904,1000,1001,24.904,0.0
4970,647826,500,9500,500,10500,1000,502,19.0,0.0
49707,2739444,1000,46656,1000,48656,2000,1001,46.656,0.0
49708,663308,1000,9750,1000,11750,2000,1001,9.75,0.0
4971,383026,500,4920,500,5920,1000,502,9.84,0.5
49712,17436,20,216,20,276,60,41,10.8,0.0
49714,8250,20,80,20,120,40,21,4.0,0.0
49716,511961,1000,10000,1000,12000,2000,1001,10.0,0.0
49718,767614,1000,13000,1000,15000,2000,1001,13.0,1.0
49719,4189,6,30,6,42,12,7,5.0,0.0
49720,50273,96,768,96,960,192,97,8.0,0.5
49722,1042467,1000,16000,1000,18000,2000,1001,16.0,0.0
49724,404288,638,5742,638,7018,1276,639,9.0,0.0
49725,139063,147,1756,147,2050,294,148,11.946,0.0
49726,704528,1000,19000,1000,21000,2000,1001,19.0,0.0
49727,1424554,1000,25983,1000,27983,2000,1001,25.983,0.0
49728,239576,1000,1000,1000,3000,2000,1001,1.0,0.0
49729,56237,59,702,59,879,177,119,11.898,0.0
4973,142839,139,2194,139,2472,278,141,15.784,0.0
49730,1657517,1000,25821,1000,27821,2000,1001,25.821,0.75
49735,17080,0,252,0,273,21,22,12.0,0.0
49738,969125,1000,11943,1000,13943,2000,1001,11.943,1.0
4974,5542,7,70,7,84,14,9,10.0,0.0
49740,239576,1000,1000,1000,3000,2000,1001,1.0,0.0
49742,235575,1000,1000,1000,3000,2000,1001,1.0,0.0
49744,2766340,1000,47460,1000,49460,2000,1001,47.46,0.0
49745,7223,12,102,12,126,24,13,8.5,0.0
49750,13004,52,52,52,156,104,53,1.0,0.0
49752,15254,40,160,40,240,80,41,4.0,1.0
49753,3370250,1000,58116,1000,60116,2000,1001,58.116,0.0
49754,1269846,1000,22109,1000,24109,2000,1001,22.109,0.0
49756,235575,1000,1000,1000,3000,2000,1001,1.0,0.0
49757,669996,1000,8835,1000,10835,2000,1001,8.835,0.0
49760,3720,0,48,0,52,4,5,12.0,0.0
49763,4276,0,48,0,51,3,4,16.0,0.0
49764,2233316,1000,42000,1000,44000,2000,1001,42.0,0.0
49766,235575,1000,1000,1000,3000,2000,1001,1.0,0.0
49767,253742,492,3250,492,4234,984,493,6.606,0.0
49768,355778,1000,4000,1000,6000,2000,1001,4.0,0.0
49769,10934,0,156,0,169,13,14,12.0,0.0
4977,62240,103,1028,103,1234,206,105,9.981,0.0
49770,496677,1000,6848,1000,8848,2000,1001,6.848,0.0
49771,1831305,1000,31414,1000,33414,2000,1001,31.414,0.0
49772,2367893,1000,43894,1000,45894,2000,1001,43.894,0.0
49773,239576,1000,1000,1000,3000,2000,1001,1.0,0.0
49774,44400,166,332,166,664,332,167,2.0,0.0
49776,13036,0,186,0,200,14,15,13.286,0.0
49777,1625299,1000,24939,1000,26939,2000,1001,24.939,0.0
49778,403341,1000,5996,1000,7996,2000,1001,5.996,0.0
49779,21329245,1000,120000,1000,122000,2000,1001,120.0,0.0
49784,524342,921,7131,921,8973,1842,922,7.743,0.0
49788,5452,0,72,0,78,6,7,12.0,0.0
4979,21440,47,229,47,323,94,49,4.872,0.5
49790,16560,0,252,0,270,18,19,14.0,0.0
49791,3720,0,48,0,52,4,5,12.0,0.0
49792,2745914,1000,46702,1000,48702,2000,1001,46.702,0.0
49795,239576,1000,1000,1000,3000,2000,1001,1.0,0.0
49796,235575,1000,1000,1000,3000,2000,1001,1.0,0.0
49797,11849,0,173,0,186,13,14,13.308,0.0
49799,1647192,1000,24994,1000,26994,2000,1001,24.994,0.0
4980,297410,500,4000,500,5000,1000,502,8.0,0.5
49800,4714,3,69,3,75,6,4,23.0,0.0
49805,577032,1000,6899,1000,8899,2000,1001,6.899,0.0
49806,3395,12,12,12,36,24,13,1.0,0.5
49808,18673,0,282,0,303,21,22,13.429,0.0
49809,845205,1000,12000,1000,14000,2000,1001,12.0,0.0
4981,44784,59,530,59,648,118,61,8.983,0.5
49813,4384,11,33,11,55,22,12,3.0,0.0
49814,458272,1000,6000,1000,8000,2000,1001,6.0,0.0
49817,15684,0,180,0,210,30,31,12.0,0.0
49818,1292132,1000,17978,1000,19978,2000,1001,17.978,0.0
49822,2111827,1000,36478,1000,38478,2000,1001,36.478,0.0
49824,17264,0,252,0,273,21,22,12.0,0.0
49826,7731,12,118,12,142,24,13,9.833,0.0
4983,3513,4,40,4,48,8,6,10.0,0.0
49834,16644,0,252,0,270,18,19,14.0,0.0
49838,12681,30,120,30,180,60,31,4.0,0.0
49839,51668,39,1014,39,1092,78,40,26.0,0.0
49840,18690,0,280,0,301,21,22,13.333,0.0
49849,407960,1000,5831,1000,7831,2000,1001,5.831,0.0
4985,22615,19,271,19,349,78,47,14.263,0.0
49855,14744,0,222,0,238,16,17,13.875,0.0
49856,1773290,1000,29980,1000,31980,2000,1001,29.98,0.0
49857,38712,0,604,0,648,44,45,13.727,0.0
49865,1228199,1000,20274,1000,22274,2000,1001,20.274,0.0
4987,331039,500,4500,500,5500,1000,501,9.0,0.0
49877,15715,0,180,0,210,30,31,12.0,0.0
49882,13037,0,192,0,208,16,17,12.0,0.0
49888,13122,0,192,0,208,16,17,12.0,0.0
4989,314507,0,3772,0,4272,500,501,7.544,0.5
4990,2952049,1320,54158,1320,57298,3140,1822,29.757,0.5
49904,1215028,1000,16746,1000,18746,2000,1001,16.746,0.0
49908,10163,0,144,0,156,12,13,12.0,0.0
4991,1853486,500,44980,500,45980,1000,502,89.96,0.0
49910,1113503,1000,18374,1000,20374,2000,1001,18.374,0.0
49911,6025,12,72,12,96,24,13,6.0,0.0
49917,2174,4,16,4,24,8,5,4.0,0.0
49918,1548,1,21,1,23,2,2,21.0,0.0
49919,17065,0,252,0,270,18,19,14.0,0.0
4992,2896690,1000,54532,1000,57518,2986,1590,36.355,1.0
49920,79300,335,335,335,1005,670,336,1.0,0.0
49921,897546,1000,12000,1000,14000,2000,1001,12.0,0.0
49922,17312,0,252,0,273,21,22,12.0,0.0
49923,564339,1000,7000,1000,9000,2000,1001,7.0,0.0
49925,2652161,764,36659,764,38187,1528,765,47.983,0.0
49927,593179,1000,9000,1000,11000,2000,1001,9.0,0.0
49929,7870,8,104,8,120,16,9,13.0,0.0
49931,3835040,1000,66146,1000,68146,2000,1001,66.146,0.0
49933,6087,0,84,0,91,7,8,12.0,0.0
49935,12752,0,186,0,200,14,15,13.286,0.0
49936,19861,21,272,21,314,42,22,12.952,0.0
49937,1413418,1000,22575,1000,24575,2000,1001,22.575,0.0
49939,986844,1000,18053,1000,20053,2000,1001,18.053,0.5
4994,834487,1000,11280,1000,13280,2000,1002,11.28,0.5
49940,191164,281,3653,281,4215,562,282,13.0,0.0
49941,6166,0,83,0,90,7,8,11.857,0.0
49943,3160,11,11,11,33,22,12,1.0,0.0
49944,199176,223,2918,223,3364,446,224,13.085,0.0
49945,235575,1000,1000,1000,3000,2000,1001,1.0,0.0
49946,1415281,1000,16512,1000,18512,2000,1001,16.512,0.0
49947,7595,0,108,0,117,9,10,12.0,0.0
49948,312575,1000,3000,1000,5000,2000,1001,3.0,0.0
49949,1409469,1000,23000,1000,25000,2000,1001,23.0,0.0
4995,948105,909,11954,909,13772,1818,911,13.151,0.5
49950,897669,1000,12000,1000,14000,2000,1001,12.0,0.0
49951,3485472,1000,59802,1000,61802,2000,1001,59.802,0.0
49952,9228674,1000,228999,1000,230999,2000,1001,228.999,0.0
49953,775946,1000,10000,1000,12000,2000,1001,10.0,0.0
49954,2367841,1000,43892,1000,45892,2000,1001,43.892,0.0
49955,789628,1000,11000,1000,13000,2000,1001,11.0,0.0
4996,1089896,970,10666,970,12606,1940,972,10.996,0.0
49961,105835,148,1480,148,1776,296,149,10.0,0.0
4997,1052693,1025,10994,1025,13044,2050,1027,10.726,0.0
49971,10926,0,156,0,169,13,14,12.0,0.0
49974,2254734,1000,37958,1000,39958,2000,1001,37.958,0.0
49975,48644,142,425,142,709,284,143,2.993,0.5
49977,1532,4,4,4,12,8,5,1.0,0.0
49978,1675278,1000,24737,1000,26737,2000,1001,24.737,0.0
4998,1287136,985,8710,985,10680,1970,987,8.843,0.0
49980,235575,1000,1000,1000,3000,2000,1001,1.0,0.0
49984,68809,134,804,134,1072,268,135,6.0,1.0
49987,218333,197,3593,197,3987,394,198,18.239,0.0
49989,947253,1000,16276,1000,18276,2000,1001,16.276,0.0
4999,788367,985,10730,985,12700,1970,987,10.893,1.0
49994,235575,1000,1000,1000,3000,2000,1001,1.0,0.0
49995,834791,1000,13846,1000,15846,2000,1001,13.846,0.0
49996,408831,705,5480,705,6890,1410,706,7.773,0.0
49997,6008,0,84,0,91,7,8,12.0,0.0
49999,2123648,1000,34998,1000,36998,2000,1001,34.998,0.0
50,2132795,2358,8788,2358,14586,5798,4525,3.727,0.0
5000,1110228,912,11972,912,13796,1824,914,13.127,0.0
50001,897364,1000,15312,1000,17312,2000,1001,15.312,0.0
50002,1646208,1000,29000,1000,31000,2000,1001,29.0,0.0
50004,15775,15,180,15,225,45,31,12.0,0.0
50005,68943,105,945,105,1155,210,106,9.0,0.0
5001,980646,910,9460,910,11280,1820,912,10.396,0.0
50012,69900,295,295,295,885,590,296,1.0,0.0
50015,152417,168,2480,168,2816,336,169,14.762,0.0
50018,1666725,1000,27996,1000,29996,2000,1001,27.996,0.0
5002,820258,985,8724,985,10694,1970,987,8.857,0.0
50022,843889,1000,11000,1000,13000,2000,1001,11.0,0.0
50023,15394,62,62,62,186,124,63,1.0,0.0
50024,862020,1000,12000,1000,14000,2000,1001,12.0,0.0
50025,11041,0,155,0,168,13,14,11.923,0.0
50026,3519045,1000,48864,1000,50864,2000,1001,48.864,0.0
50027,728182,281,12115,281,12677,562,282,43.114,0.0
50029,731540,280,12165,280,12725,560,281,43.446,0.0
5003,894000,985,8726,985,10696,1970,987,8.859,0.0
50030,2551088,1000,43284,1000,45284,2000,1001,43.284,0.0
50035,857722,502,13940,502,14944,1004,503,27.769,0.0
50036,1340568,917,21091,917,22925,1834,918,23.0,0.0
5004,1043849,985,8730,985,10700,1970,987,8.863,0.0
50042,1660022,1000,28000,1000,30000,2000,1001,28.0,0.0
50044,235575,1000,1000,1000,3000,2000,1001,1.0,0.0
50045,10309,7,147,7,161,14,8,21.0,0.0
50048,1701,1,18,1,20,2,2,18.0,0.0
5005,892673,985,8710,985,10680,1970,987,8.843,0.0
50050,1574309,1000,26000,1000,28000,2000,1001,26.0,0.0
50060,780638,1000,11601,1000,13601,2000,1001,11.601,0.0
50061,3568682,1000,55618,1000,57618,2000,1001,55.618,0.0
50064,1953137,1000,32000,1000,34000,2000,1001,32.0,0.0
50065,3608838,1000,62384,1000,64384,2000,1001,62.384,0.0
50066,39984,13,676,13,702,26,14,52.0,0.0
50067,1041749,1000,16000,1000,18000,2000,1001,16.0,0.0
50070,3787083,1000,65140,1000,67140,2000,1001,65.14,0.0
50071,29883,7,492,7,506,14,8,70.286,0.0
50072,1467517,1000,23886,1000,25886,2000,1001,23.886,0.0
50074,146109,297,1908,297,2502,594,298,6.424,0.0
50075,1784404,1000,29533,1000,31533,2000,1001,29.533,0.0
50076,419354,105,7107,105,7317,210,106,67.686,0.0
50077,2700300,1000,46194,1000,48194,2000,1001,46.194,0.0
50079,1409773,1000,23000,1000,25000,2000,1001,23.0,0.0
50081,46870,197,197,197,591,394,198,1.0,0.0
50082,10876,16,128,16,160,32,17,8.0,0.0
50083,3013254,1000,51056,1000,53056,2000,1001,51.056,0.0
50087,1771,5,5,5,15,10,6,1.0,0.0
50088,445566,1000,5000,1000,7000,2000,1001,5.0,0.0
50089,1043336,1000,19885,1000,21885,2000,1001,19.885,0.0
50091,7470,12,84,12,119,35,24,7.0,0.0
50092,2633,5,15,5,25,10,6,3.0,0.0
50093,1413509,1000,23000,1000,25000,2000,1001,23.0,0.0
50094,658360,1000,8730,1000,10730,2000,1001,8.73,0.0
50096,2721113,1000,46317,1000,48317,2000,1001,46.317,0.0
50098,1620169,1000,28000,1000,30000,2000,1001,28.0,0.0
50100,651575,1000,8601,1000,10601,2000,1001,8.601,0.0
50101,1750,5,5,5,15,10,6,1.0,0.0
50103,1685,1,18,1,20,2,2,18.0,0.0
50104,3547444,1000,61326,1000,63326,2000,1001,61.326,0.0
50106,876861,1000,14828,1000,16828,2000,1001,14.828,0.0
50107,28436,7,468,7,482,14,8,66.857,0.0
50111,2029,4,16,4,24,8,5,4.0,0.0
50113,4050,2,54,2,58,4,3,27.0,0.0
50116,46870,197,197,197,591,394,198,1.0,0.0
50119,56814,0,826,0,885,59,60,14.0,0.0
5012,292070,0,4000,0,4500,500,501,8.0,0.0
50122,2686203,1000,41993,1000,43993,2000,1001,41.993,0.0
50125,646759,1000,9446,1000,11446,2000,1001,9.446,0.0
50126,1245115,951,19971,951,21873,1902,952,21.0,0.0
50127,1578528,1000,26962,1000,28962,2000,1001,26.962,0.0
5013,330851,0,5000,0,5500,500,501,10.0,0.5
50136,85464,127,1016,127,1270,254,128,8.0,0.0
50139,1065,1,4,1,7,3,3,4.0,0.0
5014,189357,500,2494,500,3494,1000,501,4.988,0.5
50141,1887,3,12,3,18,6,4,4.0,0.0
50144,5838,13,65,13,91,26,14,5.0,0.0
50145,3681,5,30,5,40,10,6,6.0,0.0
50146,146956,298,1926,298,2522,596,299,6.463,0.0
50147,16978,5,269,5,279,10,6,53.8,0.0
50148,2705179,1000,45803,1000,47803,2000,1001,45.803,0.0
50149,71328,147,659,147,953,294,148,4.483,1.0
5015,730304,500,9960,500,10960,1000,501,19.92,0.0
50150,983118,1000,16770,1000,18770,2000,1001,16.77,0.0
50151,1976818,1000,34397,1000,36397,2000,1001,34.397,0.0
50152,46870,197,197,197,591,394,198,1.0,0.0
50153,2301,5,20,5,30,10,6,4.0,0.0
50154,1453618,1000,23439,1000,25439,2000,1001,23.439,0.0
50155,1976818,1000,34397,1000,36397,2000,1001,34.397,0.0
50156,871205,1000,14298,1000,16298,2000,1001,14.298,0.0
50157,10941,16,128,16,160,32,17,8.0,0.0
50158,667091,1000,8875,1000,10875,2000,1001,8.875,0.0
50159,1703837,1000,26347,1000,28347,2000,1001,26.347,0.0
5016,274500,228,3746,228,4470,724,498,7.552,0.0
50160,3804183,1000,58732,1000,60732,2000,1001,58.732,0.0
50161,2050,5,15,5,25,10,6,3.0,0.0
50162,5980,23,23,23,69,46,24,1.0,0.0
50164,3450844,1000,59568,1000,61568,2000,1001,59.568,0.0
50165,142327,296,1776,296,2368,592,297,6.0,0.0
50166,572766,719,8699,719,10137,1438,720,12.099,0.0
50167,739003,719,11504,719,12942,1438,720,16.0,0.0
50168,1393117,1000,22914,1000,24914,2000,1001,22.914,0.0
50169,4161,15,15,15,45,30,16,1.0,0.0
5017,586610,461,8266,461,9688,1422,963,8.601,0.0
50170,10870,16,128,16,160,32,17,8.0,0.0
50171,928975,1000,14584,1000,16584,2000,1001,14.584,0.0
50172,1040038,1000,15842,1000,17842,2000,1001,15.842,0.0
50173,8379,23,69,23,115,46,24,3.0,0.0
50174,1666939,1000,25676,1000,27676,2000,1001,25.676,0.0
50175,1605186,1000,28000,1000,30000,2000,1001,28.0,0.0
50178,9516,21,105,21,147,42,22,5.0,0.0
50182,1853389,1000,31200,1000,33200,2000,1001,31.2,0.0
50183,1280128,1000,19694,1000,21694,2000,1001,19.694,0.0
50185,3526799,1000,61027,1000,63027,2000,1001,61.027,0.0
50186,862009,1000,12000,1000,14000,2000,1001,12.0,0.0
50187,11666,3,183,3,189,6,4,61.0,0.0
5019,187628,0,2494,0,2994,500,501,4.988,0.0
50192,418296,105,7095,105,7305,210,106,67.571,0.0
50196,214393,256,3072,256,3584,512,257,12.0,0.0
50199,49291,109,545,109,763,218,110,5.0,0.5
5020,65620,0,812,0,963,151,152,5.377,0.0
50205,400112,91,6781,91,6963,182,92,74.516,0.0
5021,191539,0,2000,0,2500,500,501,4.0,0.0
50217,2326494,1000,39305,1000,41305,2000,1001,39.305,0.0
5022,80256,0,920,0,1150,230,231,4.0,0.0
50222,2291482,1000,38985,1000,40985,2000,1001,38.985,0.0
50224,439371,105,7449,105,7659,210,106,70.943,0.0
50226,406464,296,6284,296,6876,592,297,21.23,0.0
5023,166517,0,1876,0,2345,469,470,4.0,0.0
5024,693013,0,9495,0,9995,500,501,18.99,0.0
50243,235575,1000,1000,1000,3000,2000,1001,1.0,0.0
50247,57296,32,896,32,960,64,33,28.0,0.0
5025,275231,0,4500,0,5000,500,501,9.0,0.0
50254,195541,65,3212,65,3342,130,66,49.415,0.0
50255,1103855,1000,17099,1000,19099,2000,1001,17.099,0.0
50256,381194,296,6051,296,6643,592,297,20.443,0.0
5026,59022,0,672,0,840,168,169,4.0,0.0
50261,1642006,1000,28000,1000,30000,2000,1001,28.0,0.0
50262,685695,1000,10405,1000,12405,2000,1001,10.405,0.0
50264,2071146,1000,35119,1000,37119,2000,1001,35.119,0.0
50265,239576,1000,1000,1000,3000,2000,1001,1.0,0.0
50267,2156290,1000,36662,1000,38662,2000,1001,36.662,0.0
50269,10338,12,168,12,192,24,13,14.0,0.0
5027,426372,0,6990,0,7490,500,501,13.98,0.75
50272,2395020,1000,40543,1000,42543,2000,1001,40.543,0.0
50275,1437378,1000,23166,1000,25166,2000,1001,23.166,0.0
5028,204659,0,2774,0,3244,470,471,5.902,0.5
50283,3117386,1000,52735,1000,54735,2000,1001,52.735,0.0
50287,142971,296,1804,296,2396,592,297,6.095,0.0
5029,305097,0,4500,0,5000,500,501,9.0,0.0
50292,667336,1000,10050,1000,12050,2000,1001,10.05,0.0
50295,80419,96,1404,96,1596,192,97,14.625,0.0
5030,174556,0,2000,0,2500,500,501,4.0,1.0
50309,214376,256,3072,256,3584,512,257,12.0,0.0
5031,47474,0,550,0,660,110,111,5.0,0.0
50311,762725,1000,11613,1000,13613,2000,1001,11.613,0.0
50315,80804,96,1404,96,1596,192,97,14.625,0.0
50316,155562,44,2573,44,2661,88,45,58.477,0.0
50317,52040,219,219,219,657,438,220,1.0,0.0
50319,3101107,1000,52998,1000,54998,2000,1001,52.998,0.0
50326,779873,1000,12632,1000,14632,2000,1001,12.632,0.0
5033,88843,0,1140,0,1330,190,191,6.0,0.0
50339,989775,1000,16859,1000,18859,2000,1001,16.859,0.0
5034,70850,0,792,0,990,198,199,4.0,0.0
5035,68217,0,792,0,990,198,199,4.0,0.0
50357,1833844,1000,31998,1000,33998,2000,1001,31.998,0.0
5036,633487,500,8500,500,9500,1000,501,17.0,0.0
50362,1276994,640,21113,640,22393,1280,641,32.989,0.0
5037,180230,0,2472,0,2972,500,501,4.944,0.0
5038,88147,0,1140,0,1330,190,191,6.0,0.0
50391,85275,126,1008,126,1260,252,127,8.0,0.0
50393,9202,7,133,7,147,14,8,19.0,0.0
50394,717169,1000,10618,1000,12618,2000,1001,10.618,0.0
50396,1985087,1000,34130,1000,36130,2000,1001,34.13,0.0
50398,74798,110,880,110,1100,220,111,8.0,0.0
5040,292005,500,5000,500,6000,1000,501,10.0,1.0
50405,796766,112,12267,112,12491,224,113,109.527,0.0
50407,109691,30,1822,30,1882,60,31,60.733,0.0
50408,753516,1000,11401,1000,13401,2000,1001,11.401,0.0
50410,1127208,1000,15000,1000,17000,2000,1001,15.0,0.0
50412,891499,1000,12000,1000,14000,2000,1001,12.0,0.0
50413,4226797,1000,61495,1000,63495,2000,1001,61.495,0.0
50415,57485,7,882,7,896,14,8,126.0,0.0
50416,214075,256,3072,256,3584,512,257,12.0,0.0
50419,9176,7,133,7,147,14,8,19.0,0.0
5042,290087,500,5000,500,6000,1000,501,10.0,0.0
50421,724068,1000,10770,1000,12770,2000,1001,10.77,0.0
50424,74366,110,880,110,1100,220,111,8.0,0.0
50426,858664,112,13427,112,13651,224,113,119.884,0.0
5043,292352,500,5000,500,6000,1000,501,10.0,0.0
50431,1257895,749,19614,749,21112,1498,750,26.187,0.0
50432,792972,112,12225,112,12449,224,113,109.152,0.0
50433,897171,1000,12000,1000,14000,2000,1001,12.0,0.0
50434,247811,280,4480,280,5040,560,281,16.0,0.0
50437,71229,7,1117,7,1131,14,8,159.571,0.0
50439,1534825,1000,26000,1000,28000,2000,1001,26.0,0.0
5044,292355,500,5000,500,6000,1000,501,10.0,0.0
50441,1700336,1000,26324,1000,28324,2000,1001,26.324,0.0
50445,143048,296,1805,296,2397,592,297,6.098,0.0
50446,1070537,0,13965,0,14965,1000,1001,13.965,0.0
50448,946347,1964,12856,1964,16784,3928,1966,6.546,0.5
50449,626935,612,10404,612,11628,1224,613,17.0,1.0
5045,290350,500,5000,500,6000,1000,501,10.0,0.0
50456,35116,87,348,87,522,174,88,4.0,0.0
50458,712198,1000,6948,1000,9646,2698,1666,6.948,0.0
50459,763988,1000,10000,1000,12000,2000,1001,10.0,0.0
5046,3794771,500,62500,500,63500,1000,501,125.0,0.0
50462,36888,0,480,0,540,60,61,8.0,0.0
50464,1177022,0,15846,0,16846,1000,1001,15.846,0.0
50465,22967,52,208,52,312,104,53,4.0,0.0
50466,44574,0,425,0,470,45,46,9.444,0.5
5047,7720019,500,62500,500,63500,1000,501,125.0,0.0
50477,562413,0,6929,0,7929,1000,1001,6.929,0.0
5048,292368,500,5000,500,6000,1000,501,10.0,0.0
50482,8316,0,90,0,108,18,19,5.0,0.0
50484,19869,0,214,0,256,42,43,5.095,0.0
50486,41868,93,464,93,650,186,94,4.989,0.0
50487,78571,96,1248,96,1440,192,97,13.0,0.0
5049,757876,500,12695,500,13695,1000,501,25.39,0.5
50490,701811,750,12000,750,13500,1500,751,16.0,0.5
50498,51707,107,534,107,748,214,108,4.991,0.0
50499,2580,5,15,5,25,10,6,3.0,0.0
5050,202809,500,3000,500,4000,1000,501,6.0,0.0
50500,173622,220,2200,220,2640,440,221,10.0,0.0
50502,4542,10,30,10,50,20,11,3.0,0.0
50503,14028,35,104,35,174,70,36,2.971,0.0
50508,8733,11,132,11,154,22,12,12.0,1.0
5051,292228,500,5000,500,6000,1000,501,10.0,0.0
50512,20027,43,172,43,258,86,44,4.0,0.0
50513,11555136,1000,17537,1000,19537,2000,1001,17.537,0.0
50516,13374,23,161,23,207,46,24,7.0,0.5
50517,257594,1000,1000,1000,3000,2000,1001,1.0,0.0
50519,176153,253,1771,253,2277,506,254,7.0,0.5
50520,34172,46,552,46,644,92,47,12.0,0.5
50523,15385,36,179,36,251,72,37,4.972,0.0
50524,798171,1000,10000,1000,12000,2000,1001,10.0,0.75
50525,11421,22,88,22,132,44,23,4.0,0.5
50526,631120,1000,10000,1000,12000,2000,1001,10.0,0.0
50528,38071,61,433,61,555,122,62,7.098,1.0
50529,848511,1000,12000,1000,14000,2000,1001,12.0,0.0
5053,1220460,907,11942,907,13756,1814,909,13.166,0.0
50533,3342,4,36,4,44,8,5,9.0,0.5
50536,3313628,1000,14800,1000,16800,2000,1001,14.8,0.0
50538,12235,12,168,12,192,24,13,14.0,0.0
5054,1055649,906,11936,906,13748,1812,908,13.174,0.0
50541,257594,1000,1000,1000,3000,2000,1001,1.0,0.0
50542,525804,1000,6000,1000,8000,2000,1001,6.0,0.0
50543,6534,9,63,9,81,18,10,7.0,0.5
50545,529003,1000,6000,1000,8000,2000,1001,6.0,0.0
50547,257594,1000,1000,1000,3000,2000,1001,1.0,0.0
5055,862887,994,12458,994,14446,1988,996,12.533,0.5
50550,89069,137,1105,137,1379,274,138,8.066,0.0
50552,6927,18,54,18,90,36,19,3.0,0.0
50554,1104204,1000,14432,1000,16432,2000,1001,14.432,0.0
50556,1039,1,4,1,6,2,2,4.0,0.0
50557,82983,145,1501,145,1791,290,146,10.352,0.0
50558,16002,26,222,26,274,52,27,8.538,0.0
50559,392664,1000,4000,1000,6000,2000,1001,4.0,0.0
5056,256159,438,3412,438,4288,876,440,7.79,0.0
50560,807312,1000,12993,1000,14993,2000,1001,12.993,0.0
50561,15930,34,136,34,204,68,35,4.0,0.0
50562,10983,22,132,22,176,44,23,6.0,0.0
50563,532931,1000,6000,1000,8000,2000,1001,6.0,0.0
50566,253593,1000,1000,1000,3000,2000,1001,1.0,0.0
50567,4519,8,54,8,70,16,9,6.75,0.0
50568,7143,18,54,18,90,36,19,3.0,0.0
50572,421418,1000,3998,1000,5998,2000,1001,3.998,0.0
50573,5258,12,48,12,72,24,13,4.0,0.0
50575,573952,992,7886,992,9870,1984,993,7.95,0.0
50581,65615,253,253,253,759,506,254,1.0,0.0
50587,257594,1000,1000,1000,3000,2000,1001,1.0,0.0
50588,257594,1000,1000,1000,3000,2000,1001,1.0,0.0
50589,257594,1000,1000,1000,3000,2000,1001,1.0,0.0
5059,1083473,985,10724,985,12694,1970,987,10.887,0.0
50592,1605,4,4,4,12,8,5,1.0,0.0
50593,20104,35,231,35,301,70,36,6.6,0.0
50594,528778,511,7407,511,8429,1022,513,14.495,0.0
50595,4067,11,25,11,47,22,12,2.273,0.0
50596,1751537,1559,25520,1559,28638,3118,1561,16.369,0.0
50597,2086,3,12,3,18,6,4,4.0,0.0
50598,257594,1000,1000,1000,3000,2000,1001,1.0,0.0
50599,17299,65,65,65,195,130,66,1.0,0.0
5060,1139616,926,12000,926,13852,1852,928,12.959,0.0
50602,86360,339,339,339,1017,678,340,1.0,0.0
50604,23724,90,90,90,270,180,91,1.0,0.0
50605,253593,1000,1000,1000,3000,2000,1001,1.0,0.0
50606,14390,27,162,27,216,54,28,6.0,0.0
50607,3629,12,12,12,36,24,13,1.0,0.0
50608,253593,1000,1000,1000,3000,2000,1001,1.0,0.0
50609,7533,27,27,27,81,54,28,1.0,0.0
5061,297547,500,5000,500,6000,1000,501,10.0,0.0
50610,16115,27,185,27,239,54,28,6.852,0.0
50611,7677,28,28,28,84,56,29,1.0,0.0
50612,253593,1000,1000,1000,3000,2000,1001,1.0,0.0
50614,253593,1000,1000,1000,3000,2000,1001,1.0,0.0
50615,7162,18,72,18,108,36,19,4.0,0.0
50617,253593,1000,1000,1000,3000,2000,1001,1.0,0.0
50619,5147,18,18,18,54,36,19,1.0,0.0
5062,296717,500,4500,500,5500,1000,501,9.0,1.0
50620,23363,90,90,90,270,180,91,1.0,0.0
50621,1622,4,4,4,12,8,5,1.0,0.0
50622,981372,5,55,5,65,10,6,11.0,0.0
50623,7424,27,27,27,81,54,28,1.0,0.0
50626,253593,1000,1000,1000,3000,2000,1001,1.0,0.0
50628,253593,1000,1000,1000,3000,2000,1001,1.0,0.0
50630,15520,59,59,59,177,118,60,1.0,0.0
50631,3021039,59,413,59,531,118,60,7.0,0.0
50633,2165349,1000,41767,1000,43767,2000,1001,41.767,0.0
50634,2084441,1000,40102,1000,42102,2000,1001,40.102,0.0
50635,2207646,1000,42051,1000,44051,2000,1001,42.051,0.0
50639,1086164,2000,17158,2000,21158,4000,2002,8.579,0.0
50641,136097,254,2032,254,2541,509,257,8.0,0.0
50642,1086514,2000,17164,2000,21164,4000,2002,8.582,0.0
50643,746716,1000,13982,1000,15982,2000,1001,13.982,0.0
50647,245923,341,3751,341,4433,682,342,11.0,0.0
50649,171124,322,2576,322,3222,646,326,8.0,0.0
5065,716861,970,8660,970,10600,1940,972,8.928,0.0
50652,533851,1000,6814,1000,8814,2000,1001,6.814,0.0
50654,11103,18,213,18,249,36,19,11.833,0.0
50655,662944,0,10000,0,11000,1000,1001,10.0,0.5
50656,1346,1,15,1,17,2,2,15.0,0.0
50658,10307,18,194,18,230,36,19,10.778,0.0
50659,732447,1000,10000,1000,12000,2000,1001,10.0,0.5
50661,749008,0,11993,0,12993,1000,1001,11.993,0.0
50665,220246,0,3220,0,3542,322,323,10.0,0.0
50666,593352,1000,7648,1000,9648,2000,1001,7.648,0.0
50668,3275,0,30,0,36,6,7,5.0,0.0
5067,1055008,910,9460,910,11280,1820,912,10.396,0.0
50672,1024732,1000,17122,1000,19122,2000,1001,17.122,0.0
50674,918926,1000,15535,1000,17535,2000,1001,15.535,0.0
50675,716222,1000,9000,1000,11000,2000,1001,9.0,0.0
50676,5709,0,36,0,48,12,13,3.0,0.0
50677,651360,1000,6000,1000,8000,2000,1001,6.0,0.5
50678,719310,1000,9000,1000,11000,2000,1001,9.0,0.0
50679,553145,1000,7000,1000,9000,2000,1001,7.0,0.0
5068,1219779,908,11948,908,13764,1816,910,13.159,0.0
50686,651360,1000,6000,1000,8000,2000,1001,6.0,0.0
50687,1833368,2000,29214,2000,33214,4000,2002,14.607,0.0
50689,743451,1000,9000,1000,11000,2000,1001,9.0,0.0
5069,1419867,995,12464,995,14454,1990,997,12.527,0.0
50690,744254,1000,9000,1000,11000,2000,1001,9.0,0.0
50691,743451,1000,9000,1000,11000,2000,1001,9.0,0.0
50693,256288,923,923,923,2769,1846,924,1.0,0.0
50694,2255369,3000,36093,3000,42093,6000,3002,12.031,0.0
50695,2148440,923,39842,923,41688,1846,924,43.166,0.0
50697,2152133,923,39842,923,41688,1846,924,43.166,0.0
50698,277617,1000,1000,1000,3000,2000,1001,1.0,0.0
50699,277617,1000,1000,1000,3000,2000,1001,1.0,0.0
50700,277617,1000,1000,1000,3000,2000,1001,1.0,0.0
50701,281618,1000,1000,1000,3000,2000,1001,1.0,0.0
50702,444785,791,5537,791,7119,1582,792,7.0,0.0
50707,2740,5,15,5,25,10,6,3.0,0.0
50708,77146,152,912,152,1216,304,153,6.0,0.0
50709,3184,6,18,6,30,12,7,3.0,0.0
50712,36460,54,324,54,432,108,55,6.0,0.0
50713,4017,8,24,8,40,16,9,3.0,0.0
50714,2312,4,12,4,20,8,5,3.0,0.5
50715,3181,6,18,6,30,12,7,3.0,0.0
50718,93972,147,882,147,1176,294,148,6.0,0.0
50719,8755,25,50,25,100,50,26,2.0,0.0
50729,3608,7,21,7,35,14,8,3.0,0.0
50737,3646,7,21,7,35,14,8,3.0,0.0
50741,1924,3,9,3,15,6,4,3.0,0.0
50742,36460,54,324,54,432,108,55,6.0,0.0
50748,3606,7,21,7,35,14,8,3.0,0.0
50749,4023,8,24,8,40,16,9,3.0,0.0
5075,1226259,970,10650,970,12590,1940,972,10.979,0.0
50752,2740,5,15,5,25,10,6,3.0,0.5
50757,2734,5,15,5,25,10,6,3.0,0.0
50758,4023,8,24,8,40,16,9,3.0,0.0
50759,1884,3,9,3,15,6,4,3.0,0.5
5076,802141,970,10670,970,12610,1940,972,11.0,0.0
50763,5733,12,36,12,60,24,13,3.0,0.0
50765,2760,5,15,5,25,10,6,3.0,0.5
50766,1500,2,6,2,10,4,3,3.0,0.0
5077,791087,928,9494,928,11350,1856,930,10.231,0.0
50775,111806,0,1382,0,1454,72,73,19.194,0.0
50779,3612,7,21,7,35,14,8,3.0,0.0
50780,49171,87,609,87,783,174,88,7.0,0.0
50787,3611,7,21,7,35,14,8,3.0,0.0
5081,1375154,970,8650,970,10590,1940,972,8.918,0.0
5082,633569,970,8664,970,10604,1940,972,8.932,1.0
5083,711229,911,9466,911,11288,1822,913,10.391,0.0
50858,6764,0,75,0,80,5,6,15.0,0.0
50859,17133,12,155,12,179,24,13,12.917,0.0
50861,1908,0,17,0,18,1,2,17.0,0.0
50862,1985,0,16,0,17,1,2,16.0,0.0
50866,3335,2,32,2,36,4,3,16.0,0.0
50867,6847,0,60,0,72,12,13,5.0,0.0
50872,17161,0,192,0,204,12,13,16.0,0.0
50873,15189,0,166,0,183,17,18,9.765,0.0
50874,313244,0,4027,0,4239,212,213,18.995,0.0
50877,15345,0,144,0,160,16,17,9.0,0.0
50878,17205,0,200,0,225,25,26,8.0,0.0
50885,266289,204,2651,204,3059,408,205,12.995,0.0
50889,20451,14,236,14,264,28,15,16.857,0.0
5089,753452,970,8664,970,10604,1940,972,8.932,0.0
50893,3431,2,34,2,38,4,3,17.0,0.0
50897,43999,0,411,0,443,32,33,12.844,0.0
50899,276122,0,2975,0,3205,230,231,12.935,0.0
5090,887942,924,11966,924,13814,1848,926,12.95,0.0
5091,238740,500,3415,500,4415,1000,501,6.83,0.0
5093,671455,909,9454,909,11272,1818,911,10.4,0.0
50963,87577,358,358,358,1074,716,359,1.0,0.0
50964,392950,0,5000,0,6000,1000,1001,5.0,0.0
50965,77088,68,1020,68,1224,204,138,7.5,0.0
50967,1532722,777,19809,777,22363,2554,1779,11.147,0.5
50968,247584,1000,1000,1000,3000,2000,1001,1.0,0.0
50969,799955,1000,10000,1000,12000,2000,1001,10.0,0.0
50970,12359,18,194,18,230,36,19,10.778,0.0
50971,899638,1000,14922,1000,16922,2000,1001,14.922,1.0
50972,68642,50,1110,50,1210,100,51,22.2,0.0
50973,6079,8,64,8,80,16,9,8.0,0.5
50974,14778,17,237,17,271,34,18,13.941,0.0
50975,7412,12,109,12,133,24,13,9.083,0.0
50976,243583,1000,1000,1000,3000,2000,1001,1.0,0.0
50977,609259,505,8585,505,9595,1010,506,17.0,0.0
50978,6347,16,48,16,80,32,17,3.0,0.0
50979,6347,16,48,16,80,32,17,3.0,0.0
5098,1050391,994,12456,994,14444,1988,996,12.531,1.0
50981,97512,29,1261,29,1319,58,30,43.483,0.0
50982,13344,21,231,21,273,42,22,11.0,0.5
50983,3499,12,12,12,36,24,13,1.0,0.0
50984,193627,358,1907,358,2623,716,359,5.327,0.0
50985,8256,17,102,17,136,34,18,6.0,0.0
50986,243583,1000,1000,1000,3000,2000,1001,1.0,0.0
50987,172105,468,1872,468,2808,936,469,4.0,0.0
50988,7427,13,91,13,117,26,14,7.0,0.0
50989,159697,300,1500,300,2100,600,301,5.0,0.0
50990,17107,68,68,68,204,136,69,1.0,0.0
50991,17794,33,198,33,264,66,34,6.0,0.0
50993,399259,285,5130,285,5700,570,286,18.0,0.0
50994,783961,1000,13467,1000,15467,2000,1001,13.467,0.0
50995,57445,234,234,234,702,468,235,1.0,0.0
50997,13093,12,120,12,156,36,25,10.0,0.0
50999,458307,584,5256,584,6424,1168,585,9.0,0.0
51,1606553,1813,6777,1813,11239,4462,3487,3.738,0.0
51000,168164,456,1824,456,2736,912,457,4.0,0.0
51001,226190,627,2508,627,3762,1254,628,4.0,0.0
51002,700148,889,11944,889,13722,1778,890,13.435,0.0
51005,223579,234,4963,234,5431,468,235,21.209,0.0
51007,27754,110,110,110,330,220,111,1.0,0.0
51010,6415,24,24,24,72,48,25,1.0,0.0
51011,574105,666,5328,666,6660,1332,667,8.0,0.0
51012,1555,4,4,4,12,8,5,1.0,0.0
51014,48893,110,550,110,770,220,111,5.0,0.0
51018,4714,17,17,17,51,34,18,1.0,0.0
51019,247584,1000,1000,1000,3000,2000,1001,1.0,0.0
5102,190824,500,2000,500,3000,1000,501,4.0,0.0
51023,12733,50,50,50,150,100,51,1.0,0.0
51025,5686,21,21,21,63,42,22,1.0,0.5
5103,790465,197,18358,197,18752,394,198,93.188,0.0
51030,9634,15,75,15,105,30,16,5.0,0.0
51032,7006,26,26,26,78,52,27,1.0,0.0
51039,107376,125,1500,125,1750,250,126,12.0,0.0
5104,230189,500,3000,500,4000,1000,501,6.0,0.0
51044,199264,555,2220,555,3330,1110,556,4.0,0.0
51045,1927,2,12,2,16,4,3,6.0,0.0
51046,4228,15,15,15,45,30,16,1.0,0.0
5105,294830,500,4382,500,5382,1000,501,8.764,0.0
51051,144832,584,584,584,1752,1168,585,1.0,0.0
51053,1798,5,5,5,15,10,6,1.0,0.0
51054,826,1,1,1,3,2,2,1.0,0.0
51057,15893,35,169,35,239,70,36,4.829,0.0
51059,2640,5,20,5,30,10,6,4.0,0.5
5106,1911170,903,11918,903,13724,1806,905,13.198,0.0
51060,4695,8,32,8,48,16,9,4.0,0.5
51062,5079013,1000,62122,1000,64122,2000,1001,62.122,0.0
51063,4714,17,17,17,51,34,18,1.0,0.0
51064,421865,23,92,23,138,46,24,4.0,0.0
51068,7952,15,60,15,90,30,16,4.0,0.0
5107,967285,907,9442,907,11256,1814,909,10.41,0.0
51070,5721871,1000,9472,1000,11472,2000,1001,9.472,0.0
51071,114307,468,468,468,1404,936,469,1.0,0.0
51073,31459,125,125,125,375,250,126,1.0,0.0
51076,216610,889,889,889,2667,1778,890,1.0,0.0
51077,13052609,1000,5999,1000,7999,2000,1001,5.999,0.0
51078,1165,1,7,1,9,2,2,7.0,0.0
51079,2758,5,30,5,40,10,6,6.0,0.0
5108,1048638,909,9454,909,11272,1818,911,10.4,0.0
51080,111391,456,456,456,1368,912,457,1.0,0.0
51081,7810927,199,2587,199,2985,398,200,13.0,1.0
51087,3985,14,14,14,42,28,15,1.0,0.5
5109,1634094,904,9424,904,11232,1808,906,10.425,0.0
51092,1064903,1000,15000,1000,17000,2000,1001,15.0,0.0
51095,636823,1000,8799,1000,10799,2000,1001,8.799,0.0
51097,247584,1000,1000,1000,3000,2000,1001,1.0,0.0
5110,1451297,909,11954,909,13772,1818,911,13.151,0.0
51106,515193,893,5358,893,7144,1786,894,6.0,0.0
5111,979198,910,9460,910,11280,1820,912,10.396,1.0
51113,110252,444,444,444,1332,888,445,1.0,0.0
51114,2618879,1000,10579,1000,12579,2000,1001,10.579,0.0
51115,217582,893,893,893,2679,1786,894,1.0,0.0
5112,946920,909,11954,909,13772,1818,911,13.151,0.0
51120,49737,199,199,199,597,398,200,1.0,1.0
51125,247584,1000,1000,1000,3000,2000,1001,1.0,0.0
5113,881804,911,9466,911,11288,1822,913,10.391,1.0
51133,1078,2,2,2,6,4,3,1.0,0.0
51134,243583,1000,1000,1000,3000,2000,1001,1.0,0.0
51136,65221,266,266,266,798,532,267,1.0,0.0
51137,3013,10,10,10,30,20,11,1.0,0.0
5114,672865,910,9460,910,11280,1820,912,10.396,0.0
51140,72268,295,295,295,885,590,296,1.0,0.0
51144,4957,18,18,18,54,36,19,1.0,0.0
51145,12490,49,49,49,147,98,50,1.0,0.0
51146,9515,21,81,21,123,42,22,3.857,0.0
51148,7888,12,43,12,67,24,13,3.583,0.5
5115,971412,925,9478,925,11328,1850,927,10.246,0.0
51151,3499,12,12,12,36,24,13,1.0,0.0
51152,42085,49,516,49,614,98,50,10.531,0.0
51154,67165,274,274,274,822,548,275,1.0,0.0
51155,26638,65,195,65,325,130,66,3.0,0.0
51159,134703,220,1445,220,1885,440,221,6.568,0.0
5116,1374436,926,11984,926,13836,1852,928,12.942,0.0
51160,2041,6,6,6,18,12,7,1.0,0.0
51161,73483,300,300,300,900,600,301,1.0,0.0
51162,8602,33,33,33,99,66,34,1.0,0.0
51166,30958,125,125,125,375,250,126,1.0,0.0
51169,25369,102,102,102,306,204,103,1.0,0.0
5117,1142931,927,11988,927,13842,1854,929,12.932,0.0
51171,7600,12,60,12,84,24,13,5.0,0.0
51172,19717,49,196,49,294,98,50,4.0,0.0
51173,4092,6,24,6,36,12,7,4.0,0.0
51174,26713,65,195,65,325,130,66,3.0,0.0
51175,44409,36,864,36,936,72,37,24.0,0.0
51176,632110,1000,8000,1000,10000,2000,1001,8.0,0.0
5118,1394565,925,11976,925,13826,1850,927,12.947,0.0
5119,1027080,924,11970,924,13818,1848,926,12.955,1.0
5120,1058446,924,11968,924,13816,1848,926,12.952,0.0
5121,1124043,928,11988,928,13844,1856,930,12.918,1.0
5122,837979,925,11972,925,13822,1850,927,12.943,1.0
5123,995701,992,9946,992,11930,1984,994,10.026,0.0
5124,1401266,997,12476,997,14470,1994,999,12.514,0.0
5125,815106,996,9970,996,11962,1992,998,10.01,0.0
5127,943508,921,11964,921,13806,1842,923,12.99,0.0
5128,521711,270,7112,270,8152,1040,772,9.236,0.0
5130,212948,0,3500,0,4000,500,501,7.0,0.5
5131,290660,0,5000,0,5500,500,501,10.0,0.0
5132,209548,500,3500,500,4500,1000,501,7.0,1.0
5133,291361,0,5000,0,5500,500,501,10.0,0.0
5138,1260868,1000,11290,1000,13290,2000,1002,11.29,0.0
5139,1085002,1000,11286,1000,13286,2000,1002,11.286,0.0
5140,1272867,1000,11282,1000,13282,2000,1002,11.282,0.0
5141,1110121,1000,11288,1000,13288,2000,1002,11.288,0.0
5142,921806,1000,9284,1000,11284,2000,1002,9.284,0.0
5143,989715,1000,11276,1000,13276,2000,1002,11.276,0.0
5145,686668,1000,9282,1000,11282,2000,1002,9.282,1.0
51479,667299,1000,9000,1000,11000,2000,1001,9.0,0.5
51481,10857,39,39,39,117,78,40,1.0,0.0
51483,614428,39,156,39,234,78,40,4.0,0.0
5149,881777,909,9454,909,11272,1818,911,10.4,1.0
51492,702109,0,11000,0,12000,1000,1001,11.0,0.0
51493,528385,0,7686,0,8686,1000,1001,7.686,0.0
51494,1033494,0,18000,0,19000,1000,1001,18.0,0.0
5150,1124542,910,11960,910,13780,1820,912,13.143,0.0
5151,822463,910,9460,910,11280,1820,912,10.396,0.0
51517,692432,1000,8000,1000,10000,2000,1001,8.0,0.0
5152,715636,910,9460,910,11280,1820,912,10.396,0.0
51530,718295,1000,11715,1000,13715,2000,1001,11.715,0.0
51532,21981,30,330,30,390,60,31,11.0,0.0
51533,1079940,1000,19000,1000,21000,2000,1001,19.0,0.0
51536,719340,1000,11713,1000,13713,2000,1001,11.713,0.0
51540,723322,1000,11711,1000,13711,2000,1001,11.711,0.0
51543,720349,1000,11505,1000,13505,2000,1001,11.505,0.0
51547,719322,1000,11709,1000,13709,2000,1001,11.709,0.0
51550,269609,1000,1000,1000,3000,2000,1001,1.0,0.0
51553,63862,170,680,170,1020,340,171,4.0,0.0
51555,273610,1000,1000,1000,3000,2000,1001,1.0,0.0
51567,8229,7,129,7,143,14,8,18.429,0.0
51569,13816,12,214,12,238,24,13,17.833,0.0
51570,10205,9,89,9,107,18,10,9.889,0.0
51574,5050,4,79,4,87,8,5,19.75,0.0
51575,8796,7,140,7,154,14,8,20.0,0.0
51576,146816,255,1960,255,2470,510,257,7.686,0.0
51580,5494,11,44,11,66,22,12,4.0,0.0
51582,146816,255,1960,255,2470,510,257,7.686,0.0
51586,7627,6,112,6,124,12,7,18.667,0.0
51591,2938,3,32,3,38,6,4,10.667,0.0
51592,6536,10,79,10,99,20,11,7.9,0.0
51593,1384,2,8,2,12,4,3,4.0,0.0
51594,8585,0,66,0,88,22,23,3.0,0.0
51595,5260,0,36,0,48,12,13,3.0,0.0
51597,3140,6,24,6,36,12,7,4.0,0.0
51598,2427,5,15,5,25,10,6,3.0,0.0
51601,5572,7,62,7,76,14,8,8.857,0.0
51602,5776,4,87,4,95,8,5,21.75,0.0
51603,6217,5,53,5,63,10,6,10.6,0.0
51604,2294,4,18,4,26,8,5,4.5,0.0
51605,3335,7,33,7,47,14,8,4.714,0.0
51606,5528,4,87,4,95,8,5,21.75,0.0
51607,24259,21,392,21,434,42,22,18.667,0.0
51611,13816,12,214,12,238,24,13,17.833,0.0
51614,2221,0,20,0,24,4,5,5.0,0.0
51616,1906,3,12,3,18,6,4,4.0,0.0
51624,2472,3,15,3,21,6,4,5.0,0.0
51625,74183,63,1232,63,1358,126,64,19.556,0.0
51626,41162,36,698,36,770,72,37,19.389,0.0
51629,4021,4,47,4,55,8,5,11.75,0.0
51636,5562,6,64,6,76,12,7,10.667,0.5
51638,5560,5,45,5,55,10,6,9.0,0.0
51640,82301,70,1456,70,1596,140,71,20.8,0.0
51642,33896,29,574,29,632,58,30,19.793,0.0
51643,6536,10,79,10,99,20,11,7.9,0.0
51644,2860,0,18,0,24,6,7,3.0,0.0
51645,3534,4,44,4,52,8,5,11.0,0.0
51646,1005,1,5,1,7,2,2,5.0,0.0
51647,32165,27,550,27,604,54,28,20.37,0.0
51648,6111,5,86,5,96,10,6,17.2,0.0
51649,10844,9,163,9,181,18,10,18.111,0.0
5165,366620,0,5124,0,5624,500,501,10.248,0.0
51650,7262,4,88,4,96,8,5,22.0,0.0
51651,12079,10,202,10,222,20,11,20.2,0.0
51652,20203,17,325,17,359,34,18,19.118,0.0
51653,19643,16,346,16,378,32,17,21.625,0.0
51654,24713,21,402,21,444,42,22,19.143,0.0
51655,2308,3,12,3,18,6,4,4.0,0.0
51656,18530,15,324,15,354,30,16,21.6,0.0
51657,4742,4,67,4,75,8,5,16.75,0.0
51658,3965,3,55,3,61,6,4,18.333,0.0
51659,71908,73,1042,73,1188,146,74,14.274,0.0
5166,1067962,920,12018,920,13858,1840,922,13.063,0.0
51660,4027,3,58,3,64,6,4,19.333,0.0
51661,5433,7,31,7,52,21,15,4.429,0.0
51662,15076,0,151,0,189,38,39,3.974,0.0
51663,1955,4,12,4,20,8,5,3.0,0.0
51664,69151,56,1145,56,1257,112,57,20.446,0.0
51667,49109,40,806,40,886,80,41,20.15,0.0
51669,12828,10,210,10,230,20,11,21.0,0.0
5167,676207,0,11745,0,12245,500,501,23.49,0.0
51670,4247,0,45,0,50,5,6,9.0,0.0
51671,2466,0,22,0,24,2,3,11.0,0.5
51672,55424,54,918,54,1026,108,55,17.0,0.0
51673,6486,10,90,10,110,20,11,9.0,0.0
51674,3663,6,30,6,42,12,7,5.0,0.5
51677,11172,10,169,10,189,20,11,16.9,0.0
51678,4775,4,65,4,73,8,5,16.25,0.0
51679,5566,6,77,6,89,12,7,12.833,0.0
5168,675527,0,11741,0,12241,500,501,23.482,0.0
51680,13033,30,121,30,181,60,31,4.033,0.0
51682,14961,12,248,12,272,24,13,20.667,0.0
51683,5305,4,79,4,87,8,5,19.75,0.0
51684,2406,5,15,5,25,10,6,3.0,0.0
51687,55101,32,730,32,858,128,98,7.604,0.0
51688,1087804,1000,18065,1000,20065,2000,1001,18.065,0.0
5169,683111,0,11657,0,12157,500,501,23.314,0.0
51690,4014,3,58,3,64,6,4,19.333,0.0
51691,7672,6,116,6,128,12,7,19.333,0.0
51692,9214,23,68,23,114,46,24,2.957,0.0
5170,676694,0,11717,0,12217,500,501,23.434,0.0
51701,41019,35,700,35,770,70,36,20.0,0.0
51703,25233,46,368,46,460,92,47,8.0,0.0
51704,3713,3,42,3,48,6,4,14.0,0.0
51705,170096,286,2288,286,2860,572,287,8.0,0.0
51706,44880,36,739,36,811,72,37,20.528,0.0
51707,6233,5,99,5,109,10,6,19.8,0.0
51708,7200,16,79,16,111,32,18,4.938,0.0
5171,673799,0,11791,0,12291,500,501,23.582,0.0
51717,4232,0,36,0,45,9,10,4.0,0.5
51719,3517,4,44,4,52,8,5,11.0,0.0
51720,5302,4,78,4,86,8,5,19.5,0.0
51721,27257,46,414,46,506,92,47,9.0,0.0
51722,25534,20,440,20,480,40,21,22.0,0.0
51723,4209,3,57,3,63,6,4,19.0,0.0
51724,3379,0,24,0,30,6,7,4.0,0.0
51728,1721,2,10,2,14,4,3,5.0,0.0
51729,5184,4,76,4,84,8,5,19.0,0.0
51733,129016,115,2086,115,2316,230,116,18.139,0.0
51734,3049,2,42,2,46,4,3,21.0,0.0
51735,25233,46,368,46,460,92,47,8.0,0.0
51737,2994,6,24,6,36,12,7,4.0,0.0
51746,7261,6,113,6,125,12,7,18.833,0.0
51749,3962,3,57,3,63,6,4,19.0,0.0
5175,1078255,970,10666,970,12606,1940,972,10.996,0.0
51750,4813,4,71,4,79,8,5,17.75,0.0
51751,6486,10,90,10,110,20,11,9.0,0.0
51753,6567,10,50,10,70,20,11,5.0,0.0
51755,3220,5,20,5,30,10,6,4.0,0.0
51756,19271,31,233,31,295,62,33,7.516,0.0
51757,3713,3,42,3,48,6,4,14.0,0.0
51758,6754,5,108,5,118,10,6,21.6,0.0
51759,12659,12,204,12,228,24,13,17.0,0.0
5176,692683,985,8728,985,10698,1970,987,8.861,0.0
51761,4241,0,53,0,57,4,5,13.25,0.0
51762,48073,41,804,41,886,82,42,19.61,0.0
51763,4974,4,73,4,81,8,5,18.25,0.0
51765,4008,3,59,3,65,6,4,19.667,0.0
51769,3901,3,57,3,63,6,4,19.0,0.0
5177,1060838,985,10724,985,12694,1970,987,10.887,0.0
51770,19192,37,185,37,259,74,38,5.0,0.0
51774,13634,16,94,16,126,32,17,5.875,0.0
51776,4059,3,59,3,65,6,4,19.667,0.0
51777,6729,5,104,5,114,10,6,20.8,0.0
5178,846825,985,8728,985,10698,1970,987,8.861,0.0
51780,1149,1,6,1,8,2,2,6.0,0.0
51783,2109,2,22,2,26,4,3,11.0,0.0
51785,6834,5,105,5,115,10,6,21.0,0.5
51787,1209,1,6,1,8,2,2,6.0,0.0
51788,6437,5,103,5,113,10,6,20.6,0.0
51789,17922,15,306,15,336,30,16,20.4,0.0
5179,960547,970,10664,970,12604,1940,972,10.994,0.0
51790,5851,5,88,5,98,10,6,17.6,0.0
51791,9490,9,81,9,99,18,10,9.0,0.0
51792,25233,46,368,46,460,92,47,8.0,0.0
51793,3487,6,30,6,42,12,7,5.0,0.0
51794,9755,8,166,8,182,16,9,20.75,0.0
51795,40429,35,689,35,759,70,36,19.686,0.0
51797,4684,4,59,4,67,8,5,14.75,0.0
51798,4670,8,40,8,56,16,9,5.0,0.0
51799,6587,5,101,5,111,10,6,20.2,0.0
5180,713599,970,8658,970,10598,1940,972,8.926,0.0
51800,18990,14,304,14,332,28,15,21.714,0.0
51801,14558,15,120,15,150,30,16,8.0,0.0
51802,2994,6,24,6,36,12,7,4.0,0.0
51803,1450,2,8,2,12,4,3,4.0,0.0
5181,804702,985,10724,985,12694,1970,987,10.887,0.0
51817,2164,4,16,4,24,8,5,4.0,0.0
51818,2783,5,15,5,25,10,6,3.0,0.0
51819,6233,5,99,5,109,10,6,19.8,0.0
51826,1693,1,18,1,20,2,2,18.0,0.0
5183,780733,985,10722,985,12692,1970,987,10.885,0.0
51831,4617,4,56,4,64,8,5,14.0,0.0
51833,29254,22,445,22,489,44,23,20.227,0.0
51838,2382,0,15,0,20,5,6,3.0,0.0
51839,2188,3,18,3,24,6,4,6.0,0.0
5184,850252,1000,9286,1000,11286,2000,1002,9.286,0.0
51841,23877,21,405,21,447,42,22,19.286,0.0
51844,2497,0,15,0,20,5,6,3.0,0.75
51845,5369,4,81,4,89,8,5,20.25,0.0
51846,170096,286,2288,286,2860,572,287,8.0,0.0
51847,6160,7,72,7,86,14,8,10.286,0.0
51848,5572,4,73,4,81,8,5,18.25,0.0
51856,6138,5,82,5,92,10,6,16.4,0.0
51857,6160,14,55,14,83,28,15,3.929,0.0
51858,2448,5,20,5,30,10,6,4.0,0.75
5186,1111356,1000,11286,1000,13286,2000,1002,11.286,0.0
51869,9835,8,166,8,182,16,9,20.75,0.0
5187,835293,1000,11286,1000,13286,2000,1002,11.286,0.0
51877,14154,11,124,11,146,22,12,11.273,0.0
5188,671331,1000,9284,1000,11284,2000,1002,9.284,0.0
51881,7797,6,125,6,137,12,7,20.833,0.0
51882,7822,6,119,6,131,12,7,19.833,0.0
51883,7668,17,58,17,92,34,18,3.412,0.0
51885,41280,36,685,36,757,72,37,19.028,0.0
51886,12091,10,188,10,208,20,11,18.8,0.0
51887,1461,2,8,2,12,4,3,4.0,0.0
51888,3911,3,56,3,62,6,4,18.667,0.0
51889,7419,6,118,6,130,12,7,19.667,0.0
51890,7624,6,120,6,132,12,7,20.0,0.0
51896,1049,1,3,1,5,2,2,3.0,0.0
51897,5688,5,84,5,94,10,6,16.8,0.0
51898,44620,95,605,95,795,190,97,6.368,0.0
51899,5566,6,77,6,89,12,7,12.833,0.0
51900,3750,5,39,5,49,10,6,7.8,0.0
51901,8523,6,111,6,123,12,7,18.5,0.0
51902,6135,14,68,14,96,28,15,4.857,0.0
51914,4999,4,75,4,83,8,5,18.75,0.0
51915,3084,3,37,3,43,6,4,12.333,0.0
51918,23729,22,380,22,424,44,23,17.273,0.0
51919,28691,24,475,24,523,48,25,19.792,0.0
51920,82031,141,1094,141,1376,282,143,7.759,0.0
51921,22962,48,288,48,384,96,49,6.0,0.0
51924,6748,6,101,6,113,12,7,16.833,0.0
51925,2756,5,20,5,30,10,6,4.0,0.0
51926,10297,11,110,11,132,22,12,10.0,0.75
51927,18536,40,319,40,399,80,42,7.975,0.0
51934,7934,20,60,20,100,40,21,3.0,0.0
51951,25233,46,368,46,460,92,47,8.0,0.0
51959,4169,3,57,3,63,6,4,19.0,0.0
51965,4661,4,57,4,65,8,5,14.25,0.0
51971,1045,1,5,1,7,2,2,5.0,0.0
51972,5895,8,72,8,88,16,9,9.0,0.0
51979,6233,5,99,5,109,10,6,19.8,0.0
51982,1765,1,19,1,21,2,2,19.0,0.0
51983,5378,4,83,4,91,8,5,20.75,0.0
51984,2962,2,40,2,44,4,3,20.0,0.0
51985,3204,4,30,4,38,8,5,7.5,0.0
51986,2416,2,21,2,25,4,3,10.5,0.0
51991,8935,8,143,8,159,16,9,17.875,0.0
51992,4156,3,62,3,68,6,4,20.667,0.0
51993,2658,4,32,4,40,8,5,8.0,0.0
51994,45861,43,696,43,782,86,44,16.186,0.0
51995,1005,1,5,1,7,2,2,5.0,0.0
51997,1127,1,6,1,8,2,2,6.0,0.0
51998,15359,12,245,12,269,24,13,20.417,0.0
51999,16179,13,262,13,288,26,14,20.154,0.0
52,18463,72,179,72,305,126,76,3.315,0.0
52000,2249,4,16,4,24,8,5,4.0,0.0
52001,20432,42,374,42,458,84,44,8.905,0.0
52002,7597,7,117,7,131,14,8,16.714,0.0
52003,6267,0,103,0,108,5,6,20.6,0.0
52004,5382,4,81,4,89,8,5,20.25,0.0
52007,5050,4,79,4,87,8,5,19.75,0.0
52015,6485,5,101,5,111,10,6,20.2,0.0
52016,8994,8,136,8,152,16,9,17.0,0.0
52017,6840,6,105,6,117,12,7,17.5,0.0
52040,5147,4,74,4,82,8,5,18.5,0.0
52041,4134,3,63,3,69,6,4,21.0,0.0
52043,12377,10,204,10,224,20,11,20.4,0.0
52044,6194,13,61,13,87,26,14,4.692,0.0
52046,1650,1,14,1,16,2,2,14.0,0.0
52047,1413,2,10,2,14,4,3,5.0,0.0
52051,17473,15,288,15,318,30,16,19.2,0.0
52055,16533,40,240,40,320,80,42,6.0,0.0
52064,11407,10,184,10,204,20,11,18.4,0.0
52065,6431,5,100,5,110,10,6,20.0,0.0
52068,7432,11,81,11,103,22,12,7.364,0.0
52071,4267,5,45,5,55,10,6,9.0,0.0
52072,6170,5,95,5,105,10,6,19.0,0.0
52074,15682,16,246,16,278,32,17,15.375,0.0
52078,7522,6,118,6,130,12,7,19.667,0.0
52079,5064,4,74,4,82,8,5,18.5,0.0
52087,5308,7,56,7,70,14,8,8.0,0.0
52090,3717,8,32,8,48,16,9,4.0,0.0
52091,7070,6,110,6,122,12,7,18.333,0.0
52093,10178,6,84,6,96,12,7,14.0,0.0
52096,2220,4,20,4,28,8,5,5.0,0.0
52098,7318,6,120,6,132,12,7,20.0,0.0
52099,9916,10,150,10,170,20,11,15.0,0.75
52100,43213,36,692,36,764,72,37,19.222,0.0
52101,2847,5,25,5,35,10,6,5.0,0.0
52102,9833,8,156,8,172,16,9,19.5,0.0
52104,8994,8,136,8,152,16,9,17.0,0.0
52107,12626,21,167,21,209,42,22,7.952,0.0
5211,683730,0,11576,0,12076,500,501,23.152,0.0
52112,5195,4,79,4,87,8,5,19.75,0.0
52113,2814,2,38,2,42,4,3,19.0,0.0
52114,3019,2,42,2,46,4,3,21.0,0.0
52118,3091,2,40,2,44,4,3,20.0,0.0
52119,6172,5,98,5,108,10,6,19.6,0.0
5212,677050,0,11650,0,12150,500,501,23.3,0.0
52120,4440,3,60,3,66,6,4,20.0,0.0
52121,4091,3,61,3,67,6,4,20.333,0.0
52122,1597,2,12,2,16,4,3,6.0,0.0
52123,4058,3,63,3,69,6,4,21.0,0.0
52124,3962,3,57,3,63,6,4,19.0,0.0
52125,4249,4,53,4,61,8,5,13.25,0.0
5213,248121,500,3208,500,4208,1000,501,6.416,0.0
52134,28201,25,457,25,507,50,26,18.28,0.0
52144,6907,0,104,0,110,6,7,17.333,0.0
52147,5099,4,74,4,82,8,5,18.5,0.0
5215,90902,0,1482,0,1578,96,97,15.438,0.0
52154,32134,28,471,28,527,56,29,16.821,0.5
52156,8734,8,141,8,157,16,9,17.625,0.0
52157,5817,5,83,5,93,10,6,16.6,0.0
5216,224732,0,4126,0,4322,196,197,21.051,0.0
52160,10932,26,130,26,182,52,28,5.0,0.0
52161,3035,4,34,4,42,8,5,8.5,0.0
52162,4817,4,68,4,76,8,5,17.0,0.0
5217,174210,0,2275,0,2671,396,397,5.745,0.0
52173,2768,2,38,2,42,4,3,19.0,0.0
52176,2852,2,38,2,42,4,3,19.0,0.0
52177,5188,4,79,4,87,8,5,19.75,0.0
52179,5761,8,72,8,88,16,9,9.0,0.0
5218,1055664,985,10726,985,12696,1970,987,10.889,0.0
52180,12510,24,156,24,204,48,26,6.5,0.0
52181,3990,3,59,3,65,6,4,19.667,0.0
52184,6333,5,99,5,109,10,6,19.8,0.0
52188,1983,4,12,4,20,8,5,3.0,0.0
5219,1412456,985,10730,985,12700,1970,987,10.893,0.0
52191,3439,6,51,6,63,12,8,8.5,0.0
52195,6007,5,94,5,104,10,6,18.8,0.0
52197,42659,37,653,37,727,74,38,17.649,0.0
5220,1242563,985,10712,985,12682,1970,987,10.875,0.0
52201,950,1,3,1,5,2,2,3.0,0.0
52202,9160,8,141,8,157,16,9,17.625,0.0
52204,5088,4,77,4,85,8,5,19.25,0.0
52209,7389,6,104,6,116,12,7,17.333,0.0
5221,912162,985,8726,985,10696,1970,987,8.859,0.0
52210,9043,23,92,23,138,46,24,4.0,0.0
52211,34652,29,570,29,628,58,30,19.655,0.0
52213,6062,5,95,5,105,10,6,19.0,0.0
52215,6425,5,101,5,111,10,6,20.2,0.0
52216,6466,5,102,5,112,10,6,20.4,0.0
52218,6147,5,95,5,105,10,6,19.0,0.0
52219,24629,0,270,0,300,30,31,9.0,0.0
5222,1019498,985,10720,985,12690,1970,987,10.883,0.0
52220,27075,23,459,23,505,46,24,19.957,0.0
52221,6028,5,90,5,100,10,6,18.0,0.0
52223,5077,4,74,4,82,8,5,18.5,0.0
52224,2963,7,21,7,35,14,8,3.0,0.0
52225,2926,6,18,6,30,12,7,3.0,0.0
52226,4962,4,68,4,76,8,5,17.0,0.0
52228,5590,5,82,5,92,10,6,16.4,0.0
52229,9467,9,143,9,161,18,10,15.889,0.0
5223,1073559,985,10726,985,12696,1970,987,10.889,0.0
52230,1692,1,19,1,21,2,2,19.0,0.0
52232,5254,4,77,4,85,8,5,19.25,0.0
52234,5717,5,80,5,90,10,6,16.0,0.0
52235,12828,10,210,10,230,20,11,21.0,0.0
52236,7269,6,114,6,126,12,7,19.0,0.0
52237,4895,4,68,4,76,8,5,17.0,0.0
52238,7045,6,112,6,124,12,7,18.667,0.75
52239,5449,11,44,11,66,22,12,4.0,0.0
5224,1052195,1017,10948,1017,12982,2034,1019,10.765,0.0
52240,8456,5,92,5,102,10,6,18.4,0.0
52241,1045,1,5,1,7,2,2,5.0,0.0
52242,7605,16,64,16,96,32,17,4.0,0.0
52243,2478,5,20,5,30,10,6,4.0,0.0
52244,2909,4,29,4,37,8,5,7.25,0.0
52245,4069,3,60,3,66,6,4,20.0,0.0
52246,61621,53,1043,53,1149,106,54,19.679,0.0
52247,6156,5,87,5,97,10,6,17.4,0.0
52248,5803,5,82,5,92,10,6,16.4,0.0
52249,4435,4,63,4,71,8,5,15.75,0.0
5225,641574,985,8726,985,10696,1970,987,8.859,0.0
52250,3991,3,60,3,66,6,4,20.0,0.0
52251,3535,3,50,3,56,6,4,16.667,0.0
52252,5307,4,81,4,89,8,5,20.25,0.0
52253,9806,8,156,8,172,16,9,19.5,0.0
52254,12547,11,204,11,226,22,12,18.545,0.0
52255,7050,6,121,6,133,12,7,20.167,0.0
52256,10918,9,170,9,188,18,10,18.889,0.0
52257,7376,6,115,6,127,12,7,19.167,0.0
52258,2188,3,18,3,24,6,4,6.0,0.0
52259,6333,5,95,5,105,10,6,19.0,0.0
5226,657022,985,8724,985,10694,1970,987,8.857,1.0
52260,2752,3,31,3,37,6,4,10.333,0.0
52261,6027,12,72,12,96,24,13,6.0,0.0
52262,3310,4,29,4,37,8,5,7.25,0.0
52263,30205,56,358,56,470,112,57,6.393,0.0
52264,1758,1,20,1,22,2,2,20.0,0.0
52266,5178,4,79,4,87,8,5,19.75,0.0
52267,5574,7,61,7,75,14,8,8.714,0.0
52268,8114,7,122,7,136,14,8,17.429,0.0
52269,18046,42,210,42,294,84,44,5.0,0.0
52270,5127,4,81,4,89,8,5,20.25,0.0
52271,4118,3,62,3,68,6,4,20.667,0.0
52272,62140,58,987,58,1103,116,59,17.017,0.0
52273,5529,4,89,4,97,8,5,22.25,0.0
52274,6278,5,102,5,112,10,6,20.4,0.0
52276,3202,3,40,3,46,6,4,13.333,0.0
52277,3000,2,41,2,45,4,3,20.5,0.0
52278,7429,7,112,7,126,14,8,16.0,0.0
52279,11198,24,120,24,168,48,25,5.0,0.0
5228,1631869,903,9418,903,11224,1806,905,10.43,0.0
52280,25636,22,431,22,475,44,23,19.591,0.0
52281,52499,120,600,120,840,240,121,5.0,0.0
52282,10168,9,89,9,107,18,10,9.889,0.0
52283,7417,5,117,5,127,10,6,23.4,0.0
52284,7597,7,117,7,131,14,8,16.714,0.0
52285,4343,3,62,3,68,6,4,20.667,0.0
52286,4887,4,71,4,79,8,5,17.75,0.0
52287,2026,3,15,3,21,6,4,5.0,0.0
52288,2501,5,15,5,25,10,6,3.0,0.0
52289,5977,4,77,4,85,8,5,19.25,0.0
52290,1045,1,4,1,6,2,2,4.0,0.0
52291,5119,4,80,4,88,8,5,20.0,0.0
52293,5453,4,76,4,84,8,5,19.0,0.0
52294,3959,3,58,3,64,6,4,19.333,0.0
52295,2470,6,13,6,25,12,7,2.167,0.0
52299,12429,10,196,10,216,20,11,19.6,0.0
52304,32441,30,486,30,546,60,31,16.2,0.0
52305,4043,3,60,3,66,6,4,20.0,0.0
52321,10869,8,171,8,187,16,9,21.375,0.0
52348,6487,5,105,5,115,10,6,21.0,0.0
5235,454620,500,6080,500,7080,1000,501,12.16,0.75
5236,885059,925,11988,925,13838,1850,927,12.96,1.0
52369,2558,5,20,5,30,10,6,4.0,0.0
5237,1060839,924,11959,924,13807,1848,926,12.943,0.0
52370,7712,6,116,6,128,12,7,19.333,0.0
5238,1074788,927,11589,927,13443,1854,929,12.502,1.0
5239,823588,924,9478,924,11326,1848,926,10.258,0.0
5240,718325,923,9476,923,11322,1846,925,10.267,0.0
5241,720727,0,14438,0,14938,500,501,28.876,0.0
5242,1193902,970,10668,970,12608,1940,972,10.998,0.0
5243,1069902,970,10668,970,12608,1940,972,10.998,0.0
5244,960732,970,10668,970,12608,1940,972,10.998,0.0
52443,7819,16,64,16,96,32,17,4.0,0.0
52452,5449,4,81,4,89,8,5,20.25,0.0
5246,915107,970,10664,970,12604,1940,972,10.994,0.0
5247,1101470,1000,11282,1000,13282,2000,1002,11.282,0.0
5248,1403384,500,11282,500,12782,1500,1002,11.282,0.0
5249,942160,1000,9290,1000,11290,2000,1002,9.29,0.0
5250,1103584,1000,11288,1000,13288,2000,1002,11.288,0.0
5251,750982,1000,9288,1000,11288,2000,1002,9.288,0.0
52517,8022,5,107,5,117,10,6,21.4,0.0
5252,946865,1000,11288,1000,13288,2000,1002,11.288,0.0
5253,747537,1000,9284,1000,11284,2000,1002,9.284,0.0
52538,14055,12,219,12,243,24,13,18.25,0.0
52539,2914,6,24,6,36,12,7,4.0,0.0
5254,1409623,1000,9286,1000,11286,2000,1002,9.286,0.0
52540,4454,6,50,6,62,12,7,8.333,0.0
52542,8701,8,141,8,157,16,9,17.625,0.0
52543,7215,6,116,6,128,12,7,19.333,0.0
52544,13708,12,228,12,252,24,13,19.0,0.0
52545,2585,2,16,2,20,4,3,8.0,0.0
52546,5701,4,84,4,92,8,5,21.0,0.0
52547,6077,4,90,4,98,8,5,22.5,0.0
52548,4265,3,64,3,70,6,4,21.333,0.0
52549,2594,2,16,2,20,4,3,8.0,0.0
5255,667538,1000,9290,1000,11290,2000,1002,9.29,1.0
52550,5022,4,67,4,75,8,5,16.75,0.0
52551,5382,4,81,4,89,8,5,20.25,0.0
52552,6037,5,87,5,97,10,6,17.4,0.0
52553,4962,4,72,4,80,8,5,18.0,0.0
52554,7798,11,77,11,99,22,12,7.0,0.0
52555,1084,1,7,1,9,2,2,7.0,0.0
52556,5342,4,81,4,89,8,5,20.25,0.0
52557,4041,3,60,3,66,6,4,20.0,0.0
52558,6464,5,102,5,112,10,6,20.4,0.0
52559,6170,5,92,5,102,10,6,18.4,0.0
52560,6266,11,55,11,77,22,12,5.0,0.0
52561,7342,6,115,6,127,12,7,19.167,0.0
52563,5230,4,84,4,92,8,5,21.0,0.0
52564,4423,4,60,4,68,8,5,15.0,0.0
52565,5583,4,86,4,94,8,5,21.5,0.0
52566,2257,5,15,5,25,10,6,3.0,0.0
52567,27253,25,436,25,486,50,26,17.44,0.0
52568,7739,6,120,6,132,12,7,20.0,0.0
52570,5436,5,80,5,90,10,6,16.0,0.0
52571,9055,7,145,7,159,14,8,20.714,0.0
52572,1503,1,6,1,8,2,2,6.0,0.0
52574,4330,3,62,3,68,6,4,20.667,0.0
52575,9993,8,162,8,178,16,9,20.25,0.0
52577,4395,3,65,3,71,6,4,21.667,0.0
52578,5162,4,81,4,89,8,5,20.25,0.0
52579,1753,1,20,1,22,2,2,20.0,0.0
52581,3892,0,18,0,20,2,3,9.0,0.0
52584,4344,7,35,7,56,21,15,5.0,0.0
52585,6358,5,100,5,110,10,6,20.0,0.0
52586,1323,2,6,2,10,4,3,3.0,0.0
52588,1086,1,7,1,9,2,2,7.0,0.0
52592,3269,2,44,2,48,4,3,22.0,0.0
52594,6403,5,96,5,106,10,6,19.2,0.0
52595,7318,6,120,6,132,12,7,20.0,0.0
52596,20089,31,217,31,279,62,32,7.0,0.0
52597,1108,1,7,1,9,2,2,7.0,0.0
52598,37199,32,596,32,660,64,33,18.625,0.0
52599,13621,21,166,21,208,42,22,7.905,0.0
5260,11065,35,105,35,175,70,36,3.0,0.0
52600,2780,2,36,2,40,4,3,18.0,0.0
52601,8082,7,126,7,140,14,8,18.0,0.0
52602,2915,2,39,2,43,4,3,19.5,0.0
52604,5506,13,39,13,65,26,14,3.0,0.0
52607,7867,16,92,16,124,32,17,5.75,0.0
52608,4452,4,63,4,71,8,5,15.75,0.0
52609,3867,0,36,0,42,6,7,6.0,0.0
5261,1077215,500,11354,500,12354,1000,501,22.708,0.0
52610,9866,8,156,8,172,16,9,19.5,0.0
52611,3656,3,50,3,56,6,4,16.667,0.0
52612,9523,8,154,8,170,16,9,19.25,0.0
52614,4153,3,60,3,66,6,4,20.0,0.0
52615,1618,3,9,3,15,6,4,3.0,0.0
52616,1029,0,3,0,4,1,2,3.0,0.0
52617,14681,12,240,12,264,24,13,20.0,0.0
52618,5411,7,62,7,76,14,8,8.857,0.0
52619,8705,7,133,7,147,14,8,19.0,0.0
5262,376584,500,5069,500,6069,1000,501,10.138,0.5
52620,9044,0,92,0,115,23,24,4.0,0.0
52622,4795,4,66,4,74,8,5,16.5,0.0
52624,4027,10,30,10,50,20,11,3.0,0.0
52625,5361,4,82,4,90,8,5,20.5,0.0
52626,9128,7,145,7,159,14,8,20.714,0.0
52627,18324,16,303,16,335,32,17,18.938,0.0
52628,5325,4,80,4,88,8,5,20.0,0.0
52629,11435,25,100,25,150,50,26,4.0,0.0
52630,2099,4,12,4,20,8,5,3.0,0.0
52631,8364,13,85,13,111,26,14,6.538,0.0
52632,2626,3,12,3,18,6,4,4.0,0.5
52633,1047,1,6,1,8,2,2,6.0,0.0
52635,4460,11,33,11,55,22,12,3.0,0.0
52636,11185,8,178,8,194,16,9,22.25,0.0
52637,5574,7,61,7,75,14,8,8.714,0.0
52638,14730,12,240,12,264,24,13,20.0,0.0
52639,9715,8,162,8,178,16,9,20.25,0.0
52640,5895,5,90,5,100,10,6,18.0,0.0
52641,29254,22,445,22,489,44,23,20.227,0.0
52642,5134,4,82,4,90,8,5,20.5,0.0
52643,7819,16,64,16,96,32,17,4.0,0.0
52644,2520,2,29,2,33,4,3,14.5,0.0
52645,7987,16,96,16,128,32,17,6.0,0.0
52646,67143,58,1167,58,1283,116,59,20.121,0.0
52647,8628,7,139,7,153,14,8,19.857,0.0
52648,2544,2,29,2,33,4,3,14.5,0.0
52649,6468,5,100,5,110,10,6,20.0,0.0
52651,5286,4,78,4,86,8,5,19.5,0.0
52652,1101,1,4,1,6,2,2,4.0,0.0
52653,6495,10,79,10,99,20,11,7.9,0.0
52657,5323,4,82,4,90,8,5,20.5,0.0
52658,11032,24,120,24,168,48,25,5.0,0.0
52659,4816,4,70,4,78,8,5,17.5,0.0
52668,3724,3,53,3,59,6,4,17.667,0.0
52669,5974,8,50,8,66,16,9,6.25,0.0
52670,12322,11,192,11,214,22,12,17.455,0.0
52672,16216,0,260,0,280,20,21,13.0,0.0
52673,5928,8,72,8,88,16,9,9.0,0.0
52674,4078,3,60,3,66,6,4,20.0,0.0
52676,4119,3,58,3,64,6,4,19.333,0.0
52677,2139,6,6,6,18,12,7,1.0,0.0
52679,10153,6,84,6,96,12,7,14.0,0.0
52680,2099,4,12,4,20,8,5,3.0,0.0
52681,16222,16,257,16,289,32,17,16.062,0.0
52684,5834,5,89,5,99,10,6,17.8,0.0
52685,6422,5,101,5,111,10,6,20.2,0.0
52686,2948,2,42,2,46,4,3,21.0,0.0
52687,10815,9,172,9,190,18,10,19.111,0.0
52689,18406,17,295,17,329,34,18,17.353,0.0
5269,2559184,500,53475,500,54475,1000,501,106.95,0.0
52691,4930,4,70,4,78,8,5,17.5,0.0
52693,4454,6,50,6,62,12,7,8.333,0.0
52695,4154,3,60,3,66,6,4,20.0,0.0
52699,5293,0,24,0,27,3,4,8.0,0.0
52700,21456,0,312,0,338,26,27,12.0,0.0
52701,12389,9,199,9,217,18,10,22.111,0.0
52702,1097,1,7,1,9,2,2,7.0,0.0
52703,1011,1,5,1,7,2,2,5.0,0.0
52705,4605,7,48,7,62,14,8,6.857,0.0
52706,6268,5,99,5,109,10,6,19.8,0.0
52708,5076,4,74,4,82,8,5,18.5,0.0
52709,2372,2,29,2,33,4,3,14.5,0.0
52710,1254,1,7,1,9,2,2,7.0,0.0
52711,6736,5,102,5,112,10,6,20.4,0.0
52713,18985,16,297,16,329,32,17,18.562,0.0
52716,1653,3,9,3,15,6,4,3.0,0.0
52717,5325,4,83,4,91,8,5,20.75,0.0
52718,2396,7,7,7,21,14,8,1.0,0.0
52723,4169,3,58,3,64,6,4,19.333,0.0
52725,6160,7,72,7,86,14,8,10.286,0.0
52726,5658,5,81,5,91,10,6,16.2,0.0
52727,8219,0,144,0,150,6,7,24.0,0.0
52729,5509,4,84,4,92,8,5,21.0,0.0
52730,5396,4,83,4,91,8,5,20.75,0.0
52732,1536,1,14,1,16,2,2,14.0,0.0
52733,2872,6,18,6,30,12,7,3.0,0.0
52735,3954,3,57,3,63,6,4,19.0,0.0
52739,58308,50,966,50,1066,100,51,19.32,0.0
52740,5508,4,77,4,85,8,5,19.25,0.0
52742,11936,9,195,9,213,18,10,21.667,0.5
52745,5644,4,82,4,90,8,5,20.5,0.0
52746,2189,4,16,4,24,8,5,4.0,0.0
52748,9848,8,145,8,161,16,9,18.125,0.0
52750,4527,6,66,6,78,12,7,11.0,0.0
52751,4570,3,53,3,59,6,4,17.667,0.0
52758,1072,1,6,1,8,2,2,6.0,0.0
52760,3057,2,42,2,46,4,3,21.0,0.0
52761,1091,1,7,1,9,2,2,7.0,0.0
52763,3192,6,30,6,42,12,7,5.0,0.0
52764,1099,1,7,1,9,2,2,7.0,0.0
52765,1748,1,19,1,21,2,2,19.0,0.0
52768,4427,3,60,3,66,6,4,20.0,0.0
52770,10195,8,150,8,166,16,9,18.75,0.0
52772,5956,5,91,5,101,10,6,18.2,0.0
52773,7681,7,115,7,129,14,8,16.429,0.0
52779,27549,24,438,24,486,48,25,18.25,0.0
52780,55833,48,936,48,1032,96,49,19.5,0.0
52781,20432,42,374,42,458,84,44,8.905,0.0
52782,1086,1,7,1,9,2,2,7.0,0.0
52786,5095,4,73,4,81,8,5,18.25,0.0
52789,3066,2,41,2,45,4,3,20.5,0.0
5279,460054,0,7500,0,8000,500,501,15.0,0.75
52792,22564,30,330,30,390,60,31,11.0,0.0
52793,5233,7,58,7,72,14,8,8.286,0.0
52794,1053,1,6,1,8,2,2,6.0,0.0
52796,5700,4,82,4,90,8,5,20.5,0.0
5280,265629,0,3500,0,4000,500,501,7.0,0.0
52801,4440,3,60,3,66,6,4,20.0,0.0
52803,1431,2,8,2,12,4,3,4.0,0.0
52805,28119,60,360,60,480,120,61,6.0,0.0
52806,2212,0,12,0,16,4,5,3.0,0.0
52807,6314,5,97,5,107,10,6,19.4,0.0
52808,13796,36,180,36,252,72,38,5.0,0.0
52809,10793,9,175,9,193,18,10,19.444,0.0
5281,270170,0,3500,0,4000,500,501,7.0,0.0
52810,5527,4,84,4,92,8,5,21.0,0.0
52811,1737,1,19,1,21,2,2,19.0,0.0
52812,3560,3,50,3,56,6,4,16.667,0.0
52813,2218,5,15,5,25,10,6,3.0,0.0
52814,8935,8,143,8,159,16,9,17.875,0.0
52815,4190,3,62,3,68,6,4,20.667,0.0
52816,2457,5,20,5,30,10,6,4.0,0.0
52817,8539,7,125,7,139,14,8,17.857,0.0
52818,2579,5,15,5,25,10,6,3.0,0.0
52819,4926,4,73,4,81,8,5,18.25,0.0
5282,6525,19,57,19,95,38,20,3.0,0.0
52820,7572,6,116,6,128,12,7,19.333,0.0
52821,5443,4,80,4,88,8,5,20.0,0.0
52823,4787,4,68,4,76,8,5,17.0,0.0
52825,5631,0,104,0,108,4,5,26.0,0.75
52826,11371,9,170,9,188,18,10,18.889,0.0
52827,5732,5,85,5,95,10,6,17.0,0.0
52829,1495,2,8,2,12,4,3,4.0,0.0
5283,9249731,3551,73200,3551,80302,7102,3553,20.614,0.0
52831,2160,0,16,0,20,4,5,4.0,0.0
52833,5042,4,73,4,81,8,5,18.25,0.0
52836,10089,13,145,13,171,26,14,11.154,0.0
5284,1027872,0,10222,0,10722,500,501,20.444,1.0
52843,2618,4,22,4,30,8,5,5.5,0.0
52844,4816,4,70,4,78,8,5,17.5,0.0
52845,1760,1,20,1,22,2,2,20.0,0.0
52846,5490,5,82,5,92,10,6,16.4,0.0
52848,4084,3,60,3,66,6,4,20.0,0.0
52849,2446,4,15,4,23,8,5,3.75,0.0
5285,6534660,3362,71660,3362,78384,6724,3364,21.315,0.0
52850,4951,4,74,4,82,8,5,18.5,0.0
52851,5410,4,74,4,82,8,5,18.5,0.0
52852,37211,30,642,30,702,60,31,21.4,0.0
52853,2941,2,39,2,43,4,3,19.5,0.0
52854,2997,4,20,4,28,8,5,5.0,0.75
52855,5325,4,80,4,88,8,5,20.0,0.0
52857,5198,4,80,4,88,8,5,20.0,0.0
52858,15927,15,255,15,285,30,16,17.0,0.0
52859,9203,7,144,7,158,14,8,20.571,0.0
5286,4856,0,60,0,70,10,11,6.0,0.0
52861,6233,5,99,5,109,10,6,19.8,0.0
52862,4067,3,57,3,63,6,4,19.0,0.0
52863,4219,3,61,3,67,6,4,20.333,0.0
52866,22813,60,340,60,460,120,62,5.667,0.0
52868,6308,5,101,5,111,10,6,20.2,0.0
52874,15899,15,253,15,283,30,16,16.867,0.0
52877,10836,8,171,8,187,16,9,21.375,0.0
5288,3075,0,40,0,45,5,6,8.0,0.0
52880,1012,1,4,1,6,2,2,4.0,0.0
52883,5211,4,80,4,88,8,5,20.0,0.0
52889,27337,25,438,25,488,50,26,17.52,0.0
5289,3798,0,40,0,50,10,11,4.0,0.0
52892,4599,3,53,3,59,6,4,17.667,0.0
52893,1016,1,3,1,5,2,2,3.0,0.0
52894,3735,3,51,3,57,6,4,17.0,0.0
52896,5186,4,80,4,88,8,5,20.0,0.0
52898,3931,5,40,5,50,10,6,8.0,0.0
5290,274490,500,3861,500,4861,1000,501,7.722,0.0
52901,13998,30,150,30,210,60,31,5.0,0.0
5291,1374105,985,10710,985,12680,1970,987,10.873,0.0
52911,4353,3,66,3,72,6,4,22.0,0.0
52913,6765,24,24,24,72,48,25,1.0,0.0
52914,58176,50,992,50,1092,100,51,19.84,0.0
52916,9099,7,145,7,159,14,8,20.714,0.0
52917,7343,6,120,6,132,12,7,20.0,0.0
52918,1295,2,6,2,10,4,3,3.0,0.0
52919,19135,46,276,46,368,92,48,6.0,0.0
5292,844447,985,10726,985,12696,1970,987,10.889,0.0
52920,4071,3,63,3,69,6,4,21.0,0.0
52922,5977,4,77,4,85,8,5,19.25,0.0
52923,19219,20,323,20,363,40,21,16.15,0.0
52926,1079,1,5,1,7,2,2,5.0,0.0
52927,17746,15,285,15,315,30,16,19.0,0.0
52929,4427,3,60,3,66,6,4,20.0,0.0
5293,1617771,1025,10984,1025,13034,2050,1027,10.716,0.0
52931,11648,43,43,43,129,86,44,1.0,0.0
52933,2768,2,38,2,42,4,3,19.0,0.0
52937,9128,7,145,7,159,14,8,20.714,0.0
5294,918880,985,10726,985,12696,1970,987,10.889,0.0
52943,27169,25,432,25,482,50,26,17.28,0.0
52946,4005,3,58,3,64,6,4,19.333,0.0
52948,6532,0,104,0,109,5,6,20.8,0.0
5295,300311,0,5976,0,6476,500,501,11.952,0.5
52951,1095,1,7,1,9,2,2,7.0,0.0
52952,1763,2,14,2,18,4,3,7.0,0.0
52953,21157,80,80,80,240,160,81,1.0,0.0
52956,5574,7,61,7,75,14,8,8.714,0.0
5296,196264,0,3000,0,3500,500,501,6.0,0.5
52961,16327,12,260,12,284,24,13,21.667,0.0
52962,4599,3,53,3,59,6,4,17.667,0.0
52963,5985,4,84,4,92,8,5,21.0,0.0
52964,1491,0,10,0,12,2,3,5.0,0.0
52965,12551,9,203,9,221,18,10,22.556,0.0
52966,7933,6,125,6,137,12,7,20.833,0.0
52967,6189,5,92,5,102,10,6,18.4,0.0
52968,4153,3,60,3,66,6,4,20.0,0.0
52969,2978,2,39,2,43,4,3,19.5,0.0
52970,19042,46,276,46,368,92,48,6.0,0.0
52971,2645,4,15,4,23,8,5,3.75,0.0
52972,4075,3,57,3,63,6,4,19.0,0.0
52973,1101,1,4,1,6,2,2,4.0,0.0
52975,7597,6,116,6,128,12,7,19.333,0.0
52977,5120,0,74,0,78,4,5,18.5,0.0
52978,6447,5,100,5,110,10,6,20.0,0.0
52979,11378,10,178,10,198,20,11,17.8,0.0
52980,22412,30,319,30,379,60,31,10.633,0.0
52981,22250,19,357,19,395,38,20,18.789,0.0
52982,2463,4,15,4,23,8,5,3.75,0.0
52984,1052,1,5,1,7,2,2,5.0,0.0
52987,6230,5,96,5,106,10,6,19.2,0.0
52990,2033,2,17,2,21,4,3,8.5,1.0
52995,4200,3,60,3,66,6,4,20.0,0.5
52997,16533,40,240,40,320,80,42,6.0,0.0
52998,4452,15,15,15,45,30,16,1.0,0.0
53000,41918,36,687,36,759,72,37,19.083,0.0
53002,4231,9,36,9,54,18,10,4.0,0.5
53003,5359,4,81,4,89,8,5,20.25,0.0
53004,942,1,3,1,5,2,2,3.0,0.0
53006,5523,4,84,4,92,8,5,21.0,0.0
53010,4385,3,65,3,71,6,4,21.667,0.0
53014,2982,5,25,5,35,10,6,5.0,0.0
53015,27915,31,447,31,509,62,32,14.419,0.0
53022,1785,1,20,1,22,2,2,20.0,0.0
53024,10947,10,171,10,191,20,11,17.1,0.0
53025,7908,6,125,6,137,12,7,20.833,0.0
53026,4310,3,62,3,68,6,4,20.667,0.0
53028,5244,4,80,4,88,8,5,20.0,0.0
53029,4063,3,61,3,67,6,4,20.333,0.0
5303,455627,500,6082,500,7082,1000,501,12.164,1.0
53032,4099,3,62,3,68,6,4,20.667,0.0
53033,2551,2,29,2,33,4,3,14.5,0.0
53035,10886,10,168,10,188,20,11,16.8,0.0
53037,4570,3,53,3,59,6,4,17.667,0.0
53039,4012,3,58,3,64,6,4,19.333,0.0
5304,1111847,907,11942,907,13756,1814,909,13.166,1.0
53041,2308,3,12,3,18,6,4,4.0,0.0
53045,4713,4,70,4,78,8,5,17.5,0.0
53046,9806,8,156,8,172,16,9,19.5,0.0
5305,823316,915,9490,915,11320,1830,917,10.372,0.0
53055,5488,5,82,5,92,10,6,16.4,0.0
53059,4216,4,57,4,65,8,5,14.25,0.0
5306,712176,909,9454,909,11272,1818,911,10.4,0.0
53061,5917,4,79,4,87,8,5,19.75,0.0
53065,4945,4,72,4,80,8,5,18.0,0.0
53076,2600,5,15,5,25,10,6,3.0,0.0
53077,7665,7,111,7,125,14,8,15.857,0.0
53079,2035,3,18,3,24,6,4,6.0,0.0
53082,16433,0,168,0,210,42,43,4.0,0.0
53083,1748,1,19,1,21,2,2,19.0,0.0
53084,4253,3,62,3,68,6,4,20.667,0.0
53085,8719,7,141,7,155,14,8,20.143,0.0
53086,5013,4,74,4,82,8,5,18.5,0.0
53087,2872,2,39,2,43,4,3,19.5,0.0
53088,6780,5,105,5,115,10,6,21.0,0.0
53090,7987,16,96,16,128,32,17,6.0,0.0
53091,4764,4,70,4,78,8,5,17.5,0.0
53092,9717,8,155,8,171,16,9,19.375,0.0
53094,4356,3,58,3,64,6,4,19.333,0.0
53095,3912,3,57,3,63,6,4,19.0,0.0
53096,6228,5,98,5,108,10,6,19.6,0.0
53097,2391,2,29,2,33,4,3,14.5,0.0
53098,8288,7,134,7,148,14,8,19.143,0.0
53099,3826,3,54,3,60,6,4,18.0,0.5
53100,4396,3,63,3,69,6,4,21.0,0.0
53102,6815,6,105,6,117,12,7,17.5,0.0
53103,9994,36,36,36,108,72,37,1.0,0.0
53104,4127,3,57,3,63,6,4,19.0,0.0
53105,2462,2,31,2,35,4,3,15.5,0.0
53106,5375,4,79,4,87,8,5,19.75,0.0
53107,7220,6,114,6,126,12,7,19.0,0.0
53109,6112,5,85,5,95,10,6,17.0,0.0
5311,290756,0,5000,0,5500,500,501,10.0,0.0
53110,1644,3,9,3,15,6,4,3.0,0.0
53111,6373,0,98,0,103,5,6,19.6,0.0
53112,7528,6,115,6,127,12,7,19.167,0.0
53114,2660,6,18,6,30,12,7,3.0,0.0
53115,4119,3,61,3,67,6,4,20.333,0.0
53116,3717,8,32,8,48,16,9,4.0,0.0
53117,6343,0,99,0,104,5,6,19.8,0.0
53118,5212,4,76,4,84,8,5,19.0,0.0
53119,3999,3,61,3,67,6,4,20.333,0.0
5312,289996,0,5000,0,5500,500,501,10.0,0.0
53121,7091,4,83,4,91,8,5,20.75,0.0
53122,6034,5,91,5,101,10,6,18.2,0.0
53124,5130,4,80,4,88,8,5,20.0,0.0
53125,4662,3,60,3,66,6,4,20.0,0.0
53127,6315,0,99,0,104,5,6,19.8,0.0
53128,7373,6,120,6,132,12,7,20.0,0.0
5313,292314,0,5000,0,5500,500,501,10.0,0.0
53130,7057,10,92,10,112,20,11,9.2,0.0
53131,3904,6,36,6,48,12,7,6.0,0.0
53132,3077,3,39,3,45,6,4,13.0,0.0
53134,3963,3,57,3,63,6,4,19.0,0.0
53136,2818,2,38,2,42,4,3,19.0,0.0
53137,4583,3,53,3,59,6,4,17.667,0.0
5314,197274,0,3000,0,3500,500,501,6.0,0.5
53141,1045,1,5,1,7,2,2,5.0,0.0
53142,12059,10,208,10,228,20,11,20.8,0.0
53143,1431,2,8,2,12,4,3,4.0,0.0
53144,3948,3,56,3,62,6,4,18.667,0.0
53146,1625,4,4,4,12,8,5,1.0,0.0
53147,3966,3,57,3,63,6,4,19.0,0.0
53149,16144,39,156,39,234,78,40,4.0,0.0
5315,812169,0,13992,0,14492,500,501,27.984,0.0
53150,14954,12,246,12,270,24,13,20.5,0.0
53155,5219,4,71,4,79,8,5,17.75,0.0
53157,5509,4,84,4,92,8,5,21.0,0.0
53158,4460,11,33,11,55,22,12,3.0,0.0
53159,5110,4,80,4,88,8,5,20.0,0.0
5316,341798,610,4665,610,5885,1220,612,7.648,0.0
53160,6259,0,96,0,101,5,6,19.2,0.0
53161,1759,1,20,1,22,2,2,20.0,0.0
53162,2249,4,16,4,24,8,5,4.0,0.0
53163,1806,1,20,1,22,2,2,20.0,0.0
53164,22769,48,288,48,384,96,49,6.0,0.0
53165,6237,5,96,5,106,10,6,19.2,0.0
53166,7597,7,117,7,131,14,8,16.714,0.0
53167,21157,80,80,80,240,160,81,1.0,0.0
53168,989,1,4,1,6,2,2,4.0,0.0
53169,17940,15,305,15,335,30,16,20.333,0.0
5317,1227472,1000,11282,1000,13282,2000,1002,11.282,0.0
53170,1618,3,9,3,15,6,4,3.0,0.0
53172,6091,5,85,5,95,10,6,17.0,0.0
53173,8782,0,40,0,45,5,6,8.0,0.0
53174,16469,40,240,40,320,80,42,6.0,0.0
53176,3209,2,45,2,49,4,3,22.5,0.0
53178,9099,7,145,7,159,14,8,20.714,0.0
53179,14218,53,53,53,159,106,54,1.0,0.0
5318,1051394,1000,11282,1000,13282,2000,1002,11.282,0.0
53180,5270,4,79,4,87,8,5,19.75,0.0
53181,1790,1,20,1,22,2,2,20.0,0.0
53182,3861,3,53,3,59,6,4,17.667,0.0
53183,1356,1,10,1,12,2,2,10.0,0.0
53184,6285,4,82,4,90,8,5,20.5,0.0
53185,9467,9,143,9,161,18,10,15.889,0.0
53186,5438,4,83,4,91,8,5,20.75,0.0
53187,2378,2,17,2,21,4,3,8.5,0.0
53188,7090,3,33,3,39,6,4,11.0,0.0
53189,21993,19,369,19,407,38,20,19.421,0.0
5319,1075565,1000,9286,1000,11286,2000,1002,9.286,0.0
53191,3681,12,12,12,36,24,13,1.0,0.0
53192,6673,5,103,5,113,10,6,20.6,0.0
53193,9898,8,152,8,168,16,9,19.0,0.0
53194,2685,6,18,6,30,12,7,3.0,0.0
53198,3424,11,11,11,33,22,12,1.0,0.0
5320,1317484,1000,9284,1000,11284,2000,1002,9.284,0.0
53200,5356,4,74,4,82,8,5,18.5,0.0
53201,6495,0,99,0,104,5,6,19.8,0.0
53204,4212,3,57,3,63,6,4,19.0,0.0
53207,4036,3,62,3,68,6,4,20.667,0.0
53208,6250,5,97,5,107,10,6,19.4,0.0
53209,1625,4,4,4,12,8,5,1.0,0.0
5321,876478,1000,11290,1000,13290,2000,1002,11.29,0.0
53211,7642,6,114,6,126,12,7,19.0,0.0
53212,3861,3,53,3,59,6,4,17.667,0.0
53213,3054,2,40,2,44,4,3,20.0,0.0
53214,6230,5,96,5,106,10,6,19.2,0.0
53216,2910,9,9,9,27,18,10,1.0,0.0
53217,4055,3,59,3,65,6,4,19.667,0.0
53218,10106,37,37,37,111,74,38,1.0,0.0
5322,709339,1000,9288,1000,11288,2000,1002,9.288,0.0
53221,6174,5,94,5,104,10,6,18.8,0.0
53222,7318,6,120,6,132,12,7,20.0,0.0
53223,426396,470,5922,470,6862,940,472,12.6,0.0
53225,985,1,4,1,6,2,2,4.0,0.0
53226,3813,3,54,3,60,6,4,18.0,0.5
53228,4482,3,65,3,71,6,4,21.667,0.0
53229,1368,3,3,3,9,6,4,1.0,0.0
5323,948771,1000,11282,1000,13282,2000,1002,11.282,0.0
53239,5644,4,82,4,90,8,5,20.5,0.0
5324,812510,1000,11278,1000,13278,2000,1002,11.278,0.0
53240,1678,3,9,3,15,6,4,3.0,1.0
53244,2818,2,38,2,42,4,3,19.0,0.0
53245,2378,2,17,2,21,4,3,8.5,0.0
53246,3539,4,38,4,46,8,5,9.5,0.0
53247,5664,4,84,4,92,8,5,21.0,0.0
53248,3966,3,57,3,63,6,4,19.0,1.0
53249,4887,4,70,4,78,8,5,17.5,0.0
53251,7793,28,28,28,84,56,29,1.0,0.0
53252,10967,9,178,9,196,18,10,19.778,0.0
53253,2970,4,20,4,28,8,5,5.0,0.0
53254,22231,22,347,22,391,44,23,15.773,0.0
53255,7016,10,92,10,112,20,11,9.2,0.0
53256,4534,4,66,4,74,8,5,16.5,0.0
53257,1882,5,5,5,15,10,6,1.0,0.0
53259,6589,5,100,5,110,10,6,20.0,0.0
53262,3953,3,57,3,63,6,4,19.0,0.5
53263,6468,5,101,5,111,10,6,20.2,0.0
53266,1562,2,10,2,14,4,3,5.0,0.0
53267,2645,4,15,4,23,8,5,3.75,0.0
53268,3140,6,24,6,36,12,7,4.0,0.0
53269,3827,3,54,3,60,6,4,18.0,0.5
53271,13723,36,180,36,252,72,38,5.0,0.0
53273,5296,18,18,18,54,36,19,1.0,0.0
53274,6462,0,99,0,104,5,6,19.8,0.0
53276,11648,43,43,43,129,86,44,1.0,0.0
53277,2752,3,31,3,37,6,4,10.333,0.0
53278,5173,4,74,4,82,8,5,18.5,0.0
53280,6296,0,99,0,104,5,6,19.8,0.0
53281,5977,4,77,4,85,8,5,19.25,0.0
53282,4047,3,62,3,68,6,4,20.667,0.0
53283,6340,22,22,22,66,44,23,1.0,0.0
53284,8503,16,69,16,101,32,17,4.312,0.0
53285,3081,5,25,5,35,10,6,5.0,0.0
53286,4974,4,71,4,79,8,5,17.75,0.0
53288,6418,0,99,0,104,5,6,19.8,0.0
53293,6939,6,111,6,123,12,7,18.5,0.0
53297,1536,2,10,2,14,4,3,5.0,0.0
5330,1043849,985,8730,985,10700,1970,987,8.863,0.0
53302,5069,4,76,4,84,8,5,19.0,0.0
53303,3954,3,57,3,63,6,4,19.0,0.0
53307,6346,0,94,0,99,5,6,18.8,0.0
5331,1155884,910,11460,910,13280,1820,912,12.593,0.0
53313,6446,0,99,0,104,5,6,19.8,0.0
53315,21478,80,80,80,240,160,81,1.0,0.0
53316,2396,7,7,7,21,14,8,1.0,0.0
53319,3586,3,51,3,57,6,4,17.0,0.0
5332,1208390,910,9460,910,11280,1820,912,10.396,0.0
53321,10839,9,162,9,180,18,10,18.0,0.0
53322,5554,4,61,4,69,8,5,15.25,0.0
53324,2849,2,38,2,42,4,3,19.0,0.0
53326,4338,3,63,3,69,6,4,21.0,0.0
53327,7681,7,115,7,129,14,8,16.429,0.0
53329,4966,17,17,17,51,34,18,1.0,0.0
53330,7262,4,88,4,96,8,5,22.0,0.0
53331,5112,4,73,4,81,8,5,18.25,0.0
53333,1995,4,12,4,20,8,5,3.0,0.0
53338,44283,36,732,36,804,72,37,20.333,0.0
5334,1107198,908,11948,908,13764,1816,910,13.159,0.0
53340,1064,1,4,1,6,2,2,4.0,0.0
53341,5400,4,77,4,85,8,5,19.25,0.0
53343,5265,4,78,4,86,8,5,19.5,0.0
53345,3832,3,54,3,60,6,4,18.0,0.5
53347,4143,3,59,3,65,6,4,19.667,0.0
53348,7022,25,25,25,75,50,26,1.0,0.0
53349,2396,7,7,7,21,14,8,1.0,0.0
5335,1052897,910,9460,910,11280,1820,912,10.396,0.0
53350,3814,3,54,3,60,6,4,18.0,0.5
53352,5994,21,21,21,63,42,22,1.0,0.0
53353,4182,3,61,3,67,6,4,20.333,0.0
53354,5205,4,77,4,85,8,5,19.25,0.0
53355,12263,0,194,0,204,10,11,19.4,0.0
53356,2396,7,7,7,21,14,8,1.0,0.0
53357,1642,4,4,4,12,8,5,1.0,0.0
53358,8289,7,129,7,143,14,8,18.429,0.0
5336,951063,909,11954,909,13772,1818,911,13.151,0.0
53361,27851,24,465,24,513,48,25,19.375,0.0
53364,12066,24,139,24,187,48,25,5.792,0.0
53366,21478,80,80,80,240,160,81,1.0,0.0
53368,5545,4,87,4,95,8,5,21.75,0.0
53369,5943,5,92,5,102,10,6,18.4,0.0
5337,1047901,909,9454,909,11272,1818,911,10.4,0.0
53371,2806,5,28,5,38,10,6,5.6,0.0
53372,2139,6,6,6,18,12,7,1.0,0.0
53375,6079,21,21,21,63,42,22,1.0,0.0
53377,2425,7,7,7,21,14,8,1.0,0.0
53379,6187,0,99,0,104,5,6,19.8,0.0
5338,656810,910,9460,910,11280,1820,912,10.396,0.0
53380,6462,0,99,0,104,5,6,19.8,0.0
53383,1625,4,4,4,12,8,5,1.0,0.0
53384,5007,4,72,4,80,8,5,18.0,0.0
53385,1111,2,2,2,6,4,3,1.0,0.0
53387,5652,5,82,5,92,10,6,16.4,0.0
53389,3167,10,10,10,30,20,11,1.0,0.0
5339,449446,500,6095,500,7095,1000,501,12.19,0.5
53397,1865,2,18,2,22,4,3,9.0,0.0
5340,886406,920,11936,920,13776,1840,922,12.974,0.0
53400,4179,3,62,3,68,6,4,20.667,0.0
53404,5994,21,21,21,63,42,22,1.0,0.0
53409,1860,3,14,3,20,6,4,4.667,0.0
5341,822366,927,9486,927,11340,1854,929,10.233,0.0
53411,8167,29,29,29,87,58,30,1.0,0.0
53413,6318,0,99,0,104,5,6,19.8,0.0
53416,7343,6,120,6,132,12,7,20.0,0.0
53417,2164,4,16,4,24,8,5,4.0,0.0
53418,6468,0,99,0,104,5,6,19.8,0.0
53419,7221,6,116,6,128,12,7,19.333,0.0
5342,717700,926,9482,926,11334,1852,928,10.24,0.0
53429,5223,18,18,18,54,36,19,1.0,0.0
5343,680503,0,11701,0,12201,500,501,23.402,0.0
53433,7492,10,87,10,107,20,11,8.7,0.0
53435,3167,10,10,10,30,20,11,1.0,0.0
5344,222597,87,4437,87,4611,174,88,51.0,0.0
53442,1711,1,19,1,21,2,2,19.0,0.0
53445,19080,26,267,26,319,52,27,10.269,0.0
5345,449167,0,6114,0,6614,500,501,12.228,0.75
53452,6466,5,105,5,115,10,6,21.0,0.0
53455,14989,56,56,56,168,112,57,1.0,0.0
5346,1181650,422,11188,422,12532,1344,924,12.134,0.0
53462,16327,12,260,12,284,24,13,21.667,0.0
53463,5994,21,21,21,63,42,22,1.0,0.0
53465,1678,3,9,3,15,6,4,3.0,1.0
53466,1015,1,5,1,7,2,2,5.0,0.0
53467,3492,5,35,5,45,10,6,7.0,0.0
53468,8050,29,29,29,87,58,30,1.0,0.0
53469,1380,2,8,2,12,4,3,4.0,0.0
5347,1378298,420,12016,420,13356,1340,922,13.061,0.0
53470,2396,7,7,7,21,14,8,1.0,0.0
53472,18046,42,210,42,294,84,44,5.0,0.0
53474,1759,1,20,1,22,2,2,20.0,0.0
53475,7995,6,126,6,138,12,7,21.0,0.0
53478,1642,3,9,3,15,6,4,3.0,0.0
53479,30152,115,115,115,345,230,116,1.0,0.0
5348,1152954,920,12016,920,13856,1840,922,13.061,0.0
53480,2847,5,25,5,35,10,6,5.0,0.0
53481,20864,18,347,18,383,36,19,19.278,0.0
53483,1111,2,2,2,6,4,3,1.0,0.0
53484,1150,1,6,1,8,2,2,6.0,0.0
53488,5994,21,21,21,63,42,22,1.0,0.0
5349,898656,0,10337,0,10837,500,501,20.674,0.0
53492,7022,25,25,25,75,50,26,1.0,0.0
53493,7665,7,111,7,125,14,8,15.857,0.0
53494,1600,3,8,3,14,6,4,2.667,0.0
53495,5737,20,20,20,60,40,21,1.0,0.0
53496,1120,2,2,2,6,4,3,1.0,0.0
53497,2959,2,42,2,46,4,3,21.0,0.0
5350,941601,0,10337,0,10837,500,501,20.674,1.0
53500,1642,4,4,4,12,8,5,1.0,0.0
53502,7045,0,105,0,111,6,7,17.5,0.0
53503,2673,4,24,4,32,8,5,6.0,0.0
53504,3088,3,39,3,45,6,4,13.0,0.0
53505,1625,4,4,4,12,8,5,1.0,0.0
53506,1770,3,12,3,18,6,4,4.0,0.0
53507,2396,7,7,7,21,14,8,1.0,0.0
53508,6765,24,24,24,72,48,25,1.0,0.0
53509,1655,3,9,3,15,6,4,3.0,0.0
5351,757279,0,10338,0,10838,500,501,20.676,1.0
53510,5223,18,18,18,54,36,19,1.0,0.0
53511,21157,80,80,80,240,160,81,1.0,0.0
53512,5282,4,78,4,86,8,5,19.5,0.0
53513,5931,11,44,11,66,22,12,4.0,0.5
53514,4073,3,57,3,63,6,4,19.0,0.0
53515,7022,25,25,25,75,50,26,1.0,0.0
53516,18607,69,69,69,207,138,70,1.0,0.0
53517,1642,4,4,4,12,8,5,1.0,0.0
53518,2653,8,8,8,24,16,9,1.0,0.0
53524,1158,1,6,1,8,2,2,6.0,0.0
53525,1588,1,16,1,18,2,2,16.0,1.0
53529,5737,20,20,20,60,40,21,1.0,0.0
5353,1441969,1000,11280,1000,13280,2000,1002,11.28,0.0
53532,1882,5,5,5,15,10,6,1.0,0.0
53534,3681,12,12,12,36,24,13,1.0,0.0
53535,18330,69,69,69,207,138,70,1.0,0.0
5354,1633668,500,11288,500,12788,1500,1002,11.288,0.0
53541,8248,7,124,7,138,14,8,17.714,0.0
53545,21157,80,80,80,240,160,81,1.0,0.0
53546,7667,6,114,6,126,12,7,19.0,0.0
53547,25458,21,423,21,465,42,22,20.143,0.0
53549,5223,18,18,18,54,36,19,1.0,0.0
5355,722393,1000,9284,1000,11284,2000,1002,9.284,0.0
53554,2123,3,18,3,24,6,4,6.0,0.0
53556,4966,17,17,17,51,34,18,1.0,0.0
5356,994539,1000,11286,1000,13286,2000,1002,11.286,0.0
53561,21157,80,80,80,240,160,81,1.0,0.0
53562,3681,12,12,12,36,24,13,1.0,0.0
53563,18607,69,69,69,207,138,70,1.0,0.0
53564,8485,8,138,8,154,16,9,17.25,0.0
53565,18330,69,69,69,207,138,70,1.0,0.0
53566,1111,2,2,2,6,4,3,1.0,0.0
53567,1655,1,18,1,20,2,2,18.0,0.0
53568,2464,5,18,5,28,10,6,3.6,0.0
53569,2396,7,7,7,21,14,8,1.0,0.0
5357,1093925,1000,11346,1000,13346,2000,1002,11.346,0.0
53570,11134,41,41,41,123,82,42,1.0,0.0
53571,5223,18,18,18,54,36,19,1.0,0.0
53572,18330,69,69,69,207,138,70,1.0,0.0
53573,9849,36,36,36,108,72,37,1.0,0.0
53574,1642,4,4,4,12,8,5,1.0,0.0
53575,2396,7,7,7,21,14,8,1.0,0.0
53576,5818,20,20,20,60,40,21,1.0,0.0
53577,1660,1,18,1,20,2,2,18.0,0.0
53578,25543,21,423,21,465,42,22,20.143,0.0
5358,876663,1000,9288,1000,11288,2000,1002,9.288,0.0
53580,11648,43,43,43,129,86,44,1.0,0.0
53581,21478,80,80,80,240,160,81,1.0,0.0
53583,11648,43,43,43,129,86,44,1.0,0.0
53584,9167,8,144,8,160,16,9,18.0,0.0
53585,18587,70,70,70,210,140,71,1.0,0.0
53586,9994,36,36,36,108,72,37,1.0,0.0
53588,20205,19,320,19,358,38,20,16.842,0.0
53589,2425,7,7,7,21,14,8,1.0,0.0
5359,1070146,1000,11282,1000,13282,2000,1002,11.282,0.0
53592,5296,18,18,18,54,36,19,1.0,0.0
53593,18330,69,69,69,207,138,70,1.0,0.0
53594,7318,6,120,6,132,12,7,20.0,0.0
53596,2947,9,9,9,27,18,10,1.0,0.0
53597,6388,10,60,10,80,20,11,6.0,0.0
53598,3730,12,12,12,36,24,13,1.0,0.0
53600,7318,6,120,6,132,12,7,20.0,0.0
53601,1882,5,5,5,15,10,6,1.0,0.0
53602,2576,5,20,5,30,10,6,4.0,0.0
53603,29301,25,475,25,525,50,26,19.0,0.0
53605,1625,4,4,4,12,8,5,1.0,0.0
53606,18607,69,69,69,207,138,70,1.0,0.0
53607,2396,7,7,7,21,14,8,1.0,0.0
53609,5035,17,17,17,51,34,18,1.0,0.0
5361,818125,1000,11286,1000,13286,2000,1002,11.286,1.0
53610,18587,70,70,70,210,140,71,1.0,0.0
53612,4966,17,17,17,51,34,18,1.0,0.0
53613,1625,4,4,4,12,8,5,1.0,0.0
53614,2425,7,7,7,21,14,8,1.0,0.0
53615,2396,7,7,7,21,14,8,1.0,0.0
53616,2396,7,7,7,21,14,8,1.0,0.0
53618,4966,17,17,17,51,34,18,1.0,0.0
5362,2450147,56,616,56,728,112,58,11.0,0.0
53620,11648,43,43,43,129,86,44,1.0,0.0
53622,6079,21,21,21,63,42,22,1.0,0.0
53623,4930,7,49,7,63,14,8,7.0,0.0
53624,28691,24,475,24,523,48,25,19.792,0.0
53626,20128,19,320,19,358,38,20,16.842,0.0
53627,263600,1000,1000,1000,3000,2000,1001,1.0,0.0
53628,1093783,1000,16809,1000,19809,3000,2002,8.405,0.0
53629,263600,1000,1000,1000,3000,2000,1001,1.0,0.0
53630,259599,1000,1000,1000,3000,2000,1001,1.0,0.0
53631,991794,2000,14796,2000,18796,4000,2002,7.398,0.0
53632,641361,1000,9000,1000,11000,2000,1001,9.0,0.0
53633,688250,0,9959,0,10959,1000,1001,9.959,0.5
53634,960797,1000,14476,1000,17476,3000,2002,7.238,0.0
53635,678086,1000,9522,1000,11522,2000,1001,9.522,0.0
53636,682526,1000,9942,1000,11942,2000,1001,9.942,0.0
53637,5344,9,54,9,72,18,10,6.0,0.0
53638,259599,1000,1000,1000,3000,2000,1001,1.0,0.0
53639,259599,1000,1000,1000,3000,2000,1001,1.0,0.0
53640,12673,0,105,0,140,35,36,3.0,0.0
53641,19919,0,171,0,228,57,58,3.0,0.0
53642,165787,0,1446,0,1928,482,483,3.0,0.0
53643,730259,1000,11000,1000,13000,2000,1001,11.0,0.0
53644,797057,1000,11519,1000,13519,2000,1001,11.519,0.0
53645,947897,1000,14000,1000,16000,2000,1001,14.0,0.0
53646,1619,0,9,0,12,3,4,3.0,0.0
53647,20034,0,171,0,228,57,58,3.0,0.0
53648,800756,1000,11692,1000,13692,2000,1001,11.692,0.0
53649,958210,1000,14000,1000,16000,2000,1001,14.0,0.0
5365,347364,500,5421,500,6421,1000,501,10.842,0.0
53650,22965,0,232,0,290,58,59,4.0,0.0
53651,652437,1000,9000,1000,11000,2000,1001,9.0,0.0
53652,683623,1000,9960,1000,11960,2000,1001,9.96,0.0
53653,713885,1000,11000,1000,13000,2000,1001,11.0,0.0
53654,382804,1000,4000,1000,6000,2000,1001,4.0,0.0
53655,6201,0,45,0,60,15,16,3.0,0.0
53656,9849,24,96,24,144,48,25,4.0,0.0
5366,93237,152,1064,152,1368,304,153,7.0,0.0
5368,284834,500,4000,500,5000,1000,501,8.0,0.0
5369,255576,500,4500,500,5500,1000,501,9.0,0.0
53735,2029661,1000,33453,1000,35453,2000,1001,33.453,0.0
53736,848918,0,5840,0,6155,315,316,18.54,0.75
53737,1003198,0,4969,0,5969,1000,1001,4.969,0.0
53738,1185921,0,17445,0,18445,1000,1001,17.445,0.5
53741,1693242,0,9150,0,10150,1000,1001,9.15,0.5
53742,1230470,0,14461,0,14827,366,367,39.511,0.0
53743,3637291,0,100924,0,101924,1000,1001,100.924,0.75
53744,1671845,0,11608,0,12608,1000,1001,11.608,0.0
53745,1245140,0,12931,0,13931,1000,1001,12.931,0.0
53746,2666147,0,33489,0,34188,699,700,47.91,1.0
5375,1226259,970,10650,970,12590,1940,972,10.979,0.0
53750,9277918,1000,236626,1000,238626,2000,1001,236.626,0.0
53752,1638288,0,21836,0,22836,1000,1001,21.836,0.0
53754,1067212,0,12914,0,13914,1000,1001,12.914,0.5
53756,503783,0,16766,0,16932,166,167,101.0,0.0
53758,1131710,1000,29870,1000,31870,2000,1001,29.87,0.0
5376,862887,994,12458,994,14446,1988,996,12.533,0.5
53760,4203373,1000,111490,1000,113490,2000,1001,111.49,0.0
53762,162806,398,1990,398,2786,796,399,5.0,0.0
53763,4350564,1000,136944,1000,138944,2000,1001,136.944,0.0
53764,1707511,1000,39099,1000,41099,2000,1001,39.099,0.0
53765,3760473,0,89801,0,90801,1000,1001,89.801,0.0
53766,137770,121,1254,121,1496,242,122,10.364,0.75
53767,1230724,1000,30476,1000,32476,2000,1001,30.476,0.0
53768,19623691,0,539808,0,540808,1000,1001,539.808,0.0
53769,1157225,0,15413,0,15793,380,381,40.561,0.0
5377,537395,500,9691,500,10691,1000,501,19.382,0.0
53770,480675,0,6661,0,6941,280,281,23.789,0.0
53771,1358589,1000,33294,1000,35294,2000,1001,33.294,0.0
53772,698944,1000,15888,1000,17888,2000,1001,15.888,0.0
53776,554506,367,9299,367,10033,734,368,25.338,0.0
53777,1119363,1000,29696,1000,31696,2000,1001,29.696,0.0
53779,169984,0,4270,0,4327,57,58,74.912,0.0
5378,380477,500,4919,500,5919,1000,502,9.838,0.5
53780,440867,0,5955,0,6955,1000,1001,5.955,0.0
53781,7017533,0,154922,0,155541,619,620,250.278,0.75
53782,2200,2,42,2,46,4,3,21.0,0.0
53784,817328,1000,12975,1000,14975,2000,1001,12.975,0.0
53785,883313,0,14877,0,15809,932,933,15.962,0.0
53786,1067247,1000,27488,1000,29488,2000,1001,27.488,0.0
53787,1007244,1000,22185,1000,24185,2000,1001,22.185,0.0
53788,755861,59,16363,59,16481,118,60,277.339,1.0
53789,241581,1000,1000,1000,3000,2000,1001,1.0,0.0
53790,8922549,0,154000,0,155000,1000,1001,154.0,0.5
53793,9676158,1000,244103,1000,246103,2000,1001,244.103,0.0
53794,1005641,1000,28268,1000,30268,2000,1001,28.268,0.0
53795,475151,0,14922,0,15006,84,85,177.643,0.5
53798,414269,0,10973,0,11045,72,73,152.403,1.0
53800,2114831,1000,67666,1000,69666,2000,1001,67.666,0.0
53802,6279534,1000,99328,1000,101328,2000,1001,99.328,0.0
53803,60679,0,1361,0,1387,26,27,52.346,1.0
53808,2300907,1000,51217,1000,53217,2000,1001,51.217,0.0
53810,347646,0,3818,0,3901,83,84,46.0,1.0
53812,901510,1000,20025,1000,22025,2000,1001,20.025,0.0
53813,261749,20,4492,20,4532,40,21,224.6,0.0
53818,2636738,1000,55078,1000,57078,2000,1001,55.078,0.0
53819,3855990,0,67120,0,68120,1000,1001,67.12,0.0
5382,350070,500,4000,500,5000,1000,501,8.0,0.0
53820,776846,1000,17222,1000,19222,2000,1001,17.222,0.0
53821,38766,0,955,0,995,40,41,23.875,0.0
53823,2075453,1000,63851,1000,65851,2000,1001,63.851,0.0
53824,2167167,1000,53713,1000,55713,2000,1001,53.713,0.0
53826,4977789,1000,151197,1000,153197,2000,1001,151.197,0.0
53828,5524745,1000,114000,1000,116000,2000,1001,114.0,0.0
53829,2013224,0,52331,0,53331,1000,1001,52.331,0.75
5383,383118,500,3500,500,4500,1000,501,7.0,0.5
53833,42593,106,512,106,724,212,107,4.83,0.0
53834,5007691,1000,155851,1000,157851,2000,1001,155.851,0.0
53835,3241948,1000,58000,1000,60000,2000,1001,58.0,0.0
53837,1500628,0,33234,0,34234,1000,1001,33.234,0.0
53839,839329,1000,18169,1000,20169,2000,1001,18.169,0.0
5384,413234,500,5498,500,6498,1000,501,10.996,0.5
53840,1171656,1000,34368,1000,36368,2000,1001,34.368,0.0
53841,437134,70,13020,70,13160,140,71,186.0,0.0
53842,471323,0,7000,0,8000,1000,1001,7.0,0.0
53843,2433965,843,60425,843,62111,1686,844,71.679,0.0
53845,4656483,1000,134791,1000,136791,2000,1001,134.791,0.0
53847,4670636,1000,145626,1000,147626,2000,1001,145.626,0.0
53848,14700,0,345,0,372,27,28,12.778,0.0
53849,7940708,1000,232306,1000,234306,2000,1001,232.306,0.0
5385,988504,500,10372,500,11372,1000,501,20.744,0.0
53850,11651042,0,374214,0,375214,1000,1001,374.214,0.0
53852,370471,0,5478,0,6478,1000,1001,5.478,0.0
53853,24385,0,472,0,502,30,31,15.733,0.0
53854,739681,0,9888,0,10888,1000,1001,9.888,0.5
53855,8244213,1000,228674,1000,230674,2000,1001,228.674,0.0
53856,1658275,1000,32850,1000,34850,2000,1001,32.85,0.0
53857,449677,37,11508,37,11582,74,38,311.027,0.0
53858,53111,0,675,0,712,37,38,18.243,0.5
5386,446339,500,9985,500,10985,1000,501,19.97,0.0
53862,26920,0,560,0,600,40,41,14.0,0.5
53864,3716914,1000,99596,1000,101596,2000,1001,99.596,0.0
53870,9255421,1000,315000,1000,317000,2000,1001,315.0,0.0
5388,729856,500,12503,500,14003,1500,1002,12.503,0.75
5389,192950,0,2000,0,2500,500,501,4.0,0.5
5390,388586,500,6500,500,7500,1000,501,13.0,0.0
5391,6208,0,60,0,75,15,16,4.0,0.0
5392,172568,0,1904,0,2380,476,477,4.0,0.0
53933,4784,0,41,0,53,12,13,3.417,0.0
53936,1684135,1000,54102,1000,56102,2000,1001,54.102,0.0
53937,1095396,1000,30373,1000,32373,2000,1001,30.373,0.0
53939,22182050,0,317035,0,318035,1000,1001,317.035,0.5
5394,828329,500,14165,500,15665,1500,1002,14.165,0.5833333333333334
53940,1035346,0,24134,0,24854,720,721,33.519,0.0
53941,56145,0,957,0,1021,64,65,14.953,1.0
53942,216940,0,2740,0,3085,345,346,7.942,0.5
53943,6935901,1000,248000,1000,250000,2000,1001,248.0,0.0
53944,6606618,1000,233411,1000,235411,2000,1001,233.411,0.0
53945,635232,0,12468,0,13468,1000,1001,12.468,0.0
53946,952457,1000,22223,1000,24223,2000,1001,22.223,0.0
53947,2763106,0,103000,0,104000,1000,1001,103.0,0.0
53948,2294135,1000,36974,1000,38974,2000,1001,36.974,0.0
5395,1714843,500,21013,500,22013,1000,502,42.026,0.0
53950,158294,207,2691,207,3105,414,208,13.0,0.5
53952,417424,120,5583,120,5823,240,121,46.525,0.0
53955,453575,0,9000,0,10000,1000,1001,9.0,0.0
53956,1085065,1000,29531,1000,31531,2000,1001,29.531,0.0
53958,23962,0,489,0,519,30,31,16.3,0.0
53959,8834529,1000,320197,1000,322197,2000,1001,320.197,0.0
53961,1089574,1000,28233,1000,30233,2000,1001,28.233,0.0
53964,1271713,1000,32000,1000,34000,2000,1001,32.0,0.0
53967,3843176,778,98578,778,100134,1556,779,126.707,0.0
53975,5794144,1000,100908,1000,102908,2000,1001,100.908,0.0
53978,3092178,0,79876,0,80876,1000,1001,79.876,0.0
53986,86950,0,552,0,625,73,74,10.824,0.75
53987,3559224,664,76190,664,77518,1328,665,114.744,0.0
53989,6084846,0,220483,0,221483,1000,1001,220.483,0.0
5399,440498,500,9460,500,10460,1000,501,18.92,0.0
53990,11826196,977,342927,977,344881,1954,978,351.0,0.0
53993,842542,0,19000,0,20000,1000,1001,19.0,0.0
53998,5097657,1000,170673,1000,172673,2000,1001,170.673,0.0
53999,2890776,1000,52252,1000,54252,2000,1001,52.252,0.0
54,608787,1087,3674,1087,5824,2150,1089,3.38,0.0
54001,6308677,1000,229661,1000,231661,2000,1001,229.661,0.0
54002,1428938,1000,42000,1000,44000,2000,1001,42.0,0.0
54004,151124,0,2279,0,2605,326,327,6.991,0.5
54005,3416796,1000,86947,1000,88947,2000,1001,86.947,0.0
54007,5079872,948,109589,948,111485,1896,949,115.6,0.0
5403,373520,357,4635,357,5349,714,358,12.983,0.5
54031,5209304,1000,190849,1000,192849,2000,1001,190.849,0.0
54035,501183,0,12074,0,12510,436,437,27.693,0.0
5404,135328,188,1960,188,2336,376,189,10.426,0.0
54044,3978462,948,97365,948,99261,1896,949,102.706,0.0
5405,175480,500,2000,500,3000,1000,501,4.0,0.0
54058,1523487,1000,47351,1000,49351,2000,1001,47.351,0.0
5406,32210,57,606,57,720,114,58,10.632,0.5
54060,753751,1000,13785,1000,15785,2000,1001,13.785,0.0
54062,1284297,1000,29258,1000,31258,2000,1001,29.258,0.0
5407,111538,188,1960,188,2336,376,189,10.426,0.0
54073,9742544,1000,271929,1000,273929,2000,1001,271.929,0.0
54074,94041,0,1675,0,1805,130,131,12.885,0.0
54076,403026,1000,6399,1000,8399,2000,1001,6.399,0.0
54079,36295,0,960,0,1008,48,49,20.0,0.5
5408,17945,37,259,37,333,74,38,7.0,0.0
54080,58658,0,1423,0,1482,59,60,24.119,0.0
54081,9192619,1000,257487,1000,259487,2000,1001,257.487,0.0
54082,465229,881,8810,881,10572,1762,882,10.0,0.0
54083,554500,0,9271,0,10271,1000,1001,9.271,0.5
54085,2273793,0,34692,0,35207,515,516,67.363,0.0
54087,378889,1000,5075,1000,7075,2000,1001,5.075,0.0
5409,17891,37,259,37,333,74,38,7.0,0.0
54090,42600,0,725,0,775,50,51,14.5,0.0
54092,868635,1000,16230,1000,18230,2000,1001,16.23,0.0
54093,4847026,1000,131477,1000,133477,2000,1001,131.477,0.0
54095,1746472,1000,39500,1000,41500,2000,1001,39.5,0.0
54098,5875,0,66,0,72,6,7,11.0,0.0
5410,18384,27,243,27,297,54,28,9.0,0.0
54100,9036127,0,164869,0,165822,953,954,173.0,0.0
54103,555563,0,14352,0,14455,103,104,139.34,0.0
54104,3360768,0,59205,0,60042,837,838,70.735,0.0
54108,2799214,0,67888,0,68888,1000,1001,67.888,0.0
5411,381098,500,3998,500,4998,1000,501,7.996,0.0
54110,12418545,1000,352000,1000,354000,2000,1001,352.0,1.0
54113,7248007,1000,207540,1000,209540,2000,1001,207.54,0.0
54115,1148509,1000,25892,1000,27892,2000,1001,25.892,0.0
54116,7113991,1000,254095,1000,256095,2000,1001,254.095,0.0
54117,354320,0,5254,0,5344,90,91,58.378,0.0
54118,3158509,0,101609,0,102609,1000,1001,101.609,0.75
5412,1637735,0,11929,0,11976,47,48,253.809,1.0
54120,8418428,1000,304742,1000,306742,2000,1001,304.742,0.0
54121,6635846,1000,231000,1000,233000,2000,1001,231.0,0.0
54122,1225018,0,25230,0,25930,700,701,36.043,0.0
54123,5301289,0,126189,0,126702,513,514,245.982,1.0
54124,7955604,1000,236316,1000,238316,2000,1001,236.316,0.0
54126,174732,0,3536,0,3657,121,122,29.223,0.0
54127,358723,0,6007,0,6252,245,246,24.518,0.0
54128,1041433,0,16722,0,17722,1000,1001,16.722,0.0
5413,375314,500,7000,500,8000,1000,501,14.0,0.0
54130,860429,1000,14000,1000,16000,2000,1001,14.0,0.0
54135,333105,0,4949,0,5270,321,322,15.417,0.0
54136,114401,216,1719,216,2151,432,217,7.958,0.5
5414,43532,63,630,63,756,126,64,10.0,0.5
54140,381410,0,5381,0,6381,1000,1001,5.381,0.0
54150,880138,1000,17209,1000,19209,2000,1001,17.209,0.0
54151,7830,0,169,0,182,13,14,13.0,0.0
5416,5496,12,36,12,60,24,13,3.0,0.0
54164,4332,0,50,0,60,10,11,5.0,0.0
5418,357516,0,6410,0,6910,500,501,12.82,0.0
54181,5497626,1000,195402,1000,197402,2000,1001,195.402,0.0
54182,9677,0,144,0,156,12,13,12.0,0.0
54183,5761414,1000,207266,1000,209266,2000,1001,207.266,0.0
5419,306937,500,4000,500,5000,1000,501,8.0,0.0
54190,9167976,1000,259404,1000,261404,2000,1001,259.404,0.0
54191,568828,0,6901,0,7901,1000,1001,6.901,0.0
54192,9092,0,120,0,140,20,21,6.0,0.0
54194,17165701,1000,351998,1000,353998,2000,1001,351.998,0.0
54197,14776,0,194,0,206,12,13,16.167,0.0
54198,2859798,0,69288,0,70288,1000,1001,69.288,0.0
5420,272426,500,3500,500,5000,1500,1002,3.5,0.0
54200,7492774,0,136101,0,136971,870,871,156.438,0.0
54201,6629200,1000,231535,1000,233535,2000,1001,231.535,0.0
54204,560028,0,6748,0,7748,1000,1001,6.748,0.0
54205,663718,0,12253,0,13253,1000,1001,12.253,0.0
54219,2015,0,21,0,24,3,4,7.0,0.0
5422,25380,57,236,57,350,114,58,4.14,0.0
54220,712469,0,15000,0,16000,1000,1001,15.0,0.0
54222,5547841,1000,201425,1000,203425,2000,1001,201.425,0.0
54228,6083208,1000,216411,1000,218411,2000,1001,216.411,0.0
5423,612145,500,8000,500,9000,1000,501,16.0,0.0
54230,8020704,1000,267319,1000,269319,2000,1001,267.319,0.0
54231,650433,0,12674,0,13674,1000,1001,12.674,0.0
54232,6275023,1000,226999,1000,228999,2000,1001,226.999,0.0
54234,2510049,768,65935,768,67471,1536,769,85.853,0.0
54236,12138405,1000,352000,1000,354000,2000,1001,352.0,1.0
54238,311023,0,8840,0,8912,72,73,122.778,0.0
54239,107369,204,1836,204,2244,408,205,9.0,0.0
5424,57228,74,748,74,896,148,75,10.108,0.0
54240,129096,0,2310,0,2489,179,180,12.905,0.0
54241,6650025,1000,236000,1000,238000,2000,1001,236.0,0.0
54242,632264,0,11992,0,12992,1000,1001,11.992,0.0
54244,517246,0,7155,0,8155,1000,1001,7.155,0.0
54246,5409665,1000,195941,1000,197941,2000,1001,195.941,0.0
54247,668490,0,12759,0,13759,1000,1001,12.759,0.0
54248,33637,0,744,0,785,41,42,18.146,0.0
54249,3278557,0,85677,0,86677,1000,1001,85.677,0.5
5425,51546,72,648,72,792,144,73,9.0,0.0
54251,9207881,1000,260329,1000,262329,2000,1001,260.329,0.0
54254,1154505,0,27000,0,28000,1000,1001,27.0,0.0
54256,719109,0,10448,0,11448,1000,1001,10.448,0.0
54258,6270442,1000,228000,1000,230000,2000,1001,228.0,0.0
54259,1054908,0,38111,0,38885,774,775,49.239,0.0
5426,65602,72,936,72,1080,144,73,13.0,0.0
54260,604917,0,11513,0,12513,1000,1001,11.513,0.0
54262,528649,0,11015,0,12015,1000,1001,11.015,0.0
54263,97535,0,1782,0,1920,138,139,12.913,0.0
54264,500101,1000,10000,1000,12000,2000,1001,10.0,0.0
54266,4190097,0,105399,0,106399,1000,1001,105.399,0.5
54267,1459272,1000,38197,1000,40197,2000,1001,38.197,0.0
54269,2610,0,20,0,25,5,6,4.0,0.0
5427,333829,500,4118,500,5118,1000,501,8.236,0.0
54272,866946,0,17468,0,18463,995,996,17.556,0.0
54275,7296728,1000,257760,1000,259760,2000,1001,257.76,0.0
54276,12426467,1000,352000,1000,354000,2000,1001,352.0,1.0
54277,110115,0,1689,0,1977,288,289,5.865,0.0
54278,520715,1000,10000,1000,12000,2000,1001,10.0,0.0
54280,45285,0,776,0,888,112,113,6.929,0.0
54284,9419,0,130,0,143,13,14,10.0,0.0
54285,95776,0,1716,0,1849,133,134,12.902,0.0
54289,7421891,1000,257723,1000,259723,2000,1001,257.723,0.0
5429,1633668,500,11288,500,12788,1500,1002,11.288,0.0
54290,775381,0,15354,0,16354,1000,1001,15.354,0.0
54292,56068,0,955,0,1019,64,65,14.922,0.875
54294,7267,0,156,0,168,12,13,13.0,0.0
54299,9566237,1000,346000,1000,348000,2000,1001,346.0,0.0
5430,1051394,1000,11282,1000,13282,2000,1002,11.282,0.0
54305,36384,0,551,0,643,92,93,5.989,0.0
54307,9651847,0,139599,0,140599,1000,1001,139.599,0.0
54308,1170963,0,27153,0,28153,1000,1001,27.153,0.0
5431,1317484,1000,9284,1000,11284,2000,1002,9.284,0.0
54311,4206744,0,109237,0,110090,853,854,128.062,0.0
54312,441185,0,7081,0,8081,1000,1001,7.081,0.0
54313,406311,1000,6000,1000,8000,2000,1001,6.0,0.0
54314,485784,0,8000,0,9000,1000,1001,8.0,0.0
5432,876478,1000,11290,1000,13290,2000,1002,11.29,0.0
54320,11896612,977,343904,977,345858,1954,978,352.0,1.0
54322,35805,0,644,0,708,64,65,10.062,1.0
54323,432553,0,6913,0,7913,1000,1001,6.913,0.0
54326,499668,0,7219,0,8219,1000,1001,7.219,0.0
54328,566524,1000,9000,1000,11000,2000,1001,9.0,0.0
54329,4235875,739,90744,739,92222,1478,740,122.793,0.0
5433,1124043,928,11988,928,13844,1856,930,12.918,1.0
54330,147162,0,2661,0,2949,288,289,9.24,0.0
54331,86313,0,1673,0,1859,186,187,8.995,0.0
54332,3609,0,34,0,42,8,9,4.25,0.0
54334,11679274,0,301000,0,302000,1000,1001,301.0,0.0
54335,1225511,0,36772,0,37772,1000,1001,36.772,0.0
54336,652568,0,14233,0,15233,1000,1001,14.233,0.5
54338,3345750,0,87490,0,88472,982,983,89.094,0.0
5434,1085002,1000,11286,1000,13286,2000,1002,11.286,0.0
54341,430448,0,5222,0,6222,1000,1001,5.222,0.0
54344,41284,0,800,0,864,64,65,12.5,1.0
54347,961173,0,20546,0,21546,1000,1001,20.546,0.0
54348,473817,0,7952,0,8952,1000,1001,7.952,0.0
54349,925259,1000,18000,1000,20000,2000,1001,18.0,0.0
5435,787206,1000,9286,1000,11286,2000,1002,9.286,0.0
54350,3379353,932,94125,932,95989,1864,933,100.992,0.0
54356,5423962,1000,199992,1000,201992,2000,1001,199.992,0.0
54357,704139,1000,13401,1000,15401,2000,1001,13.401,0.0
54358,491269,0,8266,0,9266,1000,1001,8.266,0.0
54359,62771,0,1268,0,1350,82,83,15.463,0.5
5436,841427,0,15130,0,15630,500,501,30.26,0.0
54360,435833,0,5000,0,6000,1000,1001,5.0,0.0
54361,1469592,0,35472,0,36472,1000,1001,35.472,0.0
54362,5911197,1000,215900,1000,217900,2000,1001,215.9,0.0
54363,1232737,0,27017,0,28017,1000,1001,27.017,0.0
54364,1048498,0,22444,0,23314,870,871,25.798,0.0
54366,4787182,0,127884,0,128884,1000,1001,127.884,0.0
54368,6756126,1000,245168,1000,247168,2000,1001,245.168,0.0
5437,989715,1000,11276,1000,13276,2000,1002,11.276,0.0
54371,391523,0,5000,0,6000,1000,1001,5.0,0.0
54373,5923598,1000,145246,1000,147246,2000,1001,145.246,0.0
54374,487053,0,8417,0,9417,1000,1001,8.417,0.0
54375,725149,1000,13466,1000,15466,2000,1001,13.466,0.0
54376,106996,0,1752,0,1971,219,220,8.0,0.0
54379,6887,0,144,0,156,12,13,12.0,0.0
54380,861893,1000,16136,1000,18136,2000,1001,16.136,0.0
54382,350771,0,4224,0,5224,1000,1001,4.224,0.0
54383,613562,0,11179,0,12179,1000,1001,11.179,0.0
54384,819198,0,16425,0,17425,1000,1001,16.425,0.0
54386,1018182,0,21652,0,22652,1000,1001,21.652,0.0
54387,9329,24,120,24,168,48,25,5.0,0.0
54388,5619,0,96,0,108,12,13,8.0,0.0
54390,5927964,1000,212838,1000,214838,2000,1001,212.838,0.0
54391,7782902,1000,283000,1000,285000,2000,1001,283.0,0.0
54392,465361,0,7000,0,8000,1000,1001,7.0,0.0
54393,4621541,0,100817,0,101817,1000,1001,100.817,0.0
54394,473840,0,6519,0,7519,1000,1001,6.519,0.0
54395,467740,0,7991,0,8991,1000,1001,7.991,0.0
54398,470138,0,8166,0,9166,1000,1001,8.166,0.0
5440,900482,500,16504,500,17504,1000,501,33.008,0.0
54400,688535,0,13644,0,14644,1000,1001,13.644,0.0
54401,404134,0,5920,0,6920,1000,1001,5.92,0.0
54410,5643059,1000,208000,1000,210000,2000,1001,208.0,0.0
54411,917755,0,19949,0,20904,955,956,20.889,0.0
54416,732620,1000,15000,1000,17000,2000,1001,15.0,0.0
54418,496453,0,8999,0,9999,1000,1001,8.999,0.0
54424,885098,0,21968,0,22968,1000,1001,21.968,0.0
54429,14681971,1000,350784,1000,352784,2000,1001,350.784,0.0
54431,621209,1000,13000,1000,15000,2000,1001,13.0,0.0
54432,448946,0,5000,0,6000,1000,1001,5.0,0.0
54433,382293,0,4894,0,5894,1000,1001,4.894,0.0
54440,122221,0,2954,0,3036,82,83,36.024,0.5
54441,1571688,0,21574,0,22574,1000,1001,21.574,0.0
54442,716279,1000,12000,1000,14000,2000,1001,12.0,0.0
54445,14458684,1000,257574,1000,259574,2000,1001,257.574,0.0
54448,715102,0,14000,0,15000,1000,1001,14.0,0.0
54449,6545112,1000,235772,1000,237772,2000,1001,235.772,0.0
54451,1100405,0,24869,0,25869,1000,1001,24.869,0.0
54453,106529,204,1836,204,2244,408,205,9.0,0.0
54454,63506,193,772,193,1158,386,194,4.0,0.0
54456,457727,0,6997,0,7997,1000,1001,6.997,0.0
54458,772965,1000,16000,1000,18000,2000,1001,16.0,0.0
54459,175006,464,1856,464,2784,928,465,4.0,0.0
54460,5286670,0,151140,0,152140,1000,1001,151.14,0.0
54462,604926,0,10053,0,10374,321,322,31.318,0.0
54463,720544,0,11909,0,12410,501,502,23.77,0.0
54464,43971,0,826,0,864,38,39,21.737,0.0
54465,107301,204,1836,204,2244,408,205,9.0,0.0
54466,6043069,1000,209972,1000,211972,2000,1001,209.972,0.0
54467,110654,0,2469,0,2551,82,83,30.11,0.0
54468,45442,0,703,0,767,64,65,10.984,1.0
54469,106529,204,1836,204,2244,408,205,9.0,0.0
54472,3444717,0,21248,0,22576,1328,1310,32.0,0.75
54474,335055,0,9871,0,10121,250,251,39.484,0.0
54475,1668117,0,28531,0,29371,840,841,33.965,0.0
54476,275014,0,5724,0,6042,318,319,18.0,0.0
54478,5940016,1000,212674,1000,214674,2000,1001,212.674,0.0
54479,5334212,1000,194642,1000,196642,2000,1001,194.642,0.0
54481,2799412,0,44000,0,45000,1000,1001,44.0,0.0
54482,405620,1000,6696,1000,8696,2000,1001,6.696,0.0
54484,12109486,1000,351000,1000,353000,2000,1001,351.0,0.0
54486,85001,258,1032,258,1548,516,259,4.0,0.0
54487,266744,573,4011,573,5157,1146,574,7.0,0.0
54489,918513,0,20153,0,21153,1000,1001,20.153,0.0
54492,12426538,1000,352000,1000,354000,2000,1001,352.0,1.0
54498,1524803,1000,34000,1000,36000,2000,1001,34.0,0.0
54499,12099488,1000,351000,1000,353000,2000,1001,351.0,0.0
5450,248661,500,2500,500,3500,1000,501,5.0,0.0
54500,6598006,1000,230480,1000,232480,2000,1001,230.48,0.0
54501,661614,0,15999,0,16999,1000,1001,15.999,0.0
54502,733354,0,14000,0,15000,1000,1001,14.0,0.0
54503,686214,0,13005,0,14005,1000,1001,13.005,0.0
54504,595567,150,21563,150,21863,300,151,143.753,0.0
54505,2528202,0,80750,0,81750,1000,1001,80.75,0.0
54509,7162616,1000,255394,1000,257394,2000,1001,255.394,0.0
54512,106520,204,1836,204,2244,408,205,9.0,0.0
54515,2460778,0,64368,0,65368,1000,1001,64.368,0.0
54516,1626972,1000,44000,1000,46000,2000,1001,44.0,0.0
54517,6721123,1000,240383,1000,242383,2000,1001,240.383,0.0
54518,8529036,1000,308975,1000,310975,2000,1001,308.975,0.0
5452,264302,500,3000,500,4000,1000,501,6.0,1.0
54520,56155,0,957,0,1021,64,65,14.953,1.0
54521,197416,404,3636,404,4444,808,405,9.0,0.0
54522,161333,377,2639,377,3393,754,378,7.0,0.0
54524,715456,0,14000,0,15000,1000,1001,14.0,0.0
54526,4867997,1000,177430,1000,179430,2000,1001,177.43,0.0
54527,106503,204,1836,204,2244,408,205,9.0,0.0
54528,4599880,1000,169667,1000,171667,2000,1001,169.667,0.0
54529,2245475,1000,49000,1000,51000,2000,1001,49.0,0.0
5453,556252,0,7610,0,8110,500,501,15.22,0.0
54530,106512,204,1836,204,2244,408,205,9.0,0.0
54531,615275,1000,11104,1000,13104,2000,1001,11.104,0.0
54532,2262935,705,61095,705,62505,1410,706,86.66,0.0
54534,427259,1000,7000,1000,9000,2000,1001,7.0,0.0
5454,341853,406,3656,406,4468,812,408,9.005,0.5
54541,521646,685,8220,685,9590,1370,686,12.0,0.0
54545,360508,1000,4000,1000,6000,2000,1001,4.0,0.0
54546,10001139,1000,277000,1000,279000,2000,1001,277.0,1.0
54547,435919,103,15865,103,16071,206,104,154.029,0.0
54548,593869,0,11117,0,12117,1000,1001,11.117,0.0
54549,919500,1000,17000,1000,19000,2000,1001,17.0,0.0
5455,2036254,500,24990,500,25990,1000,501,49.98,0.0
54550,103982,220,1320,220,1760,440,221,6.0,0.0
54551,598275,762,13716,762,15240,1524,763,18.0,0.0
54552,1878637,0,49278,0,50278,1000,1001,49.278,0.0
54553,1103872,0,34289,0,34577,288,289,119.059,0.0
54554,622462,1000,8225,1000,10225,2000,1001,8.225,0.0
54555,843213,0,19999,0,20999,1000,1001,19.999,0.0
54556,1284771,0,36686,0,37686,1000,1001,36.686,0.0
54557,6398402,0,171950,0,172950,1000,1001,171.95,0.0
54559,12091920,1000,352000,1000,354000,2000,1001,352.0,1.0
5456,1190659,0,19038,0,19538,500,501,38.076,0.0
54560,414944,0,7890,0,8890,1000,1001,7.89,0.0
54561,1053652,1000,24561,1000,26561,2000,1001,24.561,0.0
54562,4249243,654,66416,654,67724,1308,655,101.554,0.0
54564,4521242,617,67177,617,68411,1234,618,108.877,0.0
54565,790917,0,19755,0,20755,1000,1001,19.755,0.0
54566,5296680,0,148796,0,149796,1000,1001,148.796,0.0
5457,253103,500,5000,500,6000,1000,501,10.0,0.0
54578,251591,1000,1000,1000,3000,2000,1001,1.0,0.0
54579,255592,1000,1000,1000,3000,2000,1001,1.0,0.0
5458,900482,500,16504,500,17504,1000,501,33.008,0.0
54584,85656,0,702,0,936,234,235,3.0,0.0
54585,76505,0,639,0,852,213,214,3.0,0.0
54587,251591,1000,1000,1000,3000,2000,1001,1.0,0.0
54588,251591,1000,1000,1000,3000,2000,1001,1.0,0.0
54589,712092,1000,9987,1000,11987,2000,1001,9.987,0.0
5459,1227472,1000,11282,1000,13282,2000,1002,11.282,0.0
54590,251591,1000,1000,1000,3000,2000,1001,1.0,0.0
54591,31856,0,264,0,352,88,89,3.0,0.0
54592,45910,0,437,0,550,113,114,3.867,0.0
54593,544613,630,8036,630,9296,1260,631,12.756,0.0
54594,251591,1000,1000,1000,3000,2000,1001,1.0,0.0
54595,10906,0,45,0,60,15,16,3.0,0.0
54597,388786,746,4475,746,5967,1492,747,5.999,0.0
54599,251591,1000,1000,1000,3000,2000,1001,1.0,0.0
5460,709339,1000,9288,1000,11288,2000,1002,9.288,0.0
54600,45632,48,612,48,708,96,49,12.75,0.0
54601,251591,1000,1000,1000,3000,2000,1001,1.0,0.0
54602,251591,1000,1000,1000,3000,2000,1001,1.0,0.0
54603,684412,1000,9000,1000,11000,2000,1001,9.0,0.0
54604,5109,18,18,18,54,36,19,1.0,0.0
54605,6791,12,79,12,103,24,13,6.583,0.0
54606,412408,1000,3000,1000,5000,2000,1001,3.0,0.0
54607,255592,1000,1000,1000,3000,2000,1001,1.0,0.0
54608,12832,48,48,48,144,96,49,1.0,0.0
54609,16153,62,62,62,186,124,63,1.0,0.0
5461,812510,1000,11278,1000,13278,2000,1002,11.278,0.0
54612,16153,62,62,62,186,124,63,1.0,0.0
54613,20992,80,80,80,240,160,81,1.0,0.0
54614,25270,62,248,62,372,124,63,4.0,0.0
54615,3603,12,12,12,36,24,13,1.0,0.0
54617,458843,80,400,80,560,160,81,5.0,0.0
54618,213107,7,42,7,56,14,8,6.0,0.0
54620,26629,62,310,62,434,124,63,5.0,0.0
54621,187837,746,746,746,2238,1492,747,1.0,0.0
54622,57082,1,7,1,9,2,2,7.0,0.0
54625,818217,178,3296,178,3652,356,179,18.517,0.0
54626,15902,61,61,61,183,122,62,1.0,0.0
54628,847,1,1,1,3,2,2,1.0,0.0
54629,10205,22,110,22,154,44,23,5.0,0.0
5463,1260868,1000,11290,1000,13290,2000,1002,11.29,0.0
54630,45269,178,178,178,534,356,179,1.0,0.0
54631,5463,9,62,9,80,18,10,6.889,0.0
54632,243298,25,175,25,225,50,26,7.0,0.0
54634,27660,61,366,61,488,122,62,6.0,0.0
54635,40070,45,585,45,675,90,46,13.0,0.0
54636,251591,1000,1000,1000,3000,2000,1001,1.0,0.0
54637,27901,61,366,61,488,122,62,6.0,0.0
54638,571458,191,2292,191,2674,382,192,12.0,0.0
5464,1272867,1000,11282,1000,13282,2000,1002,11.282,0.0
54640,2348,7,7,7,21,14,8,1.0,0.0
54641,356312,227,2459,227,2913,454,228,10.833,0.0
54643,6866,25,25,25,75,50,26,1.0,0.0
54644,255592,1000,1000,1000,3000,2000,1001,1.0,0.0
54645,255592,1000,1000,1000,3000,2000,1001,1.0,0.0
54646,11886,45,45,45,135,90,46,1.0,0.0
54647,39729,47,611,47,705,94,48,13.0,0.0
54648,34760,25,125,25,175,50,26,5.0,0.0
54649,1868,1,7,1,9,2,2,7.0,0.0
5465,921806,1000,9284,1000,11284,2000,1002,9.284,0.0
54650,251591,1000,1000,1000,3000,2000,1001,1.0,0.0
54651,8680,12,91,12,115,24,13,7.583,0.0
54652,57568,227,227,227,681,454,228,1.0,0.0
54653,12388,47,47,47,141,94,48,1.0,0.0
54654,54054,213,213,213,639,426,214,1.0,0.0
54655,255592,1000,1000,1000,3000,2000,1001,1.0,0.0
54656,11886,45,45,45,135,90,46,1.0,0.0
54657,847,1,1,1,3,2,2,1.0,0.0
54658,251591,1000,1000,1000,3000,2000,1001,1.0,0.0
54659,6113,22,22,22,66,44,23,1.0,0.0
5466,923212,1000,9288,1000,11288,2000,1002,9.288,0.0
54660,12388,47,47,47,141,94,48,1.0,0.0
54661,3603,12,12,12,36,24,13,1.0,0.0
54663,49297,191,191,191,573,382,192,1.0,0.0
54665,700030,340,4504,340,5184,680,341,13.247,0.0
54666,127343,3,12,3,18,6,4,4.0,0.0
54668,255592,1000,1000,1000,3000,2000,1001,1.0,0.0
54669,161242,630,630,630,1890,1260,631,1.0,0.0
5467,190824,500,2000,500,3000,1000,501,4.0,0.0
54671,87292,340,340,340,1020,680,341,1.0,0.0
54672,59325,234,234,234,702,468,235,1.0,0.0
54673,1888,3,12,3,18,6,4,4.0,0.0
54674,2850,9,9,9,27,18,10,1.0,0.0
54676,6967,25,25,25,75,50,26,1.0,0.0
5469,1403384,500,11282,500,12782,1500,1002,11.282,0.0
5470,850252,1000,9286,1000,11286,2000,1002,9.286,0.0
5471,942160,1000,9290,1000,11290,2000,1002,9.29,0.0
5472,230189,500,3000,500,4000,1000,501,6.0,0.0
5474,1111356,1000,11286,1000,13286,2000,1002,11.286,0.0
5475,1409623,1000,9286,1000,11286,2000,1002,9.286,0.0
5476,667538,1000,9290,1000,11290,2000,1002,9.29,1.0
5477,1068168,1000,11282,1000,13282,2000,1002,11.282,0.0
5478,671331,1000,9284,1000,11284,2000,1002,9.284,0.0
5479,292355,500,5000,500,6000,1000,501,10.0,0.0
5483,428255,500,9000,500,10000,1000,502,18.0,0.5
5484,2103223,500,23910,500,24910,1000,502,47.82,0.0
5485,559572,500,11986,500,12986,1000,502,23.972,0.0
5486,1337864,500,18500,500,19500,1000,502,37.0,0.0
5487,1162040,0,17500,0,18000,500,501,35.0,0.0
5488,368931,500,5148,500,6148,1000,502,10.296,0.0
5489,335924,500,6000,500,7000,1000,502,12.0,0.0
5490,297025,500,4000,500,5000,1000,502,8.0,0.0
5491,784101,500,11500,500,12500,1000,502,23.0,0.0
5493,6507178,0,93370,0,93870,500,501,186.74,0.0
5494,285387,500,4000,500,5000,1000,502,8.0,0.0
5495,1476591,500,20000,500,21000,1000,502,40.0,0.0
54953,790475,1000,13000,1000,15000,2000,1001,13.0,0.0
54956,444277,580,6960,580,8120,1160,581,12.0,0.0
54957,285312,0,4199,0,4556,357,358,11.762,0.0
5496,1623755,0,13500,0,14000,500,501,27.0,0.0
54977,496513,0,6000,0,7000,1000,1001,6.0,0.0
5498,792256,500,13500,500,14500,1000,502,27.0,0.0
5499,286124,163,3623,163,3949,326,165,22.227,0.0
55,44966,182,458,182,776,318,186,3.343,0.0
5500,430838,500,6574,500,7574,1000,502,13.148,1.0
55005,96878,164,1148,164,1476,328,165,7.0,0.0
5502,9257248,500,139891,500,140891,1000,502,279.782,0.0
55022,43133,0,384,0,408,24,25,16.0,0.0
55025,56763,30,1440,30,1500,60,31,48.0,0.0
5503,863656,0,15500,0,16000,500,501,31.0,0.0
55034,267607,1000,1000,1000,3000,2000,1001,1.0,0.0
55037,267607,1000,1000,1000,3000,2000,1001,1.0,0.0
5504,1075565,1000,9286,1000,11286,2000,1002,9.286,0.0
5505,948771,1000,11282,1000,13282,2000,1002,11.282,0.0
55056,36850,0,594,0,602,8,9,74.25,0.0
55059,550868,0,5160,0,6020,860,861,6.0,0.0
5506,618725,500,9793,500,10793,1000,501,19.586,0.0
55061,274852,0,3008,0,3384,376,377,8.0,0.0
55062,745813,0,8000,0,9000,1000,1001,8.0,0.0
55063,724367,0,8000,0,9000,1000,1001,8.0,0.0
55064,267607,1000,1000,1000,3000,2000,1001,1.0,0.0
55065,44395,164,164,164,492,328,165,1.0,0.0
55068,730424,1000,8000,1000,10000,2000,1001,8.0,0.0
55069,267607,1000,1000,1000,3000,2000,1001,1.0,1.0
5507,834487,1000,11280,1000,13280,2000,1002,11.28,0.5
5508,790465,197,18358,197,18752,394,198,93.188,0.5
5513,994539,1000,11286,1000,13286,2000,1002,11.286,0.0
5514,1093925,1000,11346,1000,13346,2000,1002,11.346,0.0
5515,1070146,1000,11282,1000,13282,2000,1002,11.282,0.0
5516,1110121,1000,11288,1000,13288,2000,1002,11.288,0.0
5517,686668,1000,9282,1000,11282,2000,1002,9.282,1.0
55186,584164,1000,7000,1000,9000,2000,1002,7.0,0.5
55187,716611,837,12554,837,14228,1674,839,14.999,0.5
55189,488543,1000,6000,1000,8000,2000,1002,6.0,0.0
5519,672865,910,9460,910,11280,1820,912,10.396,0.0
55197,467565,0,7000,0,8000,1000,1001,7.0,0.0
5520,1441969,1000,11280,1000,13280,2000,1002,11.28,0.0
55206,874683,1000,14823,1000,16823,2000,1002,14.823,0.5
55209,532102,1000,5000,1000,7000,2000,1002,5.0,0.0
5521,722393,1000,9284,1000,11284,2000,1002,9.284,0.0
55210,5250,8,32,8,56,24,18,4.0,0.0
55212,443658,0,5000,0,6000,1000,1001,5.0,1.0
55214,661701,0,10911,0,11911,1000,1001,10.911,0.0
55217,1117426,1000,17748,1000,19748,2000,1002,17.748,0.0
5522,876663,1000,9288,1000,11288,2000,1002,9.288,0.0
55221,417597,156,3930,156,4242,312,158,25.192,0.0
55237,511446,1000,7000,1000,9000,2000,1002,7.0,0.0
5524,1101470,1000,11282,1000,13282,2000,1002,11.282,0.0
5525,1103584,1000,11288,1000,13288,2000,1002,11.288,0.0
5526,750982,1000,9288,1000,11288,2000,1002,9.288,0.0
55264,14275959,0,339615,0,340615,1000,1001,339.615,0.0
5527,946865,1000,11288,1000,13288,2000,1002,11.288,0.0
55273,255942,0,1939,0,2216,277,278,7.0,1.0
55274,1432722,1999,20879,1999,24877,3998,2002,10.445,0.0
55275,407549,1000,5000,1000,7000,2000,1002,5.0,0.0
55277,237832,0,1890,0,2160,270,271,7.0,0.0
55278,2417598,1000,39292,1000,41292,2000,1002,39.292,0.0
55279,390783,1000,5000,1000,7000,2000,1002,5.0,0.0
5528,747537,1000,9284,1000,11284,2000,1002,9.284,0.0
55280,529602,0,7000,0,8000,1000,1001,7.0,0.0
55282,667847,1000,7000,1000,9000,2000,1002,7.0,0.0
55284,333464,596,4595,596,5787,1192,598,7.71,0.0
55287,826315,1000,10953,1000,12953,2000,1002,10.953,0.0
5529,289886,500,5000,500,6000,1000,501,10.0,0.0
55297,381363,1000,4000,1000,6000,2000,1002,4.0,0.0
5530,294830,500,4382,500,5382,1000,501,8.764,0.0
55300,1389401,1000,26022,1000,28022,2000,1002,26.022,0.0
55302,253590,1000,1000,1000,3000,2000,1002,1.0,0.0
5531,1111847,907,11942,907,13756,1814,909,13.166,1.0
55340,1034977,1000,14343,1000,16343,2000,1002,14.343,0.5
55354,30586,23,431,23,477,46,25,18.739,0.0
55358,8389058,1000,252860,1000,254860,2000,1002,252.86,0.0
55359,840484,0,11988,0,12988,1000,1001,11.988,0.0
55364,247748,0,1917,0,2191,274,275,6.996,0.75
55365,20778,0,294,0,343,49,50,6.0,0.0
55366,512065,0,6688,0,7432,744,745,8.989,0.0
5538,526697,500,5190,500,6190,1000,501,10.38,0.5
5539,995701,992,9946,992,11930,1984,994,10.026,0.0
55394,245645,0,1967,0,2248,281,282,7.0,0.0
55395,38399,29,234,29,334,100,61,8.069,0.75
55396,28134,74,296,74,444,148,76,4.0,0.0
55400,520940,1000,8000,1000,10000,2000,1002,8.0,0.0
55405,702801,0,10000,0,11000,1000,1001,10.0,0.0
55413,137499,113,1704,113,1930,226,115,15.08,0.0
55414,272454,270,1890,270,2430,540,272,7.0,0.5
55417,264403,0,2023,0,2312,289,290,7.0,0.0
55420,246208,0,1967,0,2248,281,282,7.0,0.0
55423,30481,23,437,23,483,46,25,19.0,0.0
55425,475617,0,7000,0,8000,1000,1001,7.0,0.5
5543,244103,0,3500,0,4000,500,501,7.0,0.0
55430,7537,11,57,11,92,35,26,5.182,0.0
55432,382414,363,2733,363,3459,726,365,7.529,0.0
55433,21844,63,189,63,315,126,65,3.0,0.0
55437,702525,0,4990,0,5590,600,601,8.317,0.0
55444,884501,1000,11760,1000,13760,2000,1002,11.76,0.0
55450,249589,1000,1000,1000,3000,2000,1002,1.0,0.0
55455,35757,47,138,47,232,94,49,2.936,0.0
55456,69845,113,819,113,1045,226,115,7.248,0.0
55467,251168,0,1999,0,2286,287,288,6.965,0.5
55470,503991,1000,4966,1000,6966,2000,1002,4.966,0.0
55481,215091,186,2368,186,2924,556,320,12.731,0.0
55486,245585,1000,1000,1000,3000,2000,1001,1.0,0.0
55509,245585,1000,1000,1000,3000,2000,1001,1.0,0.0
55510,363132,290,2131,290,2711,580,292,7.348,0.0
55511,2869,4,33,4,41,8,6,8.25,0.0
55526,84809,0,415,0,799,384,164,7.83,0.0
55532,620843,0,8000,0,9000,1000,1001,8.0,0.0
55533,52776,0,955,0,1029,74,75,12.905,0.0
55537,612270,1000,8000,1000,10000,2000,1002,8.0,0.0
5554,22547,50,284,50,384,100,52,5.68,0.5
55543,32835,87,261,87,435,174,89,3.0,0.0
55546,27740,74,296,74,444,148,76,4.0,0.0
5555,4283,7,49,7,63,14,9,7.0,0.0
55564,27618,74,296,74,444,148,76,4.0,0.0
55568,27435,24,380,24,428,48,26,15.833,0.0
55570,420328,1000,4997,1000,6997,2000,1002,4.997,0.0
5568,200709,0,3637,0,3770,133,134,27.346,1.0
55680,162965,301,2095,301,2697,602,303,6.96,0.0
55682,1171808,1000,17933,1000,19933,2000,1002,17.933,0.0
55686,275408,500,3473,500,4473,1000,502,6.946,0.0
55688,12432,20,120,20,160,40,22,6.0,0.0
55689,245585,1000,1000,1000,3000,2000,1001,1.0,0.0
5569,255347,286,4290,286,4862,572,287,15.0,0.8333333333333334
55690,18903,20,200,20,240,40,22,10.0,0.0
55691,132240,110,1097,110,1317,220,112,9.973,0.0
55692,200433,132,2562,132,2826,264,134,19.409,0.0
55693,5083,6,53,6,65,12,8,8.833,0.0
55695,404734,0,2455,0,2762,307,308,7.997,0.0
55697,1985,2,30,2,34,4,4,15.0,0.0
55698,249586,1000,1000,1000,3000,2000,1001,1.0,0.0
55699,102109,0,820,0,878,58,59,14.138,0.0
55705,90707,127,381,127,635,254,129,3.0,0.0
55707,569058,511,4074,511,5096,1022,513,7.973,0.0
55708,195368,348,2549,348,3245,696,350,7.325,0.0
55709,518724,355,3550,355,4260,710,357,10.0,0.0
55710,26319,64,320,64,448,128,66,5.0,0.0
55712,5881,7,105,7,119,14,9,15.0,0.0
55715,417902,604,5436,604,6644,1208,606,9.0,0.0
55716,24778,23,318,23,364,46,25,13.826,0.0
55717,81719,44,614,44,702,88,46,13.955,0.0
55720,5791,7,105,7,119,14,9,15.0,1.0
55723,249586,1000,1000,1000,3000,2000,1001,1.0,0.0
55725,467996,676,6084,676,7436,1352,678,9.0,0.0
55728,67893,40,317,40,644,327,132,7.925,0.0
55729,149965,283,849,283,1415,566,285,3.0,0.5
5574,211414,500,3000,500,4000,1000,502,6.0,0.5
55740,83647,44,343,44,746,403,141,7.795,0.0
55742,74992,104,1248,104,1456,208,105,12.0,0.0
55744,5999,11,73,11,95,22,13,6.636,0.0
55749,19283,47,235,47,329,94,49,5.0,0.0
55752,46819,20,377,20,417,40,21,18.85,0.0
55755,1464251,1996,18581,1996,23573,4992,2998,9.309,0.0
55756,16764,49,147,49,245,98,51,3.0,0.0
55757,417662,692,5536,692,6920,1384,694,8.0,0.0
55762,245585,1000,1000,1000,3000,2000,1001,1.0,0.0
55766,246349,284,1751,284,2319,568,286,6.165,0.0
5577,200709,0,3637,0,3770,133,134,27.346,1.0
55773,669419,682,5378,682,6742,1364,684,7.886,0.5
55774,2157013,221,663,221,1105,442,223,3.0,0.0
55786,205053,390,2633,390,3413,780,392,6.751,0.0
55787,748373,639,5105,639,6383,1278,641,7.989,0.0
5580,100392,0,1093,0,1170,77,78,14.195,1.0
5582,255347,286,4290,286,4862,572,287,15.0,0.6666666666666666
55840,253593,1000,1000,1000,3000,2000,1001,1.0,0.0
55842,253593,1000,1000,1000,3000,2000,1001,1.0,0.0
55843,1040746,1000,18835,1000,20835,2000,1001,18.835,0.0
55844,516250,1000,7306,1000,9306,2000,1001,7.306,0.0
55845,1400924,1000,25000,1000,27000,2000,1001,25.0,0.0
55846,1410386,1000,25000,1000,27000,2000,1001,25.0,0.5
55870,569000,0,7985,0,8985,1000,1001,7.985,0.5
55871,850025,1000,12988,1000,14988,2000,1001,12.988,0.5
55882,139914,85,1267,85,1437,170,86,14.906,0.0
55886,268614,0,3404,0,3675,271,272,12.561,0.75
55895,6240,14,84,14,112,28,15,6.0,0.0
55899,1617049,1000,26969,1000,28969,2000,1001,26.969,0.75
559,159694,361,733,361,1700,967,452,5.447,0.0
55901,1794789,1000,39708,1000,41708,2000,1001,39.708,0.0
55903,6308682,1000,10911,1000,12911,2000,1001,10.911,0.0
55905,234499,82,2048,82,2212,164,83,24.976,0.0
55907,744781,1000,15000,1000,17000,2000,1001,15.0,0.5
55908,249589,1000,1000,1000,3000,2000,1001,1.0,0.0
5591,329676,500,3499,500,4499,1000,501,6.998,0.8
55912,21336,82,82,82,246,164,83,1.0,0.0
55916,195653,771,771,771,2313,1542,772,1.0,0.0
55917,182100,140,2234,140,2514,280,141,15.957,0.5
55923,14035,54,54,54,162,108,55,1.0,0.0
5593,24250,59,352,59,470,118,61,5.966,0.0
55932,32974,128,128,128,384,256,129,1.0,0.0
55936,249589,1000,1000,1000,3000,2000,1001,1.0,0.0
55939,2735683,218,3052,218,3488,436,219,14.0,0.0
5594,377018,381,6818,381,7580,762,383,17.895,0.0
55942,1616450,10,90,10,110,20,11,9.0,0.0
5595,401963,500,6500,500,7500,1000,502,13.0,0.0
5596,401261,500,6500,500,7500,1000,502,13.0,0.0
5597,414391,500,6999,500,7999,1000,502,13.998,0.0
5598,4815,11,55,11,77,22,13,5.0,0.0
55984,1653985,1000,23000,1000,25000,2000,1001,23.0,0.0
55985,617553,1000,9262,1000,11262,2000,1001,9.262,0.0
55991,1550928,0,21597,0,22536,939,940,23.0,0.0
56,44966,182,458,182,776,318,186,3.343,0.0
56007,644996,0,8994,0,9994,1000,1001,8.994,0.0
56011,881160,0,12240,0,13240,1000,1001,12.24,0.0
56016,17929,33,132,33,198,66,34,4.0,0.0
56017,1577516,1000,27607,1000,29607,2000,1001,27.607,0.0
56018,10787,0,100,0,120,20,21,5.0,0.0
56020,1498538,0,20861,0,21768,907,908,23.0,0.0
56179,1090362,0,16000,0,17000,1000,1001,16.0,0.0
56183,1118679,1000,17000,1000,19000,2000,1001,17.0,0.0
56186,410720,1000,4000,1000,6000,2000,1001,4.0,0.0
562,368916,130,2242,130,2684,442,260,35.032,0.0
56207,558032,0,6341,0,7341,1000,1001,6.341,0.0
56208,828751,1000,10848,1000,12848,2000,1001,10.848,0.0
56209,4911,4,66,4,74,8,5,16.5,0.0
56212,29434,64,320,64,448,128,65,5.0,0.0
56213,407951,0,4147,0,4608,461,462,8.996,0.0
56215,257594,1000,1000,1000,3000,2000,1001,1.0,0.0
56216,456761,0,5005,0,6005,1000,1001,5.005,0.0
56222,807983,846,12870,846,14562,1692,847,15.213,0.0
56225,253593,1000,1000,1000,3000,2000,1001,1.0,0.0
56227,257594,1000,1000,1000,3000,2000,1001,1.0,0.0
56228,20126,47,235,47,329,94,48,5.0,0.0
56229,257594,1000,1000,1000,3000,2000,1001,1.0,0.0
56231,253593,1000,1000,1000,3000,2000,1001,1.0,0.0
56232,20126,47,235,47,329,94,48,5.0,0.0
56233,17707,47,141,47,235,94,48,3.0,0.0
56235,3893,9,36,9,54,18,10,4.0,0.0
5639,422477,0,6000,0,6500,500,501,12.0,0.0
5640,1005870,1000,17366,1000,19866,2500,1502,11.577,0.0
5641,395576,500,5869,500,6869,1000,501,11.738,0.0
5642,14395,0,108,0,144,36,37,3.0,0.0
5644,420370,500,6000,500,7000,1000,501,12.0,0.0
5646,239328,500,2500,500,3500,1000,501,5.0,0.0
5647,250350,500,2500,500,3500,1000,501,5.0,0.0
5650,2318,4,16,4,24,8,5,4.0,0.0
5651,1461,2,8,2,12,4,3,4.0,0.0
5652,239066,500,2500,500,3500,1000,501,5.0,0.0
5653,444111,500,6000,500,7000,1000,501,12.0,0.0
5654,421194,0,6000,0,6500,500,501,12.0,0.0
5655,5418,13,52,13,78,26,14,4.0,0.0
5659,1095765,1000,19225,1000,21725,2500,1502,12.817,0.0
5660,392932,500,5500,500,6500,1000,501,11.0,0.0
5661,770912,500,13402,500,14402,1000,501,26.804,0.0
5664,980246,1495,16816,1495,19806,2990,1497,11.248,0.0
5666,144087,144,1585,144,2017,432,269,11.007,0.0
5670,1352982,500,13773,500,14773,1000,501,27.546,0.0
5671,1229238,500,34659,500,35659,1000,501,69.318,0.0
5672,1741480,500,3500,500,4500,1000,501,7.0,0.0
5673,421849,500,6500,500,7500,1000,501,13.0,0.0
5674,2491326,1,5,1,7,2,2,5.0,0.0
5675,440487,500,6000,500,7000,1000,501,12.0,0.0
5676,499384,500,6065,500,7065,1000,501,12.13,0.5
5677,1092663,1496,19121,1496,22113,2992,1498,12.781,0.0
5679,441092,0,6000,0,6500,500,501,12.0,0.0
5680,243322,500,2500,500,3500,1000,501,5.0,0.5
5682,423245,500,6000,500,7000,1000,501,12.0,0.0
5683,440110,0,6000,0,6500,500,501,12.0,0.0
5684,1068553,999,18799,999,21297,2498,1501,12.541,0.0
5685,361879,500,5000,500,6000,1000,501,10.0,0.0
5686,1411580,375,17292,375,18042,750,376,46.112,0.6666666666666666
5687,1361410,500,13753,500,14753,1000,501,27.506,0.0
5688,334675,500,4975,500,5975,1000,501,9.95,0.0
5690,246936,500,2493,500,3993,1500,1001,4.986,0.0
5691,398321,500,5500,500,6500,1000,501,11.0,0.0
5692,37712,49,441,49,539,98,50,9.0,0.0
5695,442087,500,6000,500,7000,1000,501,12.0,0.0
5696,1052759,1000,18672,1000,21172,2500,1502,12.448,0.0
5697,425662,500,6000,500,7000,1000,501,12.0,0.0
5698,423300,500,6000,500,7000,1000,501,12.0,0.0
57,210779,936,2056,936,3690,1634,940,2.908,0.0
5700,401191,500,6000,500,7000,1000,501,12.0,0.0
5701,916491,500,31606,500,32606,1000,501,63.212,0.0
5702,165963,254,2552,254,3060,508,255,10.047,0.0
5704,3733,1,19,1,23,4,4,19.0,0.0
5708,400708,500,6000,500,7000,1000,501,12.0,0.0
5709,1883,2,24,2,28,4,3,12.0,0.0
5710,1002729,1497,17339,1497,20333,2994,1499,11.582,0.0
5713,422402,500,6000,500,7000,1000,501,12.0,0.0
5714,415812,0,6000,0,6500,500,501,12.0,0.0
5717,416791,500,6000,500,7000,1000,501,12.0,0.0
5718,416750,500,6000,500,7000,1000,501,12.0,0.0
5723,127252,175,1925,175,2275,350,176,11.0,0.0
5724,471150,500,4446,500,5446,1000,501,8.892,0.0
5725,484242,0,6000,0,6500,500,501,12.0,0.0
5726,13045,0,218,0,240,22,23,9.909,0.0
5727,19431,0,273,0,312,39,40,7.0,0.0
5728,3601,8,24,8,40,16,9,3.0,0.0
5729,425919,500,6000,500,7000,1000,501,12.0,0.0
5731,231890,0,2500,0,3000,500,501,5.0,0.0
5732,14067,26,145,26,223,78,53,5.577,0.0
5735,5049,12,48,12,72,24,13,4.0,0.0
5738,303019,500,3458,500,4458,1000,501,6.916,0.5
5745,384645,500,5000,500,6000,1000,501,10.0,0.0
5746,602404,180,6113,180,6473,360,181,33.961,0.0
5747,1135,1,6,1,8,2,2,6.0,0.0
5748,7445115,7,80,7,94,14,8,11.429,0.0
5749,698316,500,10085,500,11085,1000,501,20.17,0.0
5750,861888,500,13473,500,14473,1000,501,26.946,0.5
5751,654255,500,9025,500,10025,1000,501,18.05,0.0
5752,444581,500,5634,500,6634,1000,501,11.268,0.5
5753,22826,51,255,51,357,102,52,5.0,0.0
5754,240156,500,3539,500,4539,1000,501,7.078,0.0
5755,1119087,500,29544,500,30544,1000,501,59.088,0.0
5756,188622,500,1998,500,2998,1000,501,3.996,0.0
5758,12948507,7,35,7,49,14,8,5.0,0.0
5760,1197885,146,1022,146,1314,292,147,7.0,0.0
5761,816929,500,15192,500,16192,1000,501,30.384,0.0
5762,70799,172,671,172,1015,344,173,3.901,0.0
5763,1831,2,10,2,16,6,5,5.0,0.5
5765,271971,500,4186,500,5186,1000,501,8.372,0.0
5766,293852,500,4000,500,5000,1000,501,8.0,0.0
5767,1379218,500,36466,500,37466,1000,501,72.932,0.0
5768,1461566,500,3991,500,4991,1000,501,7.982,0.0
5769,1072965,500,35390,500,36390,1000,501,70.78,0.0
5770,400601,500,6481,500,7481,1000,501,12.962,0.0
5771,1826807,500,3500,500,4500,1000,501,7.0,0.0
5772,88619,3,27,3,33,6,4,9.0,0.0
5773,34076,31,186,31,248,62,32,6.0,0.0
5774,2740,5,20,5,30,10,6,4.0,0.0
5775,767138,106,742,106,954,212,107,7.0,0.0
5776,126853,143,1209,143,1638,429,282,8.455,0.0
5777,488278,1000,9500,1000,11500,2000,1002,9.5,0.0
5779,1473537,500,3993,500,4993,1000,501,7.986,0.0
5780,1208447,150,1050,150,1350,300,151,7.0,0.0
5781,5789,12,60,12,84,24,13,5.0,0.0
5783,944,1,3,1,5,2,2,3.0,0.0
5784,100525,131,653,131,915,262,132,4.985,0.0
5785,344885,500,5146,500,6146,1000,501,10.292,0.0
579,5561,12,48,12,72,24,13,4.0,0.5
58,4976796,9607,57634,9607,76845,19211,9608,5.999,0.0
5807,347237,0,4418,0,4918,500,501,8.836,0.0
5810,223915,78,3666,78,3822,156,79,47.0,1.0
5811,14027,16,135,16,167,32,17,8.438,0.0
5812,219807,0,2508,0,3008,500,501,5.016,0.5
5813,262513,500,3559,500,4559,1000,501,7.118,0.0
5814,284318,0,3000,0,3500,500,501,6.0,0.0
5815,688442,0,10733,0,11233,500,501,21.466,0.0
5816,21845,28,248,28,304,56,29,8.857,0.0
5817,5058,0,48,0,60,12,13,4.0,0.0
5818,614241,500,9000,500,10000,1000,501,18.0,0.0
5819,461134,0,5500,0,6000,500,501,11.0,0.0
5820,1454,2,10,2,14,4,3,5.0,0.0
5823,301133,500,4446,500,5446,1000,501,8.892,0.0
5824,69600,84,1503,84,1671,168,85,17.893,0.0
5825,1088553,500,3500,500,4500,1000,501,7.0,0.0
5826,719604,500,11178,500,12178,1000,501,22.356,0.0
5828,465692,500,5500,500,6500,1000,501,11.0,0.0
5829,2460830,920,34741,920,36944,2203,1285,37.762,0.0
5830,248379,500,3500,500,4500,1000,501,7.0,0.0
5831,266543,500,2703,500,3703,1000,501,5.406,0.0
5833,29912,0,376,0,430,54,55,6.963,0.0
5837,338965,0,4000,0,4500,500,501,8.0,0.0
5838,340581,500,5725,500,6725,1000,501,11.45,0.0
5839,5108,12,48,12,72,24,13,4.0,0.0
584,436849,0,9000,0,9500,500,501,18.0,0.5
5840,727149,500,11093,500,12093,1000,501,22.186,0.0
5842,68897,83,1485,83,1651,166,84,17.892,0.0
5843,9979,15,90,15,135,45,31,6.0,0.6666666666666666
5844,284557,500,3892,500,4892,1000,501,7.784,0.0
5845,87436,159,795,159,1113,318,160,5.0,0.0
5846,39160,58,348,58,464,116,59,6.0,0.0
5847,525866,0,6671,0,7171,500,501,13.342,0.5
5850,238223,0,3500,0,4000,500,501,7.0,0.0
5851,248188,0,3500,0,4000,500,501,7.0,0.0
5852,68032,0,1467,0,1549,82,83,17.89,0.0
5854,336879,500,4500,500,5500,1000,501,9.0,0.0
5855,67098,80,1440,80,1600,160,81,18.0,0.0
5859,723735,500,11206,500,12206,1000,501,22.412,0.0
5860,65745,0,661,0,805,144,145,4.59,0.5
5862,80472,0,682,0,796,114,115,5.982,0.0
5863,66820,81,1458,81,1620,162,82,18.0,0.0
5864,507453,500,6500,500,7500,1000,501,13.0,0.0
5865,252298,500,2689,500,3689,1000,501,5.378,0.0
5866,530566,500,6500,500,7500,1000,501,13.0,0.0
5867,681633,500,11500,500,12500,1000,501,23.0,0.0
5870,18826,55,165,55,275,110,56,3.0,0.0
5871,250036,500,3500,500,4500,1000,501,7.0,0.0
5872,406487,500,2839,500,3839,1000,501,5.678,0.0
5873,180290,303,1632,303,2238,606,304,5.386,0.0
5876,64801,0,1391,0,1469,78,79,17.833,0.0
5877,368545,0,5388,0,5888,500,501,10.776,0.0
5878,23284,0,177,0,236,59,60,3.0,0.0
5879,3087266,500,12362,500,13362,1000,501,24.724,0.5
5880,329418,0,4500,0,5000,500,501,9.0,0.0
5881,404220,500,5665,500,6665,1000,501,11.33,0.0
5882,351122,500,5000,500,6000,1000,501,10.0,0.0
5883,206010,83,2170,83,2362,192,111,19.908,0.0
5884,201493,0,2500,0,3000,500,501,5.0,0.0
5885,386715,500,5000,500,6000,1000,501,10.0,0.0
5886,18343,0,210,0,245,35,36,6.0,0.0
5887,1467920,500,24551,500,25551,1000,501,49.102,0.0
5889,850731,500,13417,500,15097,1680,1100,26.834,0.0
589,438993,0,6500,0,7000,500,501,13.0,0.0
5891,446548,500,6000,500,7000,1000,501,12.0,0.0
5892,1592,2,8,2,12,4,3,4.0,0.0
5894,503448,500,8483,500,9483,1000,501,16.966,0.0
5895,1788592,500,3500,500,4500,1000,501,7.0,0.0
5896,9188097,8,64,8,80,16,9,8.0,0.0
5897,479250,463,5487,463,6413,926,464,11.851,0.5
59,7136,28,70,28,119,49,32,3.333,0.0
5900,239524,500,4000,500,5000,1000,501,8.0,0.0
5901,236857,473,3441,473,4387,946,474,7.275,0.0
5902,4824,12,36,12,60,24,13,3.0,0.0
5903,61757,83,415,83,581,166,84,5.0,0.0
5904,429538,500,10848,500,11848,1000,501,21.696,0.0
5906,199680,229,2519,229,2977,458,230,11.0,0.0
5908,1111592,500,32500,500,33500,1000,501,65.0,0.0
5909,8112,17,81,17,115,34,18,4.765,0.0
5910,371844,500,5493,500,6493,1000,501,10.986,0.0
5911,355906,500,4983,500,5983,1000,501,9.966,0.0
5912,1429713,500,3999,500,4999,1000,501,7.998,0.0
5913,419599,403,12895,403,13701,806,404,31.998,0.0
5914,1251507,1000,22247,1000,24744,2497,1486,22.247,0.0
5915,1224875,500,20975,500,21975,1000,501,41.95,0.0
5916,247485,500,3500,500,4500,1000,501,7.0,0.0
5917,78269,136,950,136,1222,272,137,6.985,0.0
5918,463895,500,6499,500,7499,1000,501,12.998,0.5
5919,935908,500,12236,500,13236,1000,501,24.472,0.0
5920,1376855,500,38720,500,39720,1000,501,77.44,0.0
5921,1203591,500,3500,500,4500,1000,501,7.0,0.0
5923,407264,500,7859,500,8859,1000,501,15.718,0.0
5924,80881,79,893,79,1051,158,80,11.304,0.0
5925,25568,75,225,75,375,150,76,3.0,0.0
5926,649285,500,13123,500,14123,1000,501,26.246,0.0
5927,523457,500,6076,500,7576,1500,525,12.152,0.0
5928,14358,8,156,8,196,40,33,19.5,0.0
593,294607,0,5950,0,6300,350,351,17.0,0.5
5946,458021,0,5500,0,6000,500,501,11.0,0.0
5947,336975,79,4684,79,4842,158,80,59.291,0.0
5948,51546,98,686,98,882,196,99,7.0,0.0
5949,25108,49,245,49,343,98,50,5.0,0.0
5951,71100,166,770,166,1102,332,167,4.639,0.0
5952,20005,0,215,0,258,43,44,5.0,0.0
5955,67590,80,1440,80,1600,160,81,18.0,0.0
596,666122,500,14433,500,15433,1000,502,28.866,0.75
5960,1425671,500,23196,500,24196,1000,501,46.392,0.0
5962,58610,81,1215,81,1377,162,82,15.0,0.0
5963,424407,0,8500,0,9000,500,501,17.0,0.0
5964,236272,500,2421,500,3421,1000,501,4.842,0.0
5965,12264,0,6,0,8,2,3,3.0,0.0
5966,15939,31,155,31,217,62,32,5.0,0.0
5967,792574,0,374,0,427,53,54,7.057,0.0
5968,57656,0,1230,0,1312,82,83,15.0,0.0
5969,207301,0,2460,0,2870,410,411,6.0,0.5
597,53851,0,696,0,812,116,117,6.0,0.0
5970,315137,79,4298,79,4456,158,80,54.405,0.0
5974,5614990,500,64680,500,65680,1000,501,129.36,0.0
5976,649350,0,10630,0,11130,500,501,21.26,0.0
5979,458044,500,5500,500,6500,1000,501,11.0,0.5
598,56237,59,702,59,879,177,119,11.898,0.0
5981,234678,500,3000,500,4000,1000,501,6.0,0.0
5982,271669,500,4000,500,5000,1000,501,8.0,0.0
5983,5084,0,48,0,60,12,13,4.0,0.0
5984,57245,79,1185,79,1343,158,80,15.0,0.0
5985,685825,500,8590,500,9590,1000,501,17.18,0.0
5986,735974,500,11202,500,12202,1000,501,22.404,0.0
5988,277517,500,2914,500,3914,1000,501,5.828,0.5
5989,58142,81,1215,81,1377,162,82,15.0,0.0
5990,140236,119,660,119,898,238,120,5.546,0.0
5991,57373,80,1200,80,1360,160,81,15.0,0.0
5992,70932,78,967,78,1123,156,79,12.397,0.0
5993,23325,32,212,32,276,64,33,6.625,0.75
5996,289104,500,2972,500,3972,1000,501,5.944,0.0
5997,13191,20,40,20,100,60,41,2.0,0.0
5998,33365,0,330,0,385,55,56,6.0,0.0
5999,687734,0,10647,0,11147,500,501,21.294,0.0
6,272953793,1208990,155784,1208990,3786372,3630588,1276314,25.982,0.0
60,18463,72,179,72,305,126,76,3.315,0.0
6000,209009,78,3671,78,3827,156,79,47.064,0.0
6001,67317,81,1458,81,1620,162,82,18.0,0.0
6003,2893,0,24,0,28,4,5,6.0,0.0
6004,392969,500,2989,500,3989,1000,501,5.978,0.0
6006,269318,347,3943,347,4637,694,348,11.363,0.0
6007,19284,29,165,29,223,58,30,5.69,0.0
6008,727172,500,11210,500,12210,1000,501,22.42,0.0
6011,30074,22,308,22,352,44,23,14.0,0.0
6013,13820,31,186,31,248,62,32,6.0,0.0
6014,72838,0,9,0,12,3,4,3.0,0.0
6016,297948,500,2866,500,3866,1000,501,5.732,0.0
6017,335576,500,4500,500,5500,1000,501,9.0,0.0
6018,291464,0,3626,0,4126,500,501,7.252,0.0
6019,21577,0,264,0,297,33,34,8.0,0.0
6020,966856,0,17051,0,17551,500,501,34.102,0.0
6021,88576,0,1568,0,1666,98,99,16.0,0.0
6022,383508,0,5500,0,6000,500,501,11.0,0.0
6023,36976,52,467,52,571,104,53,8.981,0.0
6024,240842,413,2890,413,3716,826,414,6.998,0.0
6025,214849,0,3055,0,3120,65,66,47.0,0.0
6026,548088,0,9500,0,10000,500,501,19.0,0.0
6027,23642,34,305,34,373,68,35,8.971,0.0
6028,51401,0,736,0,828,92,93,8.0,0.0
6029,665156,1000,12269,1000,14269,2000,1002,12.269,0.0
6030,27789,92,310,92,517,207,114,3.37,0.0
6031,83142,37,1857,37,1931,74,38,50.189,0.0
6032,443930,486,5371,486,6343,972,487,11.051,0.0
6034,291422,500,3552,500,4552,1000,501,7.104,0.0
6035,511621,524,7467,524,8515,1048,526,14.25,0.0
6036,58294,70,538,70,748,210,139,7.686,0.0
6038,885611,500,11718,500,12718,1000,501,23.436,0.0
6039,204925,500,3000,500,4000,1000,501,6.0,0.0
6041,1019142,500,19859,500,20859,1000,501,39.718,0.0
6042,253113,175,3325,175,3675,350,176,19.0,0.0
6043,306386,264,2374,264,2902,528,265,8.992,0.5
6044,4739,9,43,9,61,18,10,4.778,0.0
6045,1166740,500,14564,500,15564,1000,501,29.128,0.0
6047,123244,151,1630,151,1932,302,152,10.795,0.0
6048,763966,500,9000,500,10000,1000,501,18.0,0.5
6050,239642,458,2744,458,3660,916,459,5.991,0.0
6051,391658,500,8067,500,9067,1000,501,16.134,0.0
6052,273628,500,4000,500,5000,1000,501,8.0,0.0
6053,226905,500,3000,500,4000,1000,501,6.0,0.0
6054,1113558,500,6140,500,7140,1000,501,12.28,0.0
6057,114657,58,1189,58,1479,290,233,20.5,0.0
6058,580949,1000,8904,1000,10904,2000,1002,8.904,0.0
6060,683108,500,12472,500,13472,1000,501,24.944,0.0
6061,693867,500,3992,500,4992,1000,501,7.984,0.0
6062,263307,500,3556,500,4556,1000,501,7.112,0.0
6064,950655,500,18896,500,19896,1000,501,37.792,0.0
6066,1321565,500,4000,500,5000,1000,501,8.0,0.0
6068,13519,1,10,1,12,2,2,10.0,0.0
6070,295031,500,4000,500,5000,1000,501,8.0,0.0
6090,778840,188,10072,188,10636,564,378,26.787,0.0
6092,989261,0,17127,0,17516,389,390,44.028,0.0
6093,242673,0,2381,0,2795,414,415,5.751,0.0
6095,287888,500,3500,500,4500,1000,501,7.0,0.0
6096,713054,0,11000,0,11500,500,501,22.0,0.0
6097,395365,500,5392,500,6392,1000,501,10.784,0.0
6099,335630,500,4500,500,5500,1000,501,9.0,0.0
61,44966,182,458,182,776,318,186,3.343,0.0
6100,438028,500,2740,500,3740,1000,501,5.48,0.0
6101,24490,36,204,36,276,72,37,5.667,0.0
6102,460881,500,5500,500,6500,1000,501,11.0,0.0
6103,44097,66,396,66,528,132,67,6.0,1.0
6104,472967,0,6500,0,7000,500,501,13.0,0.0
6105,248352,0,3500,0,4000,500,501,7.0,0.0
6106,738502,500,11237,500,12237,1000,501,22.474,0.0
6107,295166,377,2245,377,2999,754,378,5.955,0.0
6108,298790,500,3000,500,4000,1000,501,6.0,0.0
6109,392324,235,6050,235,6520,470,236,25.745,0.0
6112,60079,83,1245,83,1411,166,84,15.0,0.0
6113,9667544,500,3000,500,4000,1000,501,6.0,0.0
6114,4327750,356,2848,356,3560,712,357,8.0,0.0
6115,357743,79,4915,79,5073,158,80,62.215,0.0
6116,60137,83,1245,83,1411,166,84,15.0,0.0
6117,84161,135,773,135,1043,270,136,5.726,0.0
6118,66501,82,1470,82,1634,164,83,17.927,0.0
612,28616,67,134,67,335,201,135,2.0,0.0
6120,513674,500,6500,500,7500,1000,501,13.0,0.0
6122,1940567,53,424,53,530,106,54,8.0,0.0
6124,208874,0,3678,0,3756,78,79,47.154,0.0
6125,29369,50,299,50,399,100,51,5.98,0.0
6126,66713,81,1458,81,1620,162,82,18.0,0.0
6127,604870,0,8497,0,8997,500,501,16.994,0.0
6128,726161,500,11101,500,12101,1000,501,22.202,0.5
6129,250125,500,3500,500,4500,1000,501,7.0,0.0
613,5616,5,32,5,44,12,8,6.4,1.0
6130,720630,0,11189,0,11689,500,501,22.378,0.0
6131,72708,0,829,0,995,166,167,4.994,0.0
6132,258999,0,2888,0,3388,500,501,5.776,0.0
6133,148281,77,2296,77,2450,154,78,29.818,0.0
6134,58313,0,1215,0,1296,81,82,15.0,0.0
6135,279159,500,3500,500,4500,1000,501,7.0,0.0
6137,5084,0,66,0,78,12,13,5.5,0.0
61382,1166224,0,14592,0,15592,1000,1001,14.592,0.5
61385,28206,42,368,42,452,84,43,8.762,1.0
61386,40721,68,408,68,544,136,69,6.0,0.0
61387,63178,84,735,84,903,168,85,8.75,1.0
61388,1093541,1000,17932,1000,19932,2000,1001,17.932,0.5
6139,273996,0,2983,0,3483,500,501,5.966,0.0
61391,49950,55,706,55,816,110,56,12.836,1.0
61393,75012,96,959,96,1151,192,97,9.99,0.0
61394,12203,11,154,11,176,22,12,14.0,1.0
61395,26635,23,322,23,368,46,24,14.0,0.0
61396,19519,48,192,48,288,96,49,4.0,0.0
6140,21532,0,203,0,238,35,36,5.8,0.0
61402,836745,425,10960,425,11810,850,426,25.788,0.5
61408,48357,110,550,110,770,220,111,5.0,0.0
6141,14738,0,125,0,175,50,51,5.0,0.0
61415,252839,501,3434,501,4436,1002,502,6.854,0.0
6142,59900,83,1245,83,1411,166,84,15.0,0.0
61420,19585,37,222,37,296,74,38,6.0,0.0
61425,48308,47,470,47,564,94,48,10.0,0.0
61426,1843,2,16,2,20,4,3,8.0,0.0
61427,116638,425,425,425,1275,850,426,1.0,0.0
61429,12708,12,168,12,192,24,13,14.0,0.0
6143,594770,0,5456,0,5956,500,501,10.912,0.0
61430,1095275,1000,14110,1000,16110,2000,1001,14.11,0.5
61431,13442,24,164,24,212,48,25,6.833,0.0
61434,6281,6,90,6,102,12,7,15.0,0.0
61437,227514,454,3178,454,4086,908,455,7.0,0.0
61438,58202,54,540,54,648,108,55,10.0,0.0
61439,13717,48,48,48,144,96,49,1.0,0.0
61440,99252,53,1378,53,1484,106,54,26.0,0.0
61442,72290,66,1254,66,1386,132,67,19.0,0.0
61443,72555,66,1254,66,1386,132,67,19.0,0.75
61444,32699,47,470,47,564,94,48,10.0,0.0
61446,69254,66,1386,66,1518,132,67,21.0,0.0
61449,43250,47,376,47,470,94,48,8.0,0.0
6145,461504,500,5500,500,6500,1000,501,11.0,0.0
61450,12085,20,160,20,200,40,21,8.0,0.0
61451,11715,30,120,30,180,60,31,4.0,0.0
61452,57093,47,705,47,799,94,48,15.0,0.0
61453,8084,10,110,10,130,20,11,11.0,0.0
61455,12659,11,154,11,176,22,12,14.0,0.0
61457,16993,60,60,60,180,120,61,1.0,0.0
61458,7186,12,72,12,96,24,13,6.0,0.0
6146,67337,82,1470,82,1634,164,83,17.927,0.0
61461,1834,2,16,2,20,4,3,8.0,0.0
61463,6398,10,80,10,100,20,11,8.0,0.0
61464,9360,0,84,0,105,21,22,4.0,0.0
61466,22402,47,278,47,372,94,48,5.915,0.0
61467,3228,0,28,0,35,7,8,4.0,0.0
61468,6565,6,54,6,66,12,7,9.0,1.0
61469,3453,3,45,3,51,6,4,15.0,0.0
6147,32304,58,344,58,460,116,59,5.931,0.0
61470,114169,172,1531,172,1875,344,173,8.901,0.0
61471,57093,47,705,47,799,94,48,15.0,0.0
61472,6565,6,54,6,66,12,7,9.0,1.0
61473,25992,23,345,23,391,46,24,15.0,0.75
61477,48119,47,470,47,564,94,48,10.0,0.0
61482,72290,66,1254,66,1386,132,67,19.0,0.0
61484,57093,47,705,47,799,94,48,15.0,0.0
61485,21678,23,299,23,345,46,24,13.0,0.75
61486,24458,23,299,23,345,46,24,13.0,0.0
61487,22213,47,278,47,372,94,48,5.915,0.0
61489,22215,23,299,23,345,46,24,13.0,0.0
6149,2967,0,21,0,28,7,8,3.0,0.0
61491,19436,37,222,37,296,74,38,6.0,0.0
61492,15082,53,53,53,159,106,54,1.0,0.0
61494,13731,11,154,11,176,22,12,14.0,0.0
61495,25004,23,345,23,391,46,24,15.0,0.0
61499,5620,10,60,10,80,20,11,6.0,0.0
61500,13212,11,165,11,187,22,12,15.0,0.0
61501,13444,47,47,47,141,94,48,1.0,0.0
61502,1842,2,16,2,20,4,3,8.0,0.0
61505,14435,11,154,11,176,22,12,14.0,0.0
61506,23885,23,322,23,368,46,24,14.0,0.0
61507,57282,47,705,47,799,94,48,15.0,0.0
61508,3158,4,32,4,40,8,5,8.0,0.0
61509,21108,36,244,36,316,72,37,6.778,0.0
6151,33809,65,390,65,520,130,66,6.0,0.0
61511,4749,8,56,8,72,16,9,7.0,0.0
61512,72290,66,1254,66,1386,132,67,19.0,0.0
61516,89754,53,1219,53,1325,106,54,23.0,0.0
61517,2367,3,24,3,30,6,4,8.0,0.0
6152,267602,500,2823,500,3823,1000,501,5.646,0.0
61520,4623,4,56,4,64,8,5,14.0,0.0
61522,2827,6,24,6,36,12,7,4.0,0.0
61524,15082,53,53,53,159,106,54,1.0,0.0
61528,99252,53,1378,53,1484,106,54,26.0,0.0
61529,11479,0,140,0,160,20,21,7.0,0.0
6153,719013,0,11180,0,11680,500,501,22.36,0.0
61530,2525,3,24,3,30,6,4,8.0,0.0
61532,12909,11,154,11,176,22,12,14.0,0.0
61535,7574,11,88,11,110,22,12,8.0,0.0
61536,9590,9,126,9,144,18,10,14.0,0.5
61538,2351,3,24,3,30,6,4,8.0,0.0
61539,5730,10,70,10,90,20,11,7.0,0.0
6154,27878,66,396,66,528,132,67,6.0,0.0
61540,23643,48,288,48,384,96,49,6.0,0.0
61547,6195,6,48,6,60,12,7,8.0,0.0
61549,2812,3,33,3,39,6,4,11.0,0.0
6155,56285,69,690,69,828,138,70,10.0,0.0
61554,29631,39,429,39,507,78,40,11.0,0.0
61555,32155,30,449,30,509,60,31,14.967,0.0
61557,10829,11,143,11,165,22,12,13.0,0.0
61558,10213,16,112,16,144,32,17,7.0,0.0
6156,89013,159,795,159,1113,318,160,5.0,0.0
61566,5868,12,48,12,72,24,13,4.0,0.0
61568,12797,11,154,11,176,22,12,14.0,0.0
6157,66158,80,1440,80,1600,160,81,18.0,0.0
61571,11134,20,135,20,175,40,21,6.75,0.0
61572,10714,37,37,37,111,74,38,1.0,0.0
61577,2338,3,24,3,30,6,4,8.0,0.0
6158,278733,49,4188,49,4286,98,50,85.469,0.0
61582,10350,7,70,7,84,14,8,10.0,0.0
61585,15082,53,53,53,159,106,54,1.0,0.0
61587,89754,53,1219,53,1325,106,54,23.0,0.0
61588,6141,12,72,12,96,24,13,6.0,0.0
61589,13633,47,47,47,141,94,48,1.0,0.0
6159,12452,25,125,25,175,50,26,5.0,0.0
61591,2863,3,33,3,39,6,4,11.0,0.0
61594,57093,47,705,47,799,94,48,15.0,0.0
61596,1840,2,16,2,20,4,3,8.0,0.0
6160,67375,81,1419,81,1581,162,82,17.519,0.0
61601,12667,11,154,11,176,22,12,14.0,0.0
61602,1838,2,16,2,20,4,3,8.0,0.0
61603,2367,3,24,3,30,6,4,8.0,0.0
61606,273613,1000,1000,1000,3000,2000,1001,1.0,0.0
61609,1834,2,16,2,20,4,3,8.0,0.0
61610,1839,2,16,2,20,4,3,8.0,0.0
61611,1243,1,8,1,10,2,2,8.0,0.0
61623,1859,2,16,2,20,4,3,8.0,0.0
61624,10504,16,122,16,154,32,17,7.625,0.0
61625,1830,2,16,2,20,4,3,8.0,0.0
61626,1878,2,16,2,20,4,3,8.0,0.0
61628,3831,5,40,5,50,10,6,8.0,0.0
61629,1848,2,16,2,20,4,3,8.0,0.0
6163,15074,30,145,30,205,60,31,4.833,0.0
61631,6674,5,75,5,85,10,6,15.0,0.0
61635,15082,53,53,53,159,106,54,1.0,0.0
61637,116638,425,425,425,1275,850,426,1.0,0.0
61639,17234,60,60,60,180,120,61,1.0,0.0
6164,15767,25,125,25,200,75,51,5.0,0.0
61642,1849,2,16,2,20,4,3,8.0,0.0
61643,1842,2,16,2,20,4,3,8.0,0.0
61646,13444,47,47,47,141,94,48,1.0,0.0
61651,1819,2,16,2,20,4,3,8.0,0.0
61652,13444,47,47,47,141,94,48,1.0,0.0
61654,1770,2,16,2,20,4,3,8.0,0.0
61655,27869,27,270,27,324,54,28,10.0,0.0
61656,1373,1,11,1,13,2,2,11.0,0.0
61657,22165,35,280,35,350,70,36,8.0,0.0
61658,8265,12,96,12,120,24,13,8.0,0.0
61659,2558,3,24,3,30,6,4,8.0,0.0
6166,419679,0,8500,0,9000,500,501,17.0,0.0
61660,1837,2,16,2,20,4,3,8.0,0.0
61662,5728,8,64,8,80,16,9,8.0,0.0
61663,2534,3,24,3,30,6,4,8.0,0.0
61665,2546,3,24,3,30,6,4,8.0,0.0
61666,2534,3,24,3,30,6,4,8.0,0.0
61667,43250,47,376,47,470,94,48,8.0,0.0
61668,3170,4,32,4,40,8,5,8.0,0.0
61669,1831,2,16,2,20,4,3,8.0,0.0
6167,1424473,0,28500,0,29000,500,501,57.0,0.0
61670,1252,1,8,1,10,2,2,8.0,0.0
61671,13633,47,47,47,141,94,48,1.0,0.0
61672,1837,2,16,2,20,4,3,8.0,0.0
61673,1850,2,16,2,20,4,3,8.0,0.0
61674,4494,6,48,6,60,12,7,8.0,0.0
61675,1867,2,16,2,20,4,3,8.0,0.0
61677,4415,6,48,6,60,12,7,8.0,0.0
6168,353305,0,5185,0,5685,500,501,10.37,0.0
61681,10136,15,120,15,150,30,16,8.0,0.0
61684,12880,19,150,19,188,38,20,7.895,0.0
61688,3153,4,32,4,40,8,5,8.0,0.0
61689,268153,980,980,980,2940,1960,981,1.0,0.0
6169,342439,0,5518,0,6018,500,501,11.036,0.0
61691,13444,47,47,47,141,94,48,1.0,0.0
61696,1833,2,16,2,20,4,3,8.0,0.0
617,443561,0,7000,0,7500,500,501,14.0,0.0
6170,592041,0,9954,0,10454,500,501,19.908,0.0
61701,194443,710,710,710,2130,1420,711,1.0,0.0
61704,116638,425,425,425,1275,850,426,1.0,0.0
61708,268153,980,980,980,2940,1960,981,1.0,0.0
61709,273613,1000,1000,1000,3000,2000,1001,1.0,0.0
6171,3051,0,44,0,46,2,3,22.0,0.0
61711,116638,425,425,425,1275,850,426,1.0,0.0
61714,1844,2,16,2,20,4,3,8.0,0.0
61716,1840,2,16,2,20,4,3,8.0,0.0
61717,277614,1000,1000,1000,3000,2000,1001,1.0,0.0
61718,13444,47,47,47,141,94,48,1.0,0.0
61719,272074,980,980,980,2940,1960,981,1.0,0.0
6172,29141,0,560,0,595,35,36,16.0,0.0
61722,268153,980,980,980,2940,1960,981,1.0,0.0
61732,118339,425,425,425,1275,850,426,1.0,0.0
61733,268153,980,980,980,2940,1960,981,1.0,0.0
61735,116638,425,425,425,1275,850,426,1.0,0.0
6174,1469593,500,3985,500,4985,1000,501,7.97,0.0
61746,892331,1000,13979,1000,15979,2000,1001,13.979,0.5
61748,1189992,1000,14999,1000,16999,2000,1001,14.999,0.0
61749,1378526,0,22410,0,23410,1000,1001,22.41,0.0
6175,412445,103,411,103,617,206,104,3.99,0.0
61752,613317,0,9000,0,10000,1000,1001,9.0,0.0
61757,230652,112,3580,112,3804,224,113,31.964,0.0
6176,69767,152,760,152,1064,304,153,5.0,0.0
61761,1182969,1000,14998,1000,16998,2000,1001,14.998,0.0
61764,1182229,0,15000,0,16000,1000,1001,15.0,0.0
61767,22005,0,256,0,282,26,27,9.846,0.0
61771,330372,0,2586,0,3448,862,863,3.0,0.5
61778,348753,0,3031,0,3116,85,86,35.659,0.0
6178,1945493,500,4000,500,5000,1000,501,8.0,0.0
61782,124639,189,1722,189,2100,378,190,9.111,0.0
61785,86687,73,1264,73,1483,219,75,17.315,0.0
61786,249589,1000,1000,1000,3000,2000,1001,1.0,0.0
61794,68872,157,628,157,942,314,158,4.0,0.0
61797,22883,0,420,0,441,21,22,20.0,0.0
61798,5003,0,88,0,92,4,5,22.0,0.0
6180,27150,62,258,62,382,124,63,4.161,0.0
61802,434903,542,4840,542,5924,1084,543,8.93,0.5
6181,1052389,500,8999,500,9999,1000,501,17.998,0.0
61816,8557,32,32,32,96,64,33,1.0,0.0
6182,225037,500,2490,500,3490,1000,501,4.98,0.0
61828,1089358,0,12998,0,13998,1000,1001,12.998,0.0
6183,195566,135,1733,135,2003,270,136,12.837,0.0
6185,51991,103,515,103,721,206,104,5.0,0.0
6186,721873,500,14210,500,15210,1000,501,28.42,0.0
61860,1200854,1000,15000,1000,17000,2000,1001,15.0,0.0
6187,32459,90,360,90,540,180,91,4.0,0.0
61878,13081,42,84,42,168,84,43,2.0,0.0
6188,200101,500,2500,500,3500,1000,501,5.0,0.0
61880,1200452,1000,15000,1000,17000,2000,1001,15.0,0.0
61884,422240,0,6902,0,7214,312,313,22.122,0.0
61888,5903,21,21,21,63,42,22,1.0,0.0
61893,197299,790,790,790,2370,1580,791,1.0,0.0
61901,63530,123,690,123,936,246,124,5.61,0.0
61902,10267,22,110,22,154,44,23,5.0,0.0
61905,10227,0,110,0,132,22,23,5.0,0.0
6191,332511,276,4231,276,4783,552,277,15.33,0.0
61912,1200218,1000,15000,1000,17000,2000,1001,15.0,0.0
61916,249589,1000,1000,1000,3000,2000,1001,1.0,0.0
61918,23516,47,235,47,329,94,48,5.0,0.0
6192,11360,10,120,10,150,30,21,12.0,0.0
61922,5776,8,56,8,72,16,9,7.0,0.5
61924,48646,193,193,193,579,386,194,1.0,0.0
6193,18983662,2,10,2,14,4,3,5.0,0.0
61933,5277,0,52,0,65,13,14,4.0,0.0
61939,8059,30,30,30,90,60,31,1.0,0.0
61940,23327,47,235,47,329,94,48,5.0,0.0
61942,46309,93,651,93,837,186,94,7.0,0.0
61944,7291,21,63,21,105,42,22,3.0,0.0
61946,56759,0,792,0,880,88,89,9.0,0.0
6195,1856,3,12,3,18,6,4,4.0,0.0
6196,403394,1,6,1,8,2,2,6.0,0.5
61960,17277,0,148,0,185,37,38,4.0,0.0
61965,2830,9,9,9,27,18,10,1.0,0.0
6198,882158,500,16924,500,17924,1000,501,33.848,0.0
6199,1580554,500,19904,500,20904,1000,501,39.808,0.0
61995,19845,38,186,38,262,76,39,4.895,0.0
62,4976796,9607,57634,9607,76845,19211,9608,5.999,0.0
6201,49485,109,545,109,763,218,110,5.0,0.0
62010,3827,3,45,3,51,6,4,15.0,0.5
62017,422240,0,6902,0,7214,312,313,22.122,0.0
6202,22949,27,189,27,243,54,28,7.0,0.0
62020,3004,7,21,7,35,14,8,3.0,0.0
6203,393740,500,6751,500,7751,1000,501,13.502,0.0
6204,6633,20,70,20,110,40,22,3.5,0.0
62045,108328,147,1028,147,1322,294,148,6.993,0.0
6205,1212606,500,27722,500,28722,1000,501,55.444,0.0
62059,4345,7,42,7,56,14,8,6.0,0.0
62061,6154,0,94,0,98,4,5,23.5,0.0
6207,229520,500,3000,500,4000,1000,501,6.0,0.0
62074,5029,5,40,5,50,10,6,8.0,0.0
6208,745061,500,9277,500,10277,1000,501,18.554,0.0
6209,53769,52,676,52,780,104,53,13.0,1.0
6210,1830078,500,3500,500,4500,1000,501,7.0,0.0
62109,3639,0,50,0,52,2,3,25.0,0.0
6211,56841,20,233,20,273,40,21,11.65,0.0
62122,28532,0,350,0,400,50,51,7.0,0.0
6213,1199319,500,34220,500,35220,1000,501,68.44,0.0
62139,4781,6,54,6,66,12,7,9.0,0.0
62143,5767,6,42,6,54,12,7,7.0,0.0
62146,62162,73,904,73,1123,219,75,12.384,0.0
62148,3413,6,30,6,42,12,7,5.0,0.0
62151,8432,12,79,12,103,24,13,6.583,0.0
62152,4933,8,50,8,66,16,9,6.25,0.0
62153,5442,0,46,0,54,8,9,5.75,0.0
62158,2828,0,28,0,32,4,5,7.0,0.0
62161,2614,8,8,8,24,16,9,1.0,0.0
62166,5881,6,58,6,70,12,7,9.667,0.0
62169,249589,1000,1000,1000,3000,2000,1001,1.0,0.0
62171,6099,12,60,12,84,24,13,5.0,0.75
62174,4333,7,40,7,54,14,8,5.714,0.0
62175,4455,0,30,0,36,6,7,5.0,0.0
62176,3269,5,30,5,40,10,6,6.0,0.0
62179,5351,9,51,9,69,18,10,5.667,0.0
62180,4860,8,50,8,66,16,9,6.25,0.0
62182,2887,6,18,6,30,12,7,3.0,0.0
62183,4616,6,48,6,60,12,7,8.0,0.0
62184,5923,9,54,9,72,18,10,6.0,0.0
62186,9176,6,45,6,57,12,7,7.5,0.0
62187,5898,10,58,10,78,20,11,5.8,0.0
62188,2083,6,6,6,18,12,7,1.0,0.0
62189,34790,72,432,72,576,144,73,6.0,0.0
62191,10174,12,84,12,108,24,13,7.0,0.75
62194,1059,1,5,1,7,2,2,5.0,0.0
62195,4375,7,40,7,54,14,8,5.714,0.0
62196,5426,8,46,8,62,16,9,5.75,0.0
62197,8292,14,82,14,110,28,15,5.857,0.0
62198,4831,8,53,8,69,16,9,6.625,0.0
62199,3224,5,29,5,39,10,6,5.8,0.0
62200,5845,10,58,10,78,20,11,5.8,0.0
62201,5574,4,30,4,38,8,5,7.5,0.0
62202,1336,3,3,3,9,6,4,1.0,0.0
62203,12532,0,168,0,189,21,22,8.0,0.0
62204,112460,0,1820,0,1903,83,84,21.928,0.0
62205,9638,8,56,8,72,16,9,7.0,0.0
62206,1834,5,5,5,15,10,6,1.0,0.0
62207,4083,6,35,6,47,12,7,5.833,0.0
62208,4796,0,50,0,58,8,9,6.25,0.0
62209,5219,9,51,9,69,18,10,5.667,0.0
62210,249589,1000,1000,1000,3000,2000,1001,1.0,0.0
62211,3280,5,30,5,40,10,6,6.0,0.0
62212,1188205,0,15000,0,16000,1000,1001,15.0,0.0
62214,6420,6,36,6,48,12,7,6.0,0.0
62215,3673,6,35,6,47,12,7,5.833,0.0
62217,3714,6,36,6,48,12,7,6.0,0.0
62219,8378,15,88,15,118,30,16,5.867,0.0
62220,4245,7,39,7,53,14,8,5.571,0.0
62223,2211,5,15,5,25,10,6,3.0,0.0
62224,7746,6,40,6,52,12,7,6.667,0.0
62225,4950,9,52,9,70,18,10,5.778,0.0
62229,2685,4,24,4,32,8,5,6.0,0.0
62230,12251,0,80,0,92,12,13,6.667,0.0
62237,4243,0,42,0,48,6,7,7.0,0.0
62241,4820,8,40,8,56,16,9,5.0,0.0
62242,4717,10,50,10,70,20,11,5.0,0.0
62243,4680,6,51,6,63,12,7,8.5,0.0
62246,3025,5,25,5,35,10,6,5.0,0.0
62247,4857,0,51,0,59,8,9,6.375,0.0
62248,4353,6,42,6,54,12,7,7.0,0.0
62251,5303,9,52,9,70,18,10,5.778,0.0
62252,3930,6,38,6,50,12,7,6.333,0.0
62255,455233,1000,7133,1000,9133,2000,1001,7.133,0.0
62257,4989,8,46,8,62,16,9,5.75,0.0
62258,5283,0,52,0,60,8,9,6.5,0.0
62259,40429,160,160,160,480,320,161,1.0,0.0
62261,5120,8,49,8,65,16,9,6.125,0.0
62262,5978,10,58,10,78,20,11,5.8,0.0
62264,9347,10,120,10,140,20,11,12.0,0.0
62268,2825,6,18,6,30,12,7,3.0,0.0
62269,4930,0,52,0,60,8,9,6.5,0.75
62271,4909,0,52,0,60,8,9,6.5,0.0
62273,6182,12,60,12,84,24,13,5.0,0.0
62276,4775,0,49,0,57,8,9,6.125,0.0
62282,4705,0,48,0,56,8,9,6.0,0.5
62284,4385,0,45,0,53,8,9,5.625,0.0
62285,2638,0,24,0,28,4,5,6.0,0.0
62287,4834,0,46,0,54,8,9,5.75,0.0
62288,3882,4,24,4,32,8,5,6.0,0.0
6229,689994,455,9881,455,11291,1410,957,10.347,0.5
62290,5433,0,52,0,60,8,9,6.5,0.5
62291,6259,9,54,9,72,18,10,6.0,0.0
62292,7571,15,80,15,110,30,16,5.333,0.0
62293,4622,8,44,8,60,16,9,5.5,0.0
62297,4464,8,40,8,56,16,9,5.0,0.0
62299,5107,9,54,9,72,18,10,6.0,0.0
62302,2830,9,9,9,27,18,10,1.0,0.0
62306,2095,3,18,3,24,6,4,6.0,0.0
62308,4477,8,40,8,56,16,9,5.0,0.0
6231,11256,17,102,17,136,34,18,6.0,0.0
62311,7646,14,70,14,98,28,15,5.0,0.0
62312,111037,204,1244,204,1652,408,205,6.098,0.0
62313,9048,15,88,15,118,30,16,5.867,0.5
62318,5746,9,61,9,79,18,10,6.778,0.0
6232,10838,12,144,12,168,24,13,12.0,0.0
62325,2891,5,25,5,35,10,6,5.0,0.5
6233,58445,83,1230,83,1396,166,84,14.819,0.0
62332,4219,0,40,0,47,7,8,5.714,0.0
62333,4370,6,32,6,44,12,7,5.333,0.5
62335,3273,0,44,0,46,2,3,22.0,0.0
62336,4220,6,42,6,54,12,7,7.0,0.0
62338,4810,7,49,7,63,14,8,7.0,0.0
62339,2457,4,18,4,26,8,5,4.5,0.0
6234,523355,500,6500,500,7500,1000,501,13.0,0.0
62341,3743,0,34,0,40,6,7,5.667,0.0
62347,15529,60,60,60,180,120,61,1.0,0.0
62348,5080,7,45,7,59,14,8,6.429,0.0
62349,5778,12,52,12,76,24,13,4.333,0.0
6235,401951,500,8500,500,9500,1000,501,17.0,0.0
62350,5838,6,44,6,56,12,7,7.333,0.0
62351,4438,8,36,8,52,16,9,4.5,0.0
62353,3759,6,35,6,47,12,7,5.833,0.0
62354,2830,9,9,9,27,18,10,1.0,0.0
62355,3602,6,30,6,42,12,7,5.0,0.0
62359,28477,112,112,112,336,224,113,1.0,0.0
6236,164004,0,1850,0,2220,370,371,10.0,0.0
62360,249589,1000,1000,1000,3000,2000,1001,1.0,0.0
62362,3831,4,24,4,32,8,5,6.0,0.5
62365,4499,8,46,8,62,16,9,5.75,0.0
6237,46732,67,402,67,536,134,68,6.0,0.0
62370,2581,8,8,8,24,16,9,1.0,0.0
62372,4700,7,42,7,56,14,8,6.0,0.0
62376,4619,0,46,0,54,8,9,5.75,0.0
62377,1379,2,8,2,12,4,3,4.0,0.0
62378,1087,2,2,2,6,4,3,1.0,0.0
62379,3056,5,27,5,37,10,6,5.4,0.0
6238,213723,500,2000,500,3000,1000,501,4.0,0.0
62382,2415,4,18,4,26,8,5,4.5,0.0
62385,2332,7,7,7,21,14,8,1.0,0.0
62388,1345,2,6,2,10,4,3,3.0,0.0
6239,303418,24,192,24,240,48,25,8.0,0.0
62390,21110,60,180,60,300,120,61,3.0,0.0
62393,3979,4,24,4,32,8,5,6.0,0.0
62394,3018,5,25,5,35,10,6,5.0,0.0
62398,2083,6,6,6,18,12,7,1.0,0.0
62399,2665,0,24,0,28,4,5,6.0,0.0
62401,40478,60,600,60,720,120,61,10.0,0.0
62402,18806,72,72,72,216,144,73,1.0,0.0
62404,3389,4,24,4,32,8,5,6.0,0.0
62405,3120,10,10,10,30,20,11,1.0,0.75
62406,2581,8,8,8,24,16,9,1.0,0.0
62407,249589,1000,1000,1000,3000,2000,1001,1.0,0.0
62408,2494,4,20,4,28,8,5,5.0,0.0
62409,2790,4,21,4,29,8,5,5.25,1.0
6241,66532,80,1440,80,1600,160,81,18.0,0.0
62411,2581,8,8,8,24,16,9,1.0,0.0
6242,457996,0,5500,0,6000,500,501,11.0,0.0
6243,73881,166,830,166,1162,332,167,5.0,0.0
62438,249589,1000,1000,1000,3000,2000,1001,1.0,0.0
62440,249589,1000,1000,1000,3000,2000,1001,1.0,0.0
62443,2614,8,8,8,24,16,9,1.0,0.0
62444,469467,646,5168,646,6460,1292,647,8.0,0.5
62445,2572,3,20,3,26,6,4,6.667,0.0
62446,5071,18,18,18,54,36,19,1.0,0.0
62448,2879,5,25,5,35,10,6,5.0,0.5
62449,249589,1000,1000,1000,3000,2000,1001,1.0,0.0
6245,67269,83,1488,83,1654,166,84,17.928,0.0
62450,28726,113,113,113,339,226,114,1.0,0.0
62451,249589,1000,1000,1000,3000,2000,1001,1.0,0.0
62453,4359,8,40,8,56,16,9,5.0,0.0
62454,17770,69,69,69,207,138,70,1.0,0.0
6246,300450,78,3651,78,3807,156,79,46.808,0.0
62465,249589,1000,1000,1000,3000,2000,1001,1.0,0.0
62467,3966,8,33,8,49,16,9,4.125,0.0
62469,1705,3,11,3,17,6,4,3.667,0.0
62471,1458,2,9,2,13,4,3,4.5,0.0
62476,2581,8,8,8,24,16,9,1.0,0.0
6248,720910,500,11121,500,12121,1000,501,22.242,0.0
62481,2581,8,8,8,24,16,9,1.0,0.0
62482,2581,8,8,8,24,16,9,1.0,0.0
62483,3577,12,12,12,36,24,13,1.0,0.0
62484,843,1,1,1,3,2,2,1.0,0.0
62485,1087,2,2,2,6,4,3,1.0,0.0
62486,2830,9,9,9,27,18,10,1.0,0.0
62487,249589,1000,1000,1000,3000,2000,1001,1.0,0.0
62488,1636,2,12,2,16,4,3,6.0,0.0
6249,795264,53,376,53,482,106,54,7.094,0.0
62490,249589,1000,1000,1000,3000,2000,1001,1.0,0.0
62493,4324,15,15,15,45,30,16,1.0,1.0
62494,249589,1000,1000,1000,3000,2000,1001,1.0,1.0
62495,1563,2,8,2,12,4,3,4.0,0.0
62496,2273,2,20,2,24,4,3,10.0,0.0
62498,66623,261,261,261,783,522,262,1.0,0.0
62499,2581,8,8,8,24,16,9,1.0,0.0
625,194362,53,1666,53,2272,606,555,3.013,0.5
6250,287862,473,2838,473,3784,946,474,6.0,0.0
62500,1718,2,11,2,15,4,3,5.5,0.0
62501,66623,261,261,261,783,522,262,1.0,0.0
62503,1678,2,12,2,16,4,3,6.0,0.0
6251,412198,500,6393,500,7393,1000,501,12.786,0.0
6252,51728,61,714,61,836,122,62,11.705,0.0
62524,1719,3,11,3,17,6,4,3.667,0.0
6253,65589,0,1452,0,1533,81,82,17.926,0.0
62530,48407,189,189,189,567,378,190,1.0,0.5
62531,51385,204,204,204,612,408,205,1.0,0.0
62533,253590,1000,1000,1000,3000,2000,1001,1.0,0.0
62534,40429,160,160,160,480,320,161,1.0,0.0
62535,253590,1000,1000,1000,3000,2000,1001,1.0,0.0
62536,48407,189,189,189,567,378,190,1.0,0.0
62537,2830,9,9,9,27,18,10,1.0,0.0
62538,2830,9,9,9,27,18,10,1.0,0.0
62539,5071,18,18,18,54,36,19,1.0,0.0
62541,249589,1000,1000,1000,3000,2000,1001,1.0,0.0
62543,1565,2,10,2,14,4,3,5.0,0.0
62544,249589,1000,1000,1000,3000,2000,1001,1.0,0.0
62547,2924,6,24,6,36,12,7,4.0,0.0
62549,936,1,3,1,5,2,2,3.0,0.0
6255,57716,80,1186,80,1346,160,81,14.825,0.0
62550,1709,2,8,2,12,4,3,4.0,0.0
62551,2581,8,8,8,24,16,9,1.0,0.0
62552,5071,18,18,18,54,36,19,1.0,0.0
62553,8180,30,30,30,90,60,31,1.0,0.0
62554,4385,15,15,15,45,30,16,1.0,0.5
62555,47650,189,189,189,567,378,190,1.0,0.0
62556,1349,3,3,3,9,6,4,1.0,0.0
62557,1475,1,12,1,14,2,2,12.0,0.0
62558,37781,147,147,147,441,294,148,1.0,0.0
62559,2332,7,7,7,21,14,8,1.0,0.0
62560,2581,8,8,8,24,16,9,1.0,0.0
62561,2332,7,7,7,21,14,8,1.0,0.0
62562,21256,83,83,83,249,166,84,1.0,0.5
62563,47650,189,189,189,567,378,190,1.0,0.0
62565,1336,3,3,3,9,6,4,1.0,0.0
62567,1336,3,3,3,9,6,4,1.0,0.0
62568,51385,204,204,204,612,408,205,1.0,0.0
62569,6129,9,72,9,90,18,10,8.0,0.0
62570,5467,8,48,8,64,16,9,6.0,0.0
62571,2104,4,15,4,23,8,5,3.75,0.0
62572,47650,189,189,189,567,378,190,1.0,0.0
62573,3642,7,28,7,42,14,8,4.0,0.0
62574,52202,204,204,204,612,408,205,1.0,0.0
62575,51921,132,394,132,658,264,133,2.985,0.0
62576,4573,16,16,16,48,32,17,1.0,1.0
62578,28926,112,112,112,336,224,113,1.0,0.0
62579,2332,7,7,7,21,14,8,1.0,0.0
62580,2830,9,9,9,27,18,10,1.0,0.0
62582,18766,73,73,73,219,146,74,1.0,0.0
62583,249091,998,998,998,2994,1996,999,1.0,0.0
62584,2108,6,6,6,18,12,7,1.0,0.0
62587,2918,4,24,4,32,8,5,6.0,0.0
62589,37192,147,147,147,441,294,148,1.0,0.0
6259,225171,0,3000,0,3500,500,501,6.0,0.0
62591,249589,1000,1000,1000,3000,2000,1001,1.0,0.0
62593,6129,9,72,9,90,18,10,8.0,0.5
62594,50389,200,200,200,600,400,201,1.0,0.0
62596,249589,1000,1000,1000,3000,2000,1001,1.0,0.0
62597,2361,7,7,7,21,14,8,1.0,0.0
62598,253590,1000,1000,1000,3000,2000,1001,1.0,1.0
62599,1608,2,10,2,14,4,3,5.0,0.0
6260,723346,0,11013,0,11513,500,501,22.026,0.0
62601,249589,1000,1000,1000,3000,2000,1001,1.0,0.0
62602,47650,189,189,189,567,378,190,1.0,0.0
62603,2867,9,9,9,27,18,10,1.0,0.0
62606,249589,1000,1000,1000,3000,2000,1001,1.0,0.0
62607,48407,189,189,189,567,378,190,1.0,0.0
62608,249589,1000,1000,1000,3000,2000,1001,1.0,0.0
6261,65292,0,1422,0,1501,79,80,18.0,0.0
62610,47650,189,189,189,567,378,190,1.0,0.0
62611,51385,204,204,204,612,408,205,1.0,0.0
62612,1087,2,2,2,6,4,3,1.0,0.0
62615,66623,261,261,261,783,522,262,1.0,0.0
62618,1695,2,11,2,15,4,3,5.5,0.0
62619,9304,35,35,35,105,70,36,1.0,0.0
6262,5701,4,12,4,20,8,5,3.0,0.0
62627,249589,1000,1000,1000,3000,2000,1001,1.0,1.0
62628,24119,93,93,93,279,186,94,1.0,0.0
6263,36054,57,285,57,399,114,58,5.0,0.0
62633,249589,1000,1000,1000,3000,2000,1001,1.0,1.0
62637,249589,1000,1000,1000,3000,2000,1001,1.0,0.0
6264,210004,0,2808,0,2886,78,79,36.0,0.0
62642,249589,1000,1000,1000,3000,2000,1001,1.0,0.0
62645,51385,204,204,204,612,408,205,1.0,0.0
62647,249589,1000,1000,1000,3000,2000,1001,1.0,0.0
62648,37192,147,147,147,441,294,148,1.0,0.0
62649,249589,1000,1000,1000,3000,2000,1001,1.0,0.0
62652,1585,4,4,4,12,8,5,1.0,0.0
62653,1741,2,11,2,15,4,3,5.5,0.0
62657,3577,12,12,12,36,24,13,1.0,0.0
62658,249589,1000,1000,1000,3000,2000,1001,1.0,1.0
6266,13158,19,145,19,183,38,20,7.632,0.0
62661,47650,189,189,189,567,378,190,1.0,0.0
62663,249589,1000,1000,1000,3000,2000,1001,1.0,0.0
62667,21256,83,83,83,249,166,84,1.0,0.5
62668,2083,6,6,6,18,12,7,1.0,0.0
6267,59984,83,1245,83,1411,166,84,15.0,0.0
62671,6167,9,72,9,90,18,10,8.0,0.0
62675,249589,1000,1000,1000,3000,2000,1001,1.0,1.0
62678,51385,204,204,204,612,408,205,1.0,0.0
6268,12348,25,125,25,175,50,26,5.0,0.0
62681,2083,6,6,6,18,12,7,1.0,0.0
62682,47650,189,189,189,567,378,190,1.0,0.0
62684,249589,1000,1000,1000,3000,2000,1001,1.0,0.0
62686,51190,200,200,200,600,400,201,1.0,0.0
62699,1638,2,11,2,15,4,3,5.5,0.5
6270,14810,27,133,27,187,54,28,4.926,0.6
62701,2581,8,8,8,24,16,9,1.0,0.0
62705,1042,1,4,1,6,2,2,4.0,0.0
62706,3079,10,10,10,30,20,11,1.0,0.0
62707,50389,200,200,200,600,400,201,1.0,0.0
62709,249091,998,998,998,2994,1996,999,1.0,0.0
6271,729795,500,11096,500,12096,1000,501,22.192,0.0
62711,41070,160,160,160,480,320,161,1.0,0.0
62715,249589,1000,1000,1000,3000,2000,1001,1.0,0.0
62716,50389,200,200,200,600,400,201,1.0,0.0
62718,249589,1000,1000,1000,3000,2000,1001,1.0,0.0
62721,66623,261,261,261,783,522,262,1.0,0.0
62722,2614,8,8,8,24,16,9,1.0,0.0
62724,3210,4,23,4,31,8,5,5.75,0.0
62725,9304,35,35,35,105,70,36,1.0,0.0
62726,9445,35,35,35,105,70,36,1.0,0.0
62727,6161,9,72,9,90,18,10,8.0,0.0
62728,37192,147,147,147,441,294,148,1.0,0.0
6273,67801,78,778,78,934,156,79,9.974,0.0
62730,2332,7,7,7,21,14,8,1.0,0.0
62731,2332,7,7,7,21,14,8,1.0,0.0
62732,2830,9,9,9,27,18,10,1.0,0.0
62734,6814,25,25,25,75,50,26,1.0,0.0
62735,65578,261,261,261,783,522,262,1.0,0.0
62736,2299,2,14,2,18,4,3,7.0,0.0
62738,37192,147,147,147,441,294,148,1.0,0.0
6274,509282,0,6500,0,7000,500,501,13.0,0.5
62747,6175,9,72,9,90,18,10,8.0,0.0
62748,50389,200,200,200,600,400,201,1.0,0.0
6275,308688,500,3499,500,4499,1000,501,6.998,0.0
62750,52202,204,204,204,612,408,205,1.0,0.0
62751,249589,1000,1000,1000,3000,2000,1001,1.0,0.0
62754,65578,261,261,261,783,522,262,1.0,0.0
62758,47650,189,189,189,567,378,190,1.0,0.0
6276,10865,0,90,0,105,15,16,6.0,0.0
62765,37192,147,147,147,441,294,148,1.0,0.0
6277,583995,270,6435,270,6975,540,271,23.833,0.0
62770,2614,8,8,8,24,16,9,1.0,0.0
62771,65578,261,261,261,783,522,262,1.0,0.0
62774,3328,11,11,11,33,22,12,1.0,0.0
6278,230965,0,2567,0,3067,500,501,5.134,0.0
62780,8557,32,32,32,96,64,33,1.0,0.0
62786,1528,2,8,2,12,4,3,4.0,1.0
6279,90300,159,795,159,1113,318,160,5.0,0.0
62800,2332,7,7,7,21,14,8,1.0,1.0
62801,2215,3,18,3,24,6,4,6.0,0.0
62803,37192,147,147,147,441,294,148,1.0,0.0
62807,65578,261,261,261,783,522,262,1.0,0.0
6281,851002,0,20,0,24,4,5,5.0,0.0
62816,48407,189,189,189,567,378,190,1.0,0.0
6282,42304,67,375,67,509,134,68,5.597,0.0
62823,253590,1000,1000,1000,3000,2000,1001,1.0,0.0
62825,2581,8,8,8,24,16,9,1.0,0.0
62826,51385,204,204,204,612,408,205,1.0,0.0
62827,249091,998,998,998,2994,1996,999,1.0,0.0
62828,249589,1000,1000,1000,3000,2000,1001,1.0,0.0
6283,66404,78,935,78,1091,156,79,11.987,0.0
62830,249091,998,998,998,2994,1996,999,1.0,0.0
62831,65578,261,261,261,783,522,262,1.0,0.0
62833,2361,7,7,7,21,14,8,1.0,0.0
62834,37192,147,147,147,441,294,148,1.0,0.0
62835,5818,21,21,21,63,42,22,1.0,0.0
62836,5818,21,21,21,63,42,22,1.0,0.0
62837,37781,147,147,147,441,294,148,1.0,0.0
62838,18047,69,69,69,207,138,70,1.0,0.0
62839,249589,1000,1000,1000,3000,2000,1001,1.0,0.0
6284,5597,14,56,14,84,28,15,4.0,0.0
62840,51385,204,204,204,612,408,205,1.0,0.0
62841,2614,8,8,8,24,16,9,1.0,0.0
62844,2332,7,7,7,21,14,8,1.0,0.0
62845,2614,8,8,8,24,16,9,1.0,0.0
62846,37192,147,147,147,441,294,148,1.0,0.0
62847,65578,261,261,261,783,522,262,1.0,0.0
62848,7063,26,26,26,78,52,27,1.0,0.0
62849,253590,1000,1000,1000,3000,2000,1001,1.0,0.0
6285,387526,184,5421,184,5789,368,186,29.462,0.0
62850,65578,261,261,261,783,522,262,1.0,0.0
62851,37192,147,147,147,441,294,148,1.0,0.0
62852,2614,8,8,8,24,16,9,1.0,0.0
62853,23746,93,93,93,279,186,94,1.0,0.0
62854,3079,10,10,10,30,20,11,1.0,0.0
62855,66623,261,261,261,783,522,262,1.0,0.0
62856,37192,147,147,147,441,294,148,1.0,0.0
62857,65578,261,261,261,783,522,262,1.0,0.0
62858,1602,4,4,4,12,8,5,1.0,0.0
62859,2083,6,6,6,18,12,7,1.0,0.0
6286,408633,15,105,15,135,30,16,7.0,0.0
62860,65578,261,261,261,783,522,262,1.0,0.0
62861,1834,5,5,5,15,10,6,1.0,0.0
62862,51190,200,200,200,600,400,201,1.0,0.0
62863,1542,2,9,2,13,4,3,4.5,0.0
62864,37192,147,147,147,441,294,148,1.0,0.0
62866,37781,147,147,147,441,294,148,1.0,0.0
62867,52202,204,204,204,612,408,205,1.0,0.0
62868,6138,9,72,9,90,18,10,8.0,0.0
62869,37192,147,147,147,441,294,148,1.0,0.0
62870,51190,200,200,200,600,400,201,1.0,0.0
62871,37192,147,147,147,441,294,148,1.0,0.0
62872,48646,193,193,193,579,386,194,1.0,0.0
62874,2083,6,6,6,18,12,7,1.0,0.0
62875,3079,10,10,10,30,20,11,1.0,0.0
62876,2108,6,6,6,18,12,7,1.0,0.0
62877,23746,93,93,93,279,186,94,1.0,0.0
62878,37781,147,147,147,441,294,148,1.0,0.0
6288,1085569,500,15507,500,16507,1000,501,31.014,0.0
62880,51385,204,204,204,612,408,205,1.0,0.0
62881,6145,9,72,9,90,18,10,8.0,0.0
62884,37781,147,147,147,441,294,148,1.0,0.0
62885,3577,12,12,12,36,24,13,1.0,0.0
62886,37192,147,147,147,441,294,148,1.0,0.0
62887,66623,261,261,261,783,522,262,1.0,0.0
62888,37192,147,147,147,441,294,148,1.0,0.0
62889,37192,147,147,147,441,294,148,1.0,0.0
6289,82491,149,745,149,1043,298,150,5.0,0.0
62891,66623,261,261,261,783,522,262,1.0,0.0
62892,253590,1000,1000,1000,3000,2000,1001,1.0,0.0
62894,249589,1000,1000,1000,3000,2000,1001,1.0,0.0
62895,253590,1000,1000,1000,3000,2000,1001,1.0,0.0
62896,253084,998,998,998,2994,1996,999,1.0,0.0
62897,6147,9,72,9,90,18,10,8.0,0.0
62898,17149,30,180,30,240,60,31,6.0,0.0
62899,6067,22,22,22,66,44,23,1.0,0.0
629,50575,0,420,0,560,140,141,3.0,0.0
6290,66963,79,1422,79,1580,158,80,18.0,0.0
62900,65578,261,261,261,783,522,262,1.0,0.0
62901,65578,261,261,261,783,522,262,1.0,0.0
62902,37192,147,147,147,441,294,148,1.0,0.0
62903,6114,9,72,9,90,18,10,8.0,0.5
62904,65578,261,261,261,783,522,262,1.0,0.0
62906,51385,204,204,204,612,408,205,1.0,0.0
62907,51385,204,204,204,612,408,205,1.0,0.0
62908,37781,147,147,147,441,294,148,1.0,0.0
62909,6131,9,72,9,90,18,10,8.0,0.5
62910,92221,368,368,368,1104,736,369,1.0,0.0
62911,249589,1000,1000,1000,3000,2000,1001,1.0,0.0
62912,253590,1000,1000,1000,3000,2000,1001,1.0,0.0
62913,2083,6,6,6,18,12,7,1.0,0.0
62914,249091,998,998,998,2994,1996,999,1.0,0.0
62915,65578,261,261,261,783,522,262,1.0,0.0
62916,37781,147,147,147,441,294,148,1.0,0.0
62917,249589,1000,1000,1000,3000,2000,1001,1.0,0.0
62918,37192,147,147,147,441,294,148,1.0,0.0
62919,37192,147,147,147,441,294,148,1.0,0.0
6292,410172,0,5274,0,5774,500,501,10.548,0.0
62920,37781,147,147,147,441,294,148,1.0,0.0
62921,253084,998,998,998,2994,1996,999,1.0,0.0
62922,37781,147,147,147,441,294,148,1.0,0.0
62923,65578,261,261,261,783,522,262,1.0,0.0
62924,253590,1000,1000,1000,3000,2000,1001,1.0,0.0
62925,249589,1000,1000,1000,3000,2000,1001,1.0,0.0
62926,65578,261,261,261,783,522,262,1.0,0.0
62927,65578,261,261,261,783,522,262,1.0,0.0
62929,37192,147,147,147,441,294,148,1.0,0.0
6293,12122,25,125,25,175,50,26,5.0,0.0
62931,4638,16,16,16,48,32,17,1.0,0.0
62932,23746,93,93,93,279,186,94,1.0,0.0
62933,249091,998,998,998,2994,1996,999,1.0,0.0
62934,37192,147,147,147,441,294,148,1.0,0.0
62935,66623,261,261,261,783,522,262,1.0,0.0
62936,37192,147,147,147,441,294,148,1.0,0.0
62938,65578,261,261,261,783,522,262,1.0,0.0
6294,413730,500,8500,500,9500,1000,501,17.0,0.0
62940,65578,261,261,261,783,522,262,1.0,0.0
62942,37192,147,147,147,441,294,148,1.0,0.0
62943,65578,261,261,261,783,522,262,1.0,0.0
62945,1495,2,8,2,12,4,3,4.0,0.0
62946,37192,147,147,147,441,294,148,1.0,0.0
62947,37192,147,147,147,441,294,148,1.0,0.0
62948,51190,200,200,200,600,400,201,1.0,0.0
62949,37781,147,147,147,441,294,148,1.0,0.0
6295,5085,0,48,0,60,12,13,4.0,0.0
62950,37781,147,147,147,441,294,148,1.0,0.0
62951,65578,261,261,261,783,522,262,1.0,0.0
62952,2581,8,8,8,24,16,9,1.0,0.0
62953,37192,147,147,147,441,294,148,1.0,0.0
62955,249589,1000,1000,1000,3000,2000,1001,1.0,0.0
62956,2614,8,8,8,24,16,9,1.0,0.0
62957,37192,147,147,147,441,294,148,1.0,0.0
62958,24119,93,93,93,279,186,94,1.0,0.0
6296,322745,0,5565,0,6065,500,501,11.13,0.0
62960,253084,998,998,998,2994,1996,999,1.0,0.0
62961,1336,3,3,3,9,6,4,1.0,0.0
62964,253084,998,998,998,2994,1996,999,1.0,0.0
62965,23746,93,93,93,279,186,94,1.0,0.0
62967,65578,261,261,261,783,522,262,1.0,0.0
62968,37192,147,147,147,441,294,148,1.0,0.0
62969,37192,147,147,147,441,294,148,1.0,0.0
6297,297065,49,4188,49,4286,98,50,85.469,0.0
62970,37192,147,147,147,441,294,148,1.0,0.0
62971,65578,261,261,261,783,522,262,1.0,0.0
62972,63081,247,247,247,741,494,248,1.0,0.0
62973,66623,261,261,261,783,522,262,1.0,0.0
62974,249091,998,998,998,2994,1996,999,1.0,0.0
62976,65578,261,261,261,783,522,262,1.0,0.0
62977,37192,147,147,147,441,294,148,1.0,0.0
62978,52202,204,204,204,612,408,205,1.0,0.0
62979,34453,136,136,136,408,272,137,1.0,0.0
6298,736521,79,9717,79,9875,158,80,123.0,0.5
62980,63081,247,247,247,741,494,248,1.0,0.0
62981,66623,261,261,261,783,522,262,1.0,0.0
62982,2399,5,15,5,25,10,6,3.0,0.0
62983,51385,204,204,204,612,408,205,1.0,0.0
62984,249589,1000,1000,1000,3000,2000,1001,1.0,0.0
62985,249589,1000,1000,1000,3000,2000,1001,1.0,0.0
62986,253590,1000,1000,1000,3000,2000,1001,1.0,1.0
62987,253590,1000,1000,1000,3000,2000,1001,1.0,0.0
62989,249589,1000,1000,1000,3000,2000,1001,1.0,0.0
62990,66623,261,261,261,783,522,262,1.0,0.0
62992,37192,147,147,147,441,294,148,1.0,0.0
62994,37192,147,147,147,441,294,148,1.0,0.0
62996,1488,2,8,2,12,4,3,4.0,0.0
63,210779,936,2056,936,3690,1634,940,2.908,0.0
6300,2034963,500,3396,500,4396,1000,501,6.792,0.0
63004,37192,147,147,147,441,294,148,1.0,0.0
63008,37781,147,147,147,441,294,148,1.0,0.0
63009,253084,998,998,998,2994,1996,999,1.0,0.0
6301,22341,0,240,0,288,48,49,5.0,0.0
63011,65578,261,261,261,783,522,262,1.0,0.0
63012,37192,147,147,147,441,294,148,1.0,0.0
63015,51190,200,200,200,600,400,201,1.0,0.0
63017,31709,123,123,123,369,246,124,1.0,0.0
63018,37192,147,147,147,441,294,148,1.0,0.0
63022,47650,189,189,189,567,378,190,1.0,0.0
63026,249091,998,998,998,2994,1996,999,1.0,0.0
63027,249091,998,998,998,2994,1996,999,1.0,0.0
6303,48588,66,594,66,726,132,67,9.0,0.0
63030,47650,189,189,189,567,378,190,1.0,0.0
63034,253590,1000,1000,1000,3000,2000,1001,1.0,1.0
63035,249589,1000,1000,1000,3000,2000,1001,1.0,0.0
63036,249091,998,998,998,2994,1996,999,1.0,0.0
63037,249589,1000,1000,1000,3000,2000,1001,1.0,0.0
63038,37781,147,147,147,441,294,148,1.0,0.0
6304,719791,0,11192,0,11692,500,501,22.384,0.0
63041,249589,1000,1000,1000,3000,2000,1001,1.0,1.0
63042,37192,147,147,147,441,294,148,1.0,0.0
63043,37781,147,147,147,441,294,148,1.0,0.0
63045,14284,55,55,55,165,110,56,1.0,0.0
63046,249091,998,998,998,2994,1996,999,1.0,0.0
63047,37192,147,147,147,441,294,148,1.0,0.0
63048,1736,2,12,2,16,4,3,6.0,0.0
6305,65990,79,1417,79,1575,158,80,17.937,0.0
63052,37192,147,147,147,441,294,148,1.0,0.0
63054,37192,147,147,147,441,294,148,1.0,0.0
63055,253590,1000,1000,1000,3000,2000,1001,1.0,0.0
63058,2108,6,6,6,18,12,7,1.0,0.0
63060,2332,7,7,7,21,14,8,1.0,0.0
63063,249589,1000,1000,1000,3000,2000,1001,1.0,0.0
63064,249589,1000,1000,1000,3000,2000,1001,1.0,0.0
63065,2581,8,8,8,24,16,9,1.0,0.0
63066,65578,261,261,261,783,522,262,1.0,0.0
63067,249589,1000,1000,1000,3000,2000,1001,1.0,0.0
6307,57336,0,1200,0,1280,80,81,15.0,0.0
63071,253084,998,998,998,2994,1996,999,1.0,0.0
63072,37192,147,147,147,441,294,148,1.0,0.0
63074,249589,1000,1000,1000,3000,2000,1001,1.0,0.0
63075,249091,998,998,998,2994,1996,999,1.0,0.0
63076,37192,147,147,147,441,294,148,1.0,0.0
63078,37781,147,147,147,441,294,148,1.0,0.0
63080,37781,147,147,147,441,294,148,1.0,0.0
63081,37192,147,147,147,441,294,148,1.0,0.0
63084,2581,8,8,8,24,16,9,1.0,0.0
63087,249091,998,998,998,2994,1996,999,1.0,0.0
63090,249589,1000,1000,1000,3000,2000,1001,1.0,0.0
63097,37192,147,147,147,441,294,148,1.0,0.0
63099,65578,261,261,261,783,522,262,1.0,0.0
6310,85788,0,1099,0,1256,157,158,7.0,0.0
63106,654930,1000,7983,1000,9983,2000,1001,7.983,0.0
63109,65578,261,261,261,783,522,262,1.0,0.0
6311,193011,0,3695,0,3926,231,232,15.996,0.75
63110,37192,147,147,147,441,294,148,1.0,0.0
63111,37781,147,147,147,441,294,148,1.0,0.0
63112,249589,1000,1000,1000,3000,2000,1001,1.0,0.0
63113,65578,261,261,261,783,522,262,1.0,0.0
63114,42082,164,164,164,492,328,165,1.0,0.0
63115,50389,200,200,200,600,400,201,1.0,0.0
63116,249589,1000,1000,1000,3000,2000,1001,1.0,0.0
63117,65578,261,261,261,783,522,262,1.0,0.0
63119,249589,1000,1000,1000,3000,2000,1001,1.0,0.0
6312,379409,0,7000,0,7500,500,501,14.0,0.0
63121,65578,261,261,261,783,522,262,1.0,0.0
63122,66623,261,261,261,783,522,262,1.0,0.0
63123,249589,1000,1000,1000,3000,2000,1001,1.0,0.0
63124,65578,261,261,261,783,522,262,1.0,0.0
63125,66623,261,261,261,783,522,262,1.0,0.0
63126,66623,261,261,261,783,522,262,1.0,0.0
63127,65578,261,261,261,783,522,262,1.0,0.0
63128,65578,261,261,261,783,522,262,1.0,0.0
63129,65578,261,261,261,783,522,262,1.0,0.0
6313,217979,0,3500,0,4000,500,501,7.0,0.0
63130,65578,261,261,261,783,522,262,1.0,0.0
63131,253590,1000,1000,1000,3000,2000,1001,1.0,0.0
63132,253590,1000,1000,1000,3000,2000,1001,1.0,0.0
63133,65578,261,261,261,783,522,262,1.0,0.0
63134,65578,261,261,261,783,522,262,1.0,0.0
63135,66623,261,261,261,783,522,262,1.0,0.0
63136,66623,261,261,261,783,522,262,1.0,0.0
63137,37192,147,147,147,441,294,148,1.0,0.0
63138,66623,261,261,261,783,522,262,1.0,0.0
63139,1696,3,9,3,15,6,4,3.0,0.0
6314,57171,93,927,93,1113,186,94,9.968,0.0
63142,8273,18,72,18,108,36,19,4.0,0.75
63143,344362,0,4958,0,5708,750,751,6.611,0.0
6315,841352,500,13984,500,14984,1000,501,27.968,0.0
63150,1967498,242,17904,242,18388,484,243,73.983,1.0
63151,246967,242,3388,242,3872,484,243,14.0,0.0
63154,722368,1000,14000,1000,16000,2000,1001,14.0,0.0
63155,67212,87,1566,87,1740,174,88,18.0,0.0
6316,480885,0,7000,0,7500,500,501,14.0,0.0
63161,71825,132,1100,132,1364,264,133,8.333,0.0
63162,717334,243,10206,243,10692,486,244,42.0,0.0
63166,63186,107,856,107,1070,214,108,8.0,0.0
6317,155803,251,1506,251,2008,502,252,6.0,1.0
63171,614424,0,4467,0,4556,89,90,50.191,0.0
63172,221239,214,2140,214,2568,428,215,10.0,0.0
63174,77465,241,723,241,1205,482,242,3.0,0.0
63176,4612,8,32,8,48,16,9,4.0,0.0
63178,4251,8,54,8,70,16,9,6.75,0.0
6318,53046,0,415,0,498,83,84,5.0,0.0
63180,620847,106,7624,106,7836,212,107,71.925,0.0
63182,190436,242,4585,242,5069,484,243,18.946,0.0
63184,909263,0,8056,0,8206,150,151,53.707,0.0
63186,4284,8,54,8,70,16,9,6.75,0.0
63189,145262,243,1940,243,2426,486,244,7.984,0.0
63192,5768,0,77,0,88,11,12,7.0,0.0
63193,74935,85,802,85,972,170,86,9.435,0.0
63195,333230,72,4518,72,4662,144,73,62.75,0.0
63196,313594,241,4750,241,5232,482,242,19.71,0.0
63197,61357,116,919,116,1151,232,117,7.922,0.0
63198,27757,110,110,110,330,220,111,1.0,0.0
6320,927516,0,19492,0,19992,500,501,38.984,0.0
63205,247587,1000,1000,1000,3000,2000,1001,1.0,0.0
63207,251588,1000,1000,1000,3000,2000,1001,1.0,0.0
6321,469239,500,10000,500,11000,1000,501,20.0,0.0
63217,142415,168,2461,168,2797,336,169,14.649,0.0
63218,5973286,0,176000,0,177000,1000,1001,176.0,0.0
63219,671621,0,14000,0,15000,1000,1001,14.0,0.0
6322,109983,307,921,307,1535,614,308,3.0,1.0
63220,281621,1000,1000,1000,3000,2000,1001,1.0,0.0
63221,244810,869,869,869,2607,1738,870,1.0,0.0
63222,1709796,0,54000,0,55000,1000,1001,54.0,0.0
63223,1160508,869,17354,869,19961,2607,1740,9.985,1.0
63224,671619,0,14000,0,15000,1000,1001,14.0,0.0
63226,219052,195,3775,195,4360,585,392,9.679,0.0
63227,2052196,1000,39796,1000,42796,3000,2002,19.898,0.0
6323,159372,229,1877,229,2335,458,230,8.197,0.5
63230,495086,268,8837,268,9641,804,538,16.487,1.0
63231,671619,0,14000,0,15000,1000,1001,14.0,0.0
63232,12690531,1000,383000,1000,385000,2000,1001,383.0,0.0
63233,792805,2000,11295,2000,15295,4000,2002,5.647,0.5
63235,44639,96,720,96,912,192,98,7.5,0.0
63236,3286448,2000,58563,2000,62563,4000,2002,29.282,0.0
63237,1162430,0,21951,0,22951,1000,1001,21.951,0.0
63240,831489,2000,10978,2000,14978,4000,2002,5.489,0.75
63241,1713729,0,54000,0,55000,1000,1001,54.0,0.0
63242,50601,128,685,128,941,256,130,5.352,0.5
63243,728978,1000,9000,1000,12000,3000,2002,4.5,1.0
63244,63234,164,922,164,1250,328,166,5.622,0.0
63245,449483,1026,6145,1026,8197,2052,1028,5.989,1.0
63246,10761,20,160,20,200,40,22,8.0,0.0
63247,37875,82,492,82,656,164,83,6.0,0.0
63248,1136012,2000,16402,2000,20402,4000,2002,8.201,0.75
63249,136820,366,2074,366,2806,732,368,5.667,0.5
63250,673604,0,14000,0,15000,1000,1001,14.0,0.0
63251,1713082,0,54000,0,55000,1000,1001,54.0,0.0
63253,137899,258,2322,258,2838,516,260,9.0,0.0
63254,1073980,1000,20685,1000,22685,2000,1001,20.685,1.0
63257,671621,0,14000,0,15000,1000,1001,14.0,0.0
63258,1079759,2000,16689,2000,20689,4000,2002,8.345,0.5
6326,287208,500,3000,500,4000,1000,501,6.0,0.0
63261,143100,268,2308,268,2844,536,270,8.612,0.0
63263,23209970,1000,177000,1000,179000,2000,1001,177.0,0.0
63264,2052196,1000,39796,1000,42796,3000,2002,19.898,0.0
63265,375285,810,6075,810,7695,1620,812,7.5,0.0
63266,2410221,1000,41024,1000,43024,2000,1001,41.024,0.0
63267,1371573,1000,11793,1000,13793,2000,1001,11.793,0.5
63271,177168,247,3811,247,4305,494,248,15.429,0.0
63272,3852533,1000,17000,1000,20000,3000,1002,17.0,0.0
63273,257599,0,1000,0,2000,1000,1001,1.0,0.0
63274,4003496,1000,50000,1000,52000,2000,1001,50.0,0.0
63275,19085,11,165,11,187,22,12,15.0,0.0
63276,3493,11,11,11,33,22,12,1.0,0.0
63277,65185,30,311,30,371,60,31,10.367,0.0
63278,2855,1,6,1,8,2,2,6.0,0.0
63279,204419,48,479,48,575,96,49,9.979,0.0
6328,1760,1,8,1,10,2,2,8.0,0.0
63281,182782,1,12,1,14,2,2,12.0,0.0
63283,2354246,1000,34295,1000,37295,3000,2002,17.148,0.5
63286,104222,394,394,394,1182,788,395,1.0,0.0
63287,723554,1000,9838,1000,11838,2000,1001,9.838,0.0
63288,104458,401,401,401,1203,802,402,1.0,0.0
6329,329580,500,4000,500,5000,1000,501,8.0,0.5
63291,378755,401,5614,401,6817,1203,804,7.0,0.0
63292,263600,1000,1000,1000,3000,2000,1001,1.0,0.5
63294,5533,7,53,7,67,14,8,7.571,0.0
63296,374142,394,5122,394,6304,1182,790,6.5,0.0
63298,3508,7,28,7,42,14,8,4.0,0.0
63299,3056,3,45,3,51,6,4,15.0,0.0
63301,11605,21,147,21,189,42,22,7.0,0.0
63302,550288,0,8047,0,9047,1000,1001,8.047,0.0
63303,1997,2,26,2,30,4,3,13.0,0.0
63304,805520,0,13665,0,14665,1000,1001,13.665,0.0
63305,27051,28,224,28,280,56,29,8.0,0.0
63306,7538,12,108,12,132,24,13,9.0,0.0
63307,813473,1000,13794,1000,15794,2000,1001,13.794,0.0
63308,1304,1,14,1,16,2,2,14.0,0.0
63309,485294,0,5000,0,6000,1000,1001,5.0,0.0
63310,263600,1000,1000,1000,3000,2000,1001,1.0,0.0
63311,466913,0,5496,0,6183,687,688,8.0,0.0
63312,6208,0,60,0,70,10,11,6.0,0.0
63313,1389,3,3,3,9,6,4,1.0,0.0
63315,259599,1000,1000,1000,3000,2000,1001,1.0,0.5
63316,2849,0,20,0,25,5,6,4.0,0.0
63317,1692,2,20,2,24,4,3,10.0,0.0
63318,939492,1000,13000,1000,15000,2000,1001,13.0,0.0
63319,7473,4,112,4,120,8,5,28.0,0.0
6332,1462896,500,15723,500,16723,1000,501,31.446,0.0
63320,259599,1000,1000,1000,3000,2000,1001,1.0,0.0
63321,5119,0,66,0,72,6,7,11.0,0.0
63322,259599,1000,1000,1000,3000,2000,1001,1.0,0.0
63323,2832,7,21,7,35,14,8,3.0,0.0
63324,5543,0,72,0,78,6,7,12.0,0.0
63325,2006,2,26,2,30,4,3,13.0,0.0
63326,2276,0,15,0,20,5,6,3.0,0.0
63327,8977,13,100,13,126,26,14,7.692,0.0
63328,3966,13,13,13,39,26,14,1.0,0.0
63329,16645,0,187,0,204,17,18,11.0,0.5
6333,1461295,500,15509,500,16509,1000,501,31.018,0.0
63330,5297,7,53,7,67,14,8,7.571,0.0
63331,1220,0,10,0,11,1,2,10.0,0.0
63332,1077,1,8,1,10,2,2,8.0,0.0
63333,555018,1000,8003,1000,10003,2000,1001,8.003,0.0
63334,1635,4,4,4,12,8,5,1.0,0.0
63335,1330,1,15,1,17,2,2,15.0,0.0
63336,31577,0,572,0,624,52,53,11.0,0.0
63338,2157,3,30,3,36,6,4,10.0,0.0
6334,1538404,27,351,27,405,54,28,13.0,0.0
63340,21799,0,254,0,305,51,52,4.98,0.5
63341,263600,1000,1000,1000,3000,2000,1001,1.0,0.0
63342,258966,439,3073,439,3951,878,440,7.0,0.0
63343,3897,4,60,4,68,8,5,15.0,0.0
63346,487310,230,6765,230,7225,460,231,29.413,0.0
63347,4019,13,13,13,39,26,14,1.0,0.0
63350,6099,0,55,0,60,5,6,11.0,0.0
63351,29439,65,390,65,520,130,66,6.0,0.0
63352,4522,0,30,0,43,13,14,2.308,0.0
63354,2835,0,20,0,25,5,6,4.0,0.0
63355,1928,4,12,4,20,8,5,3.0,0.0
63357,1863,4,12,4,20,8,5,3.0,0.0
63358,1207,1,12,1,14,2,2,12.0,0.0
63359,1688,0,20,0,22,2,3,10.0,0.0
6336,514329,500,8472,500,9472,1000,501,16.944,0.0
63361,8064,13,117,13,143,26,14,9.0,0.0
63362,259599,1000,1000,1000,3000,2000,1001,1.0,0.0
63363,259599,1000,1000,1000,3000,2000,1001,1.0,0.0
63364,162156,152,2432,152,2736,304,153,16.0,0.0
63365,4296,10,30,10,50,20,11,3.0,0.0
63366,3235,0,20,0,24,4,5,5.0,0.0
63367,581296,804,8840,804,10448,1608,805,10.995,0.0
63369,2606437,1000,50387,1000,52387,2000,1001,50.387,0.0
6337,1542807,26,338,26,390,52,27,13.0,0.0
63370,32709,26,464,26,516,52,28,17.846,0.0
63371,1417,2,8,2,12,4,3,4.0,0.0
63374,9519,21,122,21,164,42,22,5.81,0.0
63375,4296,10,30,10,50,20,11,3.0,0.0
63376,1615,3,9,3,15,6,4,3.0,0.0
63377,813701,0,13875,0,14875,1000,1001,13.875,0.0
63379,4214,0,45,0,50,5,6,9.0,0.0
6338,723233,8,71,8,87,16,9,8.875,0.0
63381,1299,1,14,1,16,2,2,14.0,0.0
63383,399135,1000,4713,1000,6713,2000,1001,4.713,0.5
63384,5533,7,53,7,67,14,8,7.571,0.0
63387,1117,2,2,2,6,4,3,1.0,0.0
63388,5700,13,57,13,83,26,14,4.385,0.0
63389,6234,0,55,0,60,5,6,11.0,0.0
63390,993,1,5,1,7,2,2,5.0,0.5
63393,4854,9,61,9,79,18,10,6.778,0.0
63394,883985,1916,11412,1916,15244,3832,1918,5.956,0.0
63395,259599,1000,1000,1000,3000,2000,1001,1.0,0.0
63396,2075,0,18,0,22,4,5,4.5,0.0
63398,390974,0,4473,0,5473,1000,1001,4.473,0.5
63399,9337,16,128,16,160,32,17,8.0,0.0
6340,965198,500,20698,500,21698,1000,501,41.396,0.0
63400,263600,1000,1000,1000,3000,2000,1001,1.0,0.0
63402,2671,8,8,8,24,16,9,1.0,0.0
63404,251311,968,968,968,2904,1936,969,1.0,0.0
63405,4200,8,32,8,48,16,9,4.0,0.0
63406,259599,1000,1000,1000,3000,2000,1001,1.0,0.0
63407,1034785,0,13374,0,14374,1000,1001,13.374,0.0
63408,2704,8,8,8,24,16,9,1.0,0.0
63409,3959,8,48,8,64,16,9,6.0,0.0
6341,125329,117,1980,117,2214,234,118,16.923,0.0
63410,2412,7,7,7,21,14,8,1.0,0.0
63411,259599,1000,1000,1000,3000,2000,1001,1.0,0.0
63412,312715,0,2000,0,3000,1000,1001,2.0,0.5
63419,1032284,1000,14843,1000,16843,2000,1001,14.843,0.0
6342,875201,500,19922,500,20922,1000,501,39.844,0.0
63421,1335,1,15,1,17,2,2,15.0,0.0
63422,8064,13,117,13,143,26,14,9.0,0.0
63423,1031498,0,12867,0,13704,837,838,15.373,0.0
63424,780795,0,15999,0,16999,1000,1001,15.999,0.0
63425,1694,2,20,2,24,4,3,10.0,0.0
63426,1013248,0,13072,0,14072,1000,1001,13.072,0.0
63428,259599,1000,1000,1000,3000,2000,1001,1.0,0.0
63429,1635,2,19,2,23,4,3,9.5,0.0
6343,4334,5,55,5,65,10,6,11.0,0.0
63430,5719,13,66,13,92,26,14,5.077,0.0
63432,400162,0,4724,0,5724,1000,1001,4.724,0.5
63437,485838,968,4840,968,6776,1936,969,5.0,0.0
63439,20046,0,269,0,303,34,35,7.912,0.0
6344,786703,500,10283,500,11283,1000,501,20.566,0.0
63440,235512,907,907,907,2721,1814,908,1.0,0.0
63441,259599,1000,1000,1000,3000,2000,1001,1.0,0.5
63443,5717,0,78,0,84,6,7,13.0,0.0
63444,892926,652,12885,652,14841,1956,1305,19.762,0.0
63446,2832,7,21,7,35,14,8,3.0,0.0
63447,367008,1000,2987,1000,4987,2000,1001,2.987,0.0
63449,259599,1000,1000,1000,3000,2000,1001,1.0,0.0
63450,879389,1000,17997,1000,19997,2000,1001,17.997,0.0
63451,242499,0,4143,0,4441,298,299,13.903,0.0
63453,4646,11,55,11,77,22,12,5.0,0.0
63454,955306,0,13138,0,13975,837,838,15.697,0.0
63455,4875,9,72,9,90,18,10,8.0,0.0
63456,1117,2,2,2,6,4,3,1.0,0.0
63457,2153,6,6,6,18,12,7,1.0,0.0
63458,12430,15,180,15,210,30,16,12.0,0.0
63459,5403,9,74,9,92,18,10,8.222,0.0
6346,372451,79,474,79,632,158,80,6.0,0.0
63460,259599,1000,1000,1000,3000,2000,1001,1.0,0.0
63461,889741,1950,11650,1950,15550,3900,1952,5.974,0.0
63462,19418,0,248,0,282,34,35,7.294,0.0
63463,3215,6,24,6,36,12,7,4.0,0.0
63467,1481,2,8,2,12,4,3,4.0,0.5
63468,1164441,0,16471,0,17471,1000,1001,16.471,0.0
63469,1122778,0,15416,0,16416,1000,1001,15.416,0.0
6347,1019407,500,20177,500,21177,1000,501,40.354,0.0
63470,4743,16,16,16,48,32,17,1.0,0.0
63471,40852,29,696,29,754,58,30,24.0,0.0
63473,2308,5,15,5,25,10,6,3.0,0.0
63474,8887,32,32,32,96,64,33,1.0,0.0
63475,391900,1000,5000,1000,7000,2000,1001,5.0,0.0
63477,1042176,0,16472,0,17472,1000,1001,16.472,0.0
63478,9315,0,210,0,224,14,15,15.0,0.0
63479,14331,0,176,0,202,26,27,6.769,0.0
6348,223434,500,2475,500,3475,1000,501,4.95,0.0
63480,4817,9,61,9,79,18,10,6.778,0.0
63481,7482,8,91,8,107,16,9,11.375,0.0
63482,983,1,5,1,7,2,2,5.0,0.0
63486,2760,6,18,6,30,12,7,3.0,0.0
63487,1163116,0,16416,0,17416,1000,1001,16.416,0.0
63488,3528,0,42,0,49,7,8,6.0,0.0
63489,7451,8,91,8,107,16,9,11.375,0.0
6349,55693,0,538,0,678,140,141,7.686,0.0
63493,23391,88,88,88,264,176,89,1.0,0.0
63494,38588,88,440,88,616,176,89,5.0,0.0
63497,2671,8,8,8,24,16,9,1.0,0.0
63499,3622,6,42,6,54,12,7,7.0,0.0
6350,1369851,500,38700,500,39700,1000,501,77.4,0.0
63500,17434,65,65,65,195,130,66,1.0,0.0
63502,259599,1000,1000,1000,3000,2000,1001,1.0,0.0
63504,1154146,0,16403,0,17403,1000,1001,16.403,0.0
63507,2671,8,8,8,24,16,9,1.0,0.0
6351,200775,500,2500,500,3500,1000,501,5.0,0.5
63510,1161946,0,16415,0,17415,1000,1001,16.415,0.0
63511,40576,152,152,152,456,304,153,1.0,0.0
63512,856330,0,11932,0,12751,819,820,14.569,0.0
63513,1154028,0,16287,0,17287,1000,1001,16.287,0.0
63522,257599,0,1000,0,2000,1000,1001,1.0,0.0
63523,635939,1000,8000,1000,10000,2000,1001,8.0,0.0
63528,1160932,0,16395,0,17395,1000,1001,16.395,0.0
6353,1201380,147,1028,147,1322,294,148,6.993,0.0
63531,627794,1000,7406,1000,9406,2000,1001,7.406,0.0
63532,36790,26,624,26,676,52,27,24.0,0.0
63533,4527,0,31,0,43,12,13,2.583,0.0
63535,8887,32,32,32,96,64,33,1.0,0.0
63536,6845,15,85,15,115,30,16,5.667,0.0
63538,1376,3,3,3,9,6,4,1.0,0.0
63540,38220,27,648,27,702,54,28,24.0,0.0
63542,1162791,0,16400,0,17400,1000,1001,16.4,0.0
63543,30416,24,480,24,528,48,25,20.0,0.0
63544,4523,0,29,0,42,13,14,2.231,0.0
63545,36717,26,624,26,676,52,27,24.0,0.0
63547,259599,1000,1000,1000,3000,2000,1001,1.0,0.0
63549,263600,1000,1000,1000,3000,2000,1001,1.0,0.0
63550,13132,28,168,28,224,56,29,6.0,0.0
63551,643194,700,7485,700,9771,2286,1437,10.693,0.5
63552,259599,1000,1000,1000,3000,2000,1001,1.0,0.0
63553,1025051,0,13577,0,14577,1000,1001,13.577,0.0
63554,32786,25,525,25,575,50,26,21.0,0.0
63556,2671,8,8,8,24,16,9,1.0,0.0
63557,1126,2,2,2,6,4,3,1.0,0.0
63558,4645,0,36,0,49,13,14,2.769,0.0
63559,1203156,0,16296,0,17296,1000,1001,16.296,0.0
63565,263600,1000,1000,1000,3000,2000,1001,1.0,0.0
63566,255455,984,984,984,2952,1968,985,1.0,0.0
63567,1617,3,9,3,15,6,4,3.0,0.0
63568,257599,0,1000,0,2000,1000,1001,1.0,0.0
63569,8110,29,29,29,87,58,30,1.0,0.0
6357,2168676,500,3500,500,4500,1000,501,7.0,0.0
63574,263600,1000,1000,1000,3000,2000,1001,1.0,0.0
63579,1126,2,2,2,6,4,3,1.0,0.0
63582,2412,7,7,7,21,14,8,1.0,0.0
63583,474546,1000,6000,1000,8000,2000,1001,6.0,0.0
63584,2153,6,6,6,18,12,7,1.0,0.0
63586,2178,6,6,6,18,12,7,1.0,0.0
63587,1915,5,5,5,15,10,6,1.0,0.0
63588,2753,5,20,5,30,10,6,4.0,0.0
63589,4385,0,27,0,40,13,14,2.077,0.0
6359,858855,500,12665,500,13665,1000,501,25.33,0.0
63591,184700,700,700,700,2100,1400,701,1.0,0.0
63595,259599,1000,1000,1000,3000,2000,1001,1.0,0.0
63596,329401,0,5588,0,6002,414,415,13.498,0.0
63597,7446,8,91,8,107,16,9,11.375,0.0
63598,2386,5,15,5,25,10,6,3.0,0.0
63599,1085165,1000,15558,1000,17558,2000,1001,15.558,0.0
6360,2079342,500,52985,500,53985,1000,501,105.97,0.0
63602,1552483,0,25993,0,26993,1000,1001,25.993,0.0
63603,797007,0,10961,0,11961,1000,1001,10.961,0.0
63604,803426,0,10705,0,11705,1000,1001,10.705,0.0
63605,201422,741,741,741,2223,1482,742,1.0,0.0
63606,271611,1000,1000,1000,3000,2000,1001,1.0,0.0
63609,1110783,741,17463,741,18945,1482,742,23.567,0.0
6361,67130,1,6,1,8,2,2,6.0,0.0
63611,44513,162,162,162,486,324,163,1.0,0.0
63612,360152,600,4800,600,6000,1200,601,8.0,0.0
63614,18848,37,185,37,259,74,38,5.0,0.0
63615,31812,62,310,62,434,124,63,5.0,0.0
63617,1092132,1000,14999,1000,16999,2000,1001,14.999,0.0
63619,788232,1000,12324,1000,14324,2000,1001,12.324,0.0
6362,961545,500,32319,500,33319,1000,501,64.638,0.0
63620,1218628,1000,19000,1000,21000,2000,1001,19.0,0.0
63622,8267,0,126,0,135,9,10,14.0,0.0
63623,12547,21,189,21,231,42,22,9.0,0.0
63626,42579,0,542,0,620,78,79,6.949,0.0
63627,891572,0,16391,0,17391,1000,1001,16.391,0.0
6363,629228,500,3484,500,4484,1000,501,6.968,0.0
63633,2472514,1000,38964,1000,40964,2000,1001,38.964,0.0
63636,453020,1000,4436,1000,6436,2000,1001,4.436,0.0
63639,18456,33,231,33,297,66,34,7.0,0.0
6364,384617,500,7239,500,8239,1000,501,14.478,0.0
63643,477164,0,5000,0,6000,1000,1001,5.0,0.0
63647,773847,1000,12000,1000,14000,2000,1001,12.0,0.0
63648,14952,11,176,11,198,22,12,16.0,0.0
6365,49026,40,880,40,960,80,41,22.0,0.0
63650,481829,1000,6000,1000,8000,2000,1001,6.0,0.0
63651,398537,648,3726,648,5022,1296,649,5.75,0.0
63657,171264,0,2138,0,2444,306,307,6.987,0.0
63659,1334854,1000,24000,1000,26000,2000,1001,24.0,0.0
6366,4266,6,30,6,42,12,7,5.0,0.0
63661,2119416,1000,38000,1000,40000,2000,1001,38.0,0.0
63667,60994,0,583,0,726,143,144,4.077,0.0
63668,4123,10,30,10,50,20,11,3.0,0.0
6367,526262,500,16025,500,17025,1000,501,32.05,0.0
63672,253593,1000,1000,1000,3000,2000,1001,1.0,0.0
63673,898748,1000,13628,1000,15628,2000,1001,13.628,0.0
63675,509423,610,8433,610,9653,1220,611,13.825,0.0
63676,4213,10,30,10,50,20,11,3.0,0.0
63677,4716,0,36,0,48,12,13,3.0,0.0
63680,4055,0,30,0,40,10,11,3.0,0.0
63687,5906,21,21,21,63,42,22,1.0,0.0
63688,723207,1000,10998,1000,12998,2000,1001,10.998,0.0
63689,4234,10,30,10,50,20,11,3.0,0.0
63690,251593,0,1000,0,2000,1000,1001,1.0,0.0
63691,2907,9,9,9,27,18,10,1.0,0.0
63692,251593,0,1000,0,2000,1000,1001,1.0,0.0
63693,977602,1000,13762,1000,15762,2000,1001,13.762,0.0
63694,4113,10,30,10,50,20,11,3.0,0.0
63695,8943,0,33,0,66,33,34,1.0,0.0
63696,251593,0,1000,0,2000,1000,1001,1.0,0.0
63699,251593,0,1000,0,2000,1000,1001,1.0,0.0
63700,1975,3,18,3,24,6,4,6.0,0.0
63701,628943,1000,9000,1000,11000,2000,1001,9.0,0.0
63703,242360,249,3436,249,3934,498,250,13.799,0.0
63704,159230,75,1546,75,1771,225,151,20.613,0.0
63705,36486,0,143,0,286,143,144,1.0,0.0
63706,251593,0,1000,0,2000,1000,1001,1.0,0.0
63707,251593,0,1000,0,2000,1000,1001,1.0,0.0
63712,2907,9,9,9,27,18,10,1.0,0.0
63713,2870,9,9,9,27,18,10,1.0,0.0
63716,251593,0,1000,0,2000,1000,1001,1.0,0.0
63717,104054,262,1046,262,1570,524,263,3.992,0.0
63718,5321,12,48,12,72,24,13,4.0,0.0
63722,3123,10,10,10,30,20,11,1.0,0.0
63723,36574,140,140,140,420,280,141,1.0,0.0
63724,3354,0,11,0,22,11,12,1.0,0.0
63726,253593,1000,1000,1000,3000,2000,1001,1.0,0.0
63727,253593,1000,1000,1000,3000,2000,1001,1.0,0.0
63742,253593,1000,1000,1000,3000,2000,1001,1.0,0.0
63745,2907,9,9,9,27,18,10,1.0,0.0
63747,6248,22,22,22,66,44,23,1.0,0.0
63749,846,1,1,1,3,2,2,1.0,0.0
63750,3103,0,10,0,20,10,11,1.0,0.0
63751,1095,0,2,0,4,2,3,1.0,0.0
63752,251593,0,1000,0,2000,1000,1001,1.0,0.0
63753,716520,465,11625,465,12555,930,466,25.0,0.0
63754,2870,9,9,9,27,18,10,1.0,0.0
63755,3151,7,28,7,42,14,8,4.0,0.0
63756,253593,1000,1000,1000,3000,2000,1001,1.0,0.0
63757,253593,1000,1000,1000,3000,2000,1001,1.0,0.0
63758,36486,0,143,0,286,143,144,1.0,0.0
63759,3103,0,10,0,20,10,11,1.0,0.0
63760,253593,1000,1000,1000,3000,2000,1001,1.0,0.0
63762,251588,1000,1000,1000,3000,2000,1001,1.0,0.0
63763,1707043,1914,27066,1914,30894,3828,1916,14.141,0.0
63765,3081516,1000,58752,1000,60752,2000,1001,58.752,0.0
63768,939079,1000,15861,1000,17861,2000,1001,15.861,0.0
63770,657852,1000,9000,1000,11000,2000,1001,9.0,0.0
63777,2573893,926,46744,926,48596,1852,927,50.479,0.0
63791,740336,0,9098,0,10108,1010,1002,9.098,0.5
63793,976133,1000,16523,1000,18523,2000,1001,16.523,0.0
63794,970672,0,18933,0,19933,1000,1001,18.933,1.0
63796,247587,1000,1000,1000,3000,2000,1001,1.0,0.0
63799,369923,1000,4000,1000,6000,2000,1001,4.0,0.0
63812,79651,200,800,200,1200,400,201,4.0,0.0
63815,65127,104,709,104,917,208,105,6.817,0.0
63816,743457,829,11017,829,12675,1658,831,13.29,0.0
63817,585790,1000,9000,1000,11000,2000,1001,9.0,0.0
63818,1056790,1000,14815,1000,16815,2000,1001,14.815,1.0
63819,247587,1000,1000,1000,3000,2000,1001,1.0,0.0
6382,37898,59,344,59,521,177,119,5.831,0.8333333333333334
63820,247587,1000,1000,1000,3000,2000,1001,1.0,0.0
63822,12638,36,108,36,180,72,37,3.0,0.0
63823,247587,1000,1000,1000,3000,2000,1001,1.0,0.0
63825,251588,1000,1000,1000,3000,2000,1001,1.0,0.0
63826,1353116,1000,22024,1000,24024,2000,1001,22.024,1.0
63828,1091,1,9,1,11,2,2,9.0,0.0
63829,245587,0,1000,0,2000,1000,1001,1.0,0.0
63830,247587,1000,1000,1000,3000,2000,1001,1.0,0.0
63831,116595,0,1605,0,1926,321,322,5.0,0.0
63832,731293,0,10999,0,11999,1000,1001,10.999,1.0
63835,1058270,943,15990,943,17876,1886,944,16.957,1.0
63839,1129110,1000,19000,1000,21000,2000,1001,19.0,0.0
6384,338014,500,2995,500,3995,1000,501,5.99,0.0
63841,1975600,926,45058,926,46910,1852,927,48.659,0.0
63842,665333,1000,10989,1000,12989,2000,1001,10.989,0.5
63844,1118970,1000,17735,1000,19735,2000,1001,17.735,0.0
63846,3787,0,45,0,50,5,6,9.0,0.5
63848,1225080,972,23107,972,25051,1944,974,23.773,0.0
63849,64710,104,709,104,917,208,105,6.817,0.0
6385,57935,82,1230,82,1394,164,83,15.0,0.0
63850,5778,13,52,13,78,26,14,4.0,0.0
63853,1163,1,8,1,10,2,2,8.0,0.5
63855,696128,1000,11000,1000,13000,2000,1001,11.0,0.0
63856,251588,1000,1000,1000,3000,2000,1001,1.0,0.0
63857,3601,0,27,0,36,9,10,3.0,0.5
63858,1036582,943,15047,943,16933,1886,944,15.957,0.5
63859,247587,1000,1000,1000,3000,2000,1001,1.0,0.0
6386,35240,0,404,0,456,52,53,7.769,0.0
63861,433032,0,6830,0,7513,683,684,10.0,1.0
63863,1755352,1000,31452,1000,33452,2000,1001,31.452,0.0
63864,99350,241,964,241,1446,482,242,4.0,0.5
63865,251588,1000,1000,1000,3000,2000,1001,1.0,0.5
63866,247587,1000,1000,1000,3000,2000,1001,1.0,0.0
63868,29350,50,400,50,500,100,51,8.0,0.0
63869,1135,1,10,1,12,2,2,10.0,0.0
6387,5130,0,48,0,60,12,13,4.0,0.0
63870,247587,1000,1000,1000,3000,2000,1001,1.0,0.5
63874,13933,0,150,0,159,9,10,16.667,0.6666666666666666
63877,1130,1,10,1,12,2,2,10.0,0.0
63878,1093620,1000,19000,1000,21000,2000,1001,19.0,0.0
6388,3574,0,27,0,32,5,6,5.4,0.0
63881,5059,12,48,12,72,24,13,4.0,0.0
63883,29350,50,400,50,500,100,51,8.0,0.5
63885,1284422,922,27353,922,29578,2225,1304,29.667,0.0
63887,997102,1000,15005,1000,17005,2000,1001,15.005,0.0
63888,4943,5,60,5,70,10,6,12.0,0.0
63890,247587,1000,1000,1000,3000,2000,1001,1.0,0.0
63893,1047875,1000,17265,1000,19265,2000,1001,17.265,0.0
63898,247587,1000,1000,1000,3000,2000,1001,1.0,0.5
63899,851911,1000,14430,1000,16430,2000,1001,14.43,0.0
6390,11490,0,90,0,126,36,37,5.0,0.5
63910,3044,7,21,7,35,14,8,3.0,0.0
63917,12347,33,99,33,165,66,34,3.0,0.0
63918,502625,958,4757,958,7263,2506,1370,4.966,0.0
6392,64876,0,1404,0,1482,78,79,18.0,0.0
63921,1092,1,6,1,8,2,2,6.0,0.0
6393,41004,0,432,0,504,72,73,6.0,0.0
63932,11101,0,105,0,114,9,10,11.667,0.8333333333333334
63937,1092,1,6,1,8,2,2,6.0,0.0
6394,12603,25,125,25,175,50,26,5.0,0.0
63941,1242,1,10,1,12,2,2,10.0,0.0
63942,39833,73,511,73,657,146,74,7.0,0.0
63945,247587,1000,1000,1000,3000,2000,1001,1.0,0.0
63946,247587,1000,1000,1000,3000,2000,1001,1.0,0.0
63947,251588,1000,1000,1000,3000,2000,1001,1.0,0.0
63948,158910,418,1672,418,2508,836,419,4.0,0.0
6395,57515,0,1185,0,1264,79,80,15.0,0.0
63952,409002,1000,4270,1000,6270,2000,1001,4.27,0.0
63953,1235,2,6,2,10,4,3,3.0,0.0
63955,894969,1000,15000,1000,17000,2000,1001,15.0,0.0
63956,737659,0,11000,0,12000,1000,1001,11.0,0.0
63959,251588,1000,1000,1000,3000,2000,1001,1.0,0.0
63960,3881,0,24,0,33,9,10,2.667,0.8333333333333334
63961,7299,10,80,10,100,20,11,8.0,0.0
63963,618534,0,9000,0,10000,1000,1001,9.0,0.0
63964,251588,1000,1000,1000,3000,2000,1001,1.0,0.0
63965,11463,31,112,31,174,62,32,3.613,0.0
63966,1859,4,12,4,20,8,5,3.0,0.0
63967,1238,1,10,1,12,2,2,10.0,0.0
6397,147869,0,3354,0,3432,78,79,43.0,0.5
63970,5466,10,50,10,70,20,11,5.0,0.0
63973,251588,1000,1000,1000,3000,2000,1001,1.0,0.0
63976,9542,23,92,23,138,46,24,4.0,0.0
63977,25029,61,244,61,366,122,62,4.0,0.0
63985,1207,2,6,2,10,4,3,3.0,0.0
6399,57259,0,1200,0,1280,80,81,15.0,0.0
63990,247587,1000,1000,1000,3000,2000,1001,1.0,0.0
63992,35391,81,405,81,567,162,82,5.0,0.0
63993,39154,71,568,71,710,142,72,8.0,0.0
63994,3525,8,32,8,48,16,9,4.0,0.0
63995,1600,3,9,3,15,6,4,3.0,0.0
63996,247587,1000,1000,1000,3000,2000,1001,1.0,0.0
63997,1207,2,6,2,10,4,3,3.0,0.0
63998,5121,12,48,12,72,24,13,4.0,0.0
64,4976796,9607,57634,9607,76845,19211,9608,5.999,0.0
6400,417077,0,8500,0,9000,500,501,17.0,0.0
6401,735153,500,11123,500,12123,1000,501,22.246,0.0
6402,57378,79,1185,79,1343,158,80,15.0,0.0
6403,80128,78,1052,78,1208,156,79,13.487,0.0
64031,251588,1000,1000,1000,3000,2000,1001,1.0,0.0
64034,797783,1000,13046,1000,15046,2000,1001,13.046,0.0
64038,1076581,1000,20683,1000,22683,2000,1001,20.683,0.0
64039,2842209,1000,65447,1000,67447,2000,1001,65.447,1.0
64040,514823,1000,6000,1000,8000,2000,1001,6.0,0.0
64041,1510393,0,28866,0,29866,1000,1001,28.866,1.0
64042,87664,0,995,0,1194,199,200,5.0,0.0
64047,676595,1000,11199,1000,13199,2000,1001,11.199,0.0
64048,1184176,1000,22351,1000,24351,2000,1001,22.351,0.0
64050,145504,420,1259,420,2099,840,421,2.998,0.0
64051,5198,14,42,14,70,28,15,3.0,0.0
64053,249589,1000,1000,1000,3000,2000,1001,1.0,0.0
64054,7624,21,63,21,105,42,22,3.0,0.0
64056,262932,679,2035,679,3393,1358,680,2.997,0.0
64058,926529,0,10300,0,11300,1000,1001,10.3,0.0
64059,2522,6,17,6,29,12,7,2.833,0.0
6406,486047,0,6000,0,6500,500,501,12.0,0.0
64061,20433,50,220,50,320,100,51,4.4,0.5
64062,20433,50,220,50,320,100,51,4.4,0.0
64063,253590,1000,1000,1000,3000,2000,1001,1.0,0.0
64064,263352,363,3048,363,3774,726,364,8.397,0.0
64065,440817,1000,5107,1000,7107,2000,1001,5.107,0.0
64066,959,1,3,1,5,2,2,3.0,0.0
64067,1006185,1000,17000,1000,19000,2000,1001,17.0,0.0
64068,1054241,1000,17000,1000,19000,2000,1001,17.0,0.0
64069,638633,0,9000,0,10000,1000,1001,9.0,0.0
6407,118681,0,1610,0,1780,170,171,9.471,1.0
64070,650926,0,9000,0,10000,1000,1001,9.0,0.0
64071,16425,0,175,0,210,35,36,5.0,0.0
64072,40030,36,540,36,648,108,74,7.5,0.0
64074,211994,0,1648,0,2060,412,413,4.0,0.0
64075,1611,0,10,0,12,2,3,5.0,0.0
64076,688628,1000,11000,1000,13000,2000,1001,11.0,0.0
64077,36096,56,504,56,616,112,57,9.0,0.0
64078,686045,1000,11000,1000,13000,2000,1001,11.0,0.0
64079,2269,0,16,0,20,4,5,4.0,0.0
6408,5090,7,51,7,65,14,8,7.286,0.0
64080,42524,100,550,100,750,200,102,5.5,0.0
64081,17074,0,180,0,216,36,37,5.0,0.0
64082,42955,100,550,100,750,200,102,5.5,0.0
64085,77001,295,295,295,885,590,296,1.0,0.0
64086,572176,1000,8237,1000,10237,2000,1001,8.237,0.0
64087,77001,295,295,295,885,590,296,1.0,0.0
64088,75820,295,295,295,885,590,296,1.0,0.0
64089,75820,295,295,295,885,590,296,1.0,0.0
64092,1647342,1000,24725,1000,26725,2000,1001,24.725,0.0
64093,1724903,1000,26192,1000,28192,2000,1001,26.192,0.0
64095,1720968,1000,26192,1000,28192,2000,1001,26.192,0.0
64097,15949,24,192,24,240,48,25,8.0,0.0
64099,267607,1000,1000,1000,3000,2000,1001,1.0,0.0
6410,2350814,500,26386,500,27386,1000,501,52.772,0.0
64102,2642,3,18,3,24,6,4,6.0,0.0
64103,18366,40,160,40,240,80,41,4.0,0.0
64107,1942,5,5,5,15,10,6,1.0,0.0
64108,7776,11,66,11,88,22,12,6.0,0.0
6411,727247,500,11015,500,12015,1000,501,22.03,0.0
64111,79539,80,940,80,1100,160,81,11.75,0.0
64112,583941,1000,9000,1000,11000,2000,1001,9.0,0.0
64113,66147,88,946,88,1122,176,89,10.75,0.0
64114,785547,1000,10000,1000,12000,2000,1001,10.0,0.0
64116,1391443,1000,24088,1000,26088,2000,1001,24.088,0.0
64119,5006,10,60,10,80,20,11,6.0,0.0
6412,506689,500,6500,500,7500,1000,501,13.0,0.0
64120,1954,5,5,5,15,10,6,1.0,0.0
64121,768780,1000,10666,1000,12666,2000,1001,10.666,0.6666666666666666
64123,7847,18,72,18,108,36,19,4.0,0.0
64125,22450,80,80,80,240,160,81,1.0,0.0
64126,269609,1000,1000,1000,3000,2000,1001,1.0,0.0
64129,23205,84,84,84,252,168,85,1.0,0.0
6413,88342,159,795,159,1113,318,160,5.0,0.0
64130,2730,6,18,6,30,12,7,3.0,0.0
64132,1218305,1000,18522,1000,20522,2000,1001,18.522,0.0
64142,316028,8,48,8,64,16,9,6.0,0.0
6415,25920,69,276,69,414,138,70,4.0,0.0
6416,57701,81,1201,81,1363,162,82,14.827,0.0
6417,259675,0,2976,0,3476,500,501,5.952,0.0
6418,5420,0,60,0,72,12,13,5.0,0.0
6419,457162,500,5500,500,6500,1000,501,11.0,0.0
642,15394,18,198,18,234,36,19,11.0,0.0
6420,295640,500,2997,500,3997,1000,501,5.994,0.0
64208,2159972,1000,42071,1000,44071,2000,1001,42.071,0.0
64209,2099037,1000,41135,1000,43135,2000,1001,41.135,0.0
6421,248067,0,3500,0,4000,500,501,7.0,0.0
64210,1165571,0,18996,0,19996,1000,1001,18.996,0.0
64212,537879,0,6896,0,7896,1000,1001,6.896,0.0
64214,159825,0,2310,0,2640,330,331,7.0,0.0
64219,692282,1000,9998,1000,11998,2000,1001,9.998,0.5
6422,249694,500,3500,500,4500,1000,501,7.0,0.0
64226,653487,1000,7000,1000,10000,3000,2001,7.0,0.0
6423,381486,500,3000,500,4000,1000,501,6.0,0.0
64233,549461,0,8634,0,9634,1000,1001,8.634,0.5
6424,371120,0,6812,0,7312,500,501,13.624,0.0
64241,3274270,0,37419,0,37659,240,241,155.912,0.5
64247,3628081,1000,21114,1000,25113,3999,3000,21.114,0.0
6425,31333,68,340,68,476,136,69,5.0,0.0
64256,7897,16,112,16,144,32,17,7.0,0.0
64258,5963,10,80,10,100,20,11,8.0,0.0
6426,510405,0,6500,0,7000,500,501,13.0,0.0
64260,6084,10,70,10,90,20,11,7.0,0.0
6427,306412,79,4238,79,4396,158,80,53.646,0.0
64275,41782,33,588,33,654,66,34,17.818,0.0
64279,179815,283,1981,283,2830,849,567,7.0,0.0
6428,57640,82,1230,82,1394,164,83,15.0,0.0
64282,1639072,0,23739,0,23979,240,241,98.912,0.0
64284,193496,0,103,0,132,29,30,6.438,0.0
64289,425422,0,6000,0,7000,1000,1001,6.0,0.0
64292,47484,67,536,67,670,134,68,8.0,0.5
64294,1033488,0,11979,0,12219,240,241,49.913,0.0
64301,6063,10,70,10,90,20,11,7.0,0.0
64305,1355442,0,16059,0,16299,240,241,66.912,0.0
64315,7927,13,91,13,117,26,14,7.0,0.0
64319,748320,0,15222,0,15699,477,478,31.912,0.0
6432,525799,500,6500,500,7500,1000,501,13.0,0.5
64325,14500,0,176,0,220,44,45,8.0,0.0
64329,2546,4,28,4,36,8,5,7.0,0.0
6433,245283,500,2095,500,3095,1000,501,4.19,0.0
64334,827559,0,11649,0,12126,477,478,24.421,0.0
64336,3104,6,30,6,42,12,7,5.0,0.0
64339,464937,1000,6000,1000,8000,2000,1001,6.0,0.0
6434,148041,241,2059,241,2541,482,242,8.544,0.0
64341,1446,2,12,2,16,4,3,6.0,0.0
64343,3025,5,35,5,45,10,6,7.0,0.0
64344,6083,10,70,10,90,20,11,7.0,0.0
64347,326646,0,3534,0,3771,237,238,14.911,0.0
6435,4903,7,51,7,65,14,8,7.286,0.0
6438,445445,0,8500,0,9000,500,501,17.0,0.0
6439,322400,0,2985,0,3485,500,501,5.97,0.0
6440,68901,83,1485,83,1651,166,84,17.892,0.0
64400,6435,10,80,10,100,20,11,8.0,0.0
6441,69782,83,1485,83,1651,166,84,17.892,0.0
6444,36271,0,305,0,357,52,53,5.865,0.0
64446,5712,10,70,10,90,20,11,7.0,0.0
6445,3203,0,20,0,25,5,6,4.0,0.0
64454,7884,16,112,16,144,32,17,7.0,0.0
64459,3099,6,30,6,42,12,7,5.0,0.0
64462,2880,5,35,5,45,10,6,7.0,0.0
64464,6158,10,70,10,90,20,11,7.0,0.0
64465,6398,10,80,10,100,20,11,8.0,0.0
64466,1475,2,12,2,16,4,3,6.0,0.0
64467,8716,16,112,16,144,32,17,7.0,0.0
6447,11036,15,102,15,132,30,16,6.8,0.0
64473,6353,10,80,10,100,20,11,8.0,0.0
64474,2860,6,30,6,42,12,7,5.0,0.0
64475,6373,10,80,10,100,20,11,8.0,0.0
64476,1516166,1000,27287,1000,29287,2000,1001,27.287,0.0
64477,5695,10,70,10,90,20,11,7.0,0.0
64478,6181,10,70,10,90,20,11,7.0,0.0
64479,14550,57,57,57,171,114,58,1.0,0.0
6448,21968,28,252,28,308,56,29,9.0,0.0
64480,6177,10,70,10,90,20,11,7.0,0.0
64481,44779,0,369,0,492,123,124,3.0,0.0
64482,2533,4,28,4,36,8,5,7.0,0.0
64483,1465,2,12,2,16,4,3,6.0,0.0
64485,1484,2,12,2,16,4,3,6.0,0.0
64486,2717,6,18,6,30,12,7,3.0,0.0
64487,3015,0,35,0,40,5,6,7.0,0.0
64488,6288,10,80,10,100,20,11,8.0,0.0
64489,2718,6,18,6,30,12,7,3.0,0.0
6449,248844,500,3500,500,4500,1000,501,7.0,0.0
64490,6186,10,70,10,90,20,11,7.0,0.0
64491,6405,10,80,10,100,20,11,8.0,0.0
64492,9144,17,119,17,153,34,18,7.0,0.0
64493,627926,0,8000,0,9000,1000,1001,8.0,0.0
64494,1471,2,12,2,16,4,3,6.0,0.0
64495,3020,5,35,5,45,10,6,7.0,0.0
64496,5668,10,70,10,90,20,11,7.0,0.0
64498,3531,6,42,6,54,12,7,7.0,0.0
64499,3020,5,35,5,45,10,6,7.0,0.0
645,456297,500,5500,500,6500,1000,502,11.0,0.0
6450,58407,81,1215,81,1377,162,82,15.0,0.0
64500,3121,6,30,6,42,12,7,5.0,0.0
64501,1476,2,12,2,16,4,3,6.0,0.0
64502,5438,12,60,12,84,24,13,5.0,0.0
64505,3036,5,35,5,45,10,6,7.0,0.0
64506,1890821,1000,12864,1000,14864,2000,1001,12.864,0.0
64507,5992,10,70,10,90,20,11,7.0,0.0
64508,97719,177,1527,177,1881,354,178,8.627,0.5
64509,1325,2,8,2,12,4,3,4.0,0.0
6451,342973,500,3941,500,4941,1000,501,7.882,0.0
64510,3125,6,30,6,42,12,7,5.0,0.0
64511,3102,6,30,6,42,12,7,5.0,0.0
64512,6423,10,80,10,100,20,11,8.0,0.0
64513,1433,2,12,2,16,4,3,6.0,0.0
64514,6437,16,48,16,80,32,17,3.0,0.0
64516,3025,5,35,5,45,10,6,7.0,0.0
64517,6296,10,70,10,90,20,11,7.0,0.0
64518,8651,16,112,16,144,32,17,7.0,0.0
64519,2537,4,28,4,36,8,5,7.0,0.0
6452,324923,0,3,0,4,1,2,3.0,0.0
64520,8652,16,112,16,144,32,17,7.0,0.0
64521,8667,16,112,16,144,32,17,7.0,0.0
64522,3104,6,30,6,42,12,7,5.0,0.0
64523,6003,10,70,10,90,20,11,7.0,0.0
64524,1465,2,12,2,16,4,3,6.0,0.0
64525,8651,16,112,16,144,32,17,7.0,0.0
64526,5627,10,70,10,90,20,11,7.0,0.0
64527,5716,10,70,10,90,20,11,7.0,0.0
64528,1886996,1000,5000,1000,7000,2000,1001,5.0,0.0
64529,1465,2,12,2,16,4,3,6.0,0.0
64530,8649,16,112,16,144,32,17,7.0,0.0
64531,3102,6,30,6,42,12,7,5.0,0.0
64532,6000,10,70,10,90,20,11,7.0,0.0
64533,5663,10,70,10,90,20,11,7.0,0.0
64534,1478,2,12,2,16,4,3,6.0,0.0
64535,1271,2,6,2,10,4,3,3.0,0.0
64536,3100,6,30,6,42,12,7,5.0,0.0
64537,6218,10,70,10,90,20,11,7.0,0.0
64538,2880,5,35,5,45,10,6,7.0,0.0
64539,2859,6,30,6,42,12,7,5.0,0.0
64540,1473,2,12,2,16,4,3,6.0,0.0
64541,2858,6,30,6,42,12,7,5.0,0.0
64542,6404,10,80,10,100,20,11,8.0,0.0
64543,1467,2,12,2,16,4,3,6.0,0.0
64544,6007,10,70,10,90,20,11,7.0,0.0
64545,1429,2,12,2,16,4,3,6.0,0.0
64546,6058,10,70,10,90,20,11,7.0,0.0
64547,5731,10,70,10,90,20,11,7.0,0.0
64548,2861,6,24,6,36,12,7,4.0,0.0
64549,6280,10,80,10,100,20,11,8.0,0.0
6455,239026,0,2500,0,3000,500,501,5.0,0.0
64551,3016,5,35,5,45,10,6,7.0,0.0
64552,7270,17,68,17,102,34,18,4.0,0.0
64553,3123,6,30,6,42,12,7,5.0,0.0
64554,5807,10,70,10,90,20,11,7.0,0.0
64555,5706,10,70,10,90,20,11,7.0,0.0
64556,3041,5,35,5,45,10,6,7.0,0.0
64558,395630,0,6636,0,7113,477,478,13.912,0.0
64559,8716,16,112,16,144,32,17,7.0,0.0
6456,70111,166,785,166,1117,332,167,4.729,0.0
64560,5990,10,70,10,90,20,11,7.0,0.0
64562,1463,2,12,2,16,4,3,6.0,0.0
64563,1438,2,12,2,16,4,3,6.0,0.0
64564,6351,10,80,10,100,20,11,8.0,0.0
64565,8666,16,112,16,144,32,17,7.0,0.0
64566,3435,8,24,8,40,16,9,3.0,0.0
64567,3124,6,30,6,42,12,7,5.0,0.0
64569,3339,6,42,6,54,12,7,7.0,0.0
6457,1519566,500,24057,500,25057,1000,501,48.114,1.0
64570,8731,16,112,16,144,32,17,7.0,0.0
64571,2550,4,28,4,36,8,5,7.0,0.0
64572,25740,73,219,73,365,146,74,3.0,0.0
64573,4029,7,49,7,63,14,8,7.0,0.0
64574,3125,6,30,6,42,12,7,5.0,0.0
64575,8715,16,112,16,144,32,17,7.0,0.0
64576,42961,0,624,0,728,104,105,6.0,0.5
64577,473869,1000,5000,1000,7000,2000,1001,5.0,0.0
64578,1484,2,12,2,16,4,3,6.0,0.0
64579,6055,10,70,10,90,20,11,7.0,0.0
6458,3168,0,20,0,25,5,6,4.0,0.0
64580,9218,17,119,17,153,34,18,7.0,0.0
64581,9147,17,119,17,153,34,18,7.0,0.0
64584,6393,10,80,10,100,20,11,8.0,0.0
64585,1476,2,12,2,16,4,3,6.0,0.0
64586,5796,10,70,10,90,20,11,7.0,0.0
64587,3099,6,30,6,42,12,7,5.0,0.0
64588,6051,10,70,10,90,20,11,7.0,0.0
64589,7883,16,112,16,144,32,17,7.0,0.0
6459,20794,0,198,0,241,43,44,4.605,0.0
64590,9147,17,119,17,153,34,18,7.0,0.0
64591,1480,2,12,2,16,4,3,6.0,0.0
64592,6209,10,70,10,90,20,11,7.0,0.0
64594,6262,10,80,10,100,20,11,8.0,0.0
64595,3106,6,30,6,42,12,7,5.0,0.0
64596,6176,10,70,10,90,20,11,7.0,0.0
64597,1473,2,12,2,16,4,3,6.0,0.0
64598,3100,6,30,6,42,12,7,5.0,0.0
6460,5973,0,20,0,25,5,6,4.0,0.0
64600,3125,6,30,6,42,12,7,5.0,0.0
64601,6245,10,80,10,100,20,11,8.0,0.0
64602,2859,6,30,6,42,12,7,5.0,0.0
64603,827970,0,10929,0,11406,477,478,22.912,0.0
64606,3101,6,30,6,42,12,7,5.0,0.0
64607,7949,16,112,16,144,32,17,7.0,0.0
6461,411310,500,5000,500,6000,1000,501,10.0,0.0
64610,6295,10,80,10,100,20,11,8.0,0.0
64611,8731,16,112,16,144,32,17,7.0,0.0
64613,6436,10,80,10,100,20,11,8.0,0.0
64614,6247,10,80,10,100,20,11,8.0,0.0
64615,6404,10,80,10,100,20,11,8.0,0.0
64616,5436,12,60,12,84,24,13,5.0,0.0
64617,3020,5,35,5,45,10,6,7.0,0.0
64618,6274,10,80,10,100,20,11,8.0,0.0
6462,417306,500,5500,500,6500,1000,501,11.0,0.0
64620,329857,337,3213,337,4179,966,630,9.534,0.0
64622,1475,2,12,2,16,4,3,6.0,0.0
64623,3027,0,35,0,40,5,6,7.0,0.0
64624,3019,5,35,5,45,10,6,7.0,0.0
64625,2529,4,28,4,36,8,5,7.0,0.0
64626,6259,10,80,10,100,20,11,8.0,0.0
64627,3099,6,30,6,42,12,7,5.0,0.0
64628,6356,10,80,10,100,20,11,8.0,0.0
64630,43376,0,624,0,728,104,105,6.0,0.0
64634,1474,2,12,2,16,4,3,6.0,0.0
64636,6270,10,80,10,100,20,11,8.0,0.0
64637,1469,2,12,2,16,4,3,6.0,0.0
64639,6475,10,80,10,100,20,11,8.0,0.0
6464,23368,0,344,0,364,20,21,17.2,0.0
64640,3025,5,35,5,45,10,6,7.0,0.0
64641,6305,10,80,10,100,20,11,8.0,0.0
64642,8649,16,112,16,144,32,17,7.0,0.0
64643,6429,10,80,10,100,20,11,8.0,0.0
64645,3100,6,30,6,42,12,7,5.0,0.0
6465,23484,0,238,0,287,49,50,4.857,0.0
64651,3020,5,35,5,45,10,6,7.0,0.0
6466,87103,0,1398,0,1478,80,81,17.475,0.0
64661,6395,10,80,10,100,20,11,8.0,0.0
64663,2533,4,28,4,36,8,5,7.0,0.0
64664,85600,347,347,347,1041,694,348,1.0,0.0
64666,3126,6,30,6,42,12,7,5.0,0.0
6467,1435,0,14,0,15,1,2,14.0,0.0
64670,3100,6,30,6,42,12,7,5.0,0.0
64671,3100,6,30,6,42,12,7,5.0,0.0
64672,1467,2,12,2,16,4,3,6.0,0.0
64674,2533,4,28,4,36,8,5,7.0,0.0
64675,16540,14,229,14,257,28,15,16.357,0.0
64679,3020,5,35,5,45,10,6,7.0,0.0
6468,1039095,364,15024,364,15752,728,365,41.275,0.0
64681,9215,17,119,17,153,34,18,7.0,0.0
64684,9148,17,119,17,153,34,18,7.0,0.0
64685,6295,10,80,10,100,20,11,8.0,0.0
64686,1465,2,12,2,16,4,3,6.0,0.0
64687,6734,10,90,10,110,20,11,9.0,0.0
64688,4719,12,36,12,60,24,13,3.0,0.0
6469,366210,0,10000,0,10500,500,501,20.0,0.0
64690,6349,10,80,10,100,20,11,8.0,0.0
64692,1473,2,12,2,16,4,3,6.0,0.0
64694,3104,6,30,6,42,12,7,5.0,0.0
64696,1475,2,12,2,16,4,3,6.0,0.0
64699,9214,17,119,17,153,34,18,7.0,0.0
6470,367979,0,10000,0,10500,500,501,20.0,0.0
64700,3122,6,30,6,42,12,7,5.0,0.0
64701,9165,17,119,17,153,34,18,7.0,0.0
64702,3106,6,30,6,42,12,7,5.0,0.0
64705,6324,10,80,10,100,20,11,8.0,0.0
64706,1475,2,12,2,16,4,3,6.0,0.0
64707,9215,17,119,17,153,34,18,7.0,0.0
64708,1762685,1998,28396,1998,32392,3996,2000,14.212,0.0
64709,6433,10,80,10,100,20,11,8.0,0.0
6471,129488,0,1100,0,1320,220,221,5.0,0.0
64710,1471,2,12,2,16,4,3,6.0,0.0
64711,6268,10,80,10,100,20,11,8.0,0.0
64712,9213,17,119,17,153,34,18,7.0,0.0
64713,3096,6,30,6,42,12,7,5.0,0.0
64714,2550,4,28,4,36,8,5,7.0,0.0
64715,3101,6,30,6,42,12,7,5.0,0.0
64716,6373,10,80,10,100,20,11,8.0,0.0
64717,473363,1000,5000,1000,7000,2000,1001,5.0,0.0
64718,3020,5,35,5,45,10,6,7.0,0.0
64719,6428,10,80,10,100,20,11,8.0,0.0
64720,6284,10,80,10,100,20,11,8.0,0.0
64721,6315,10,80,10,100,20,11,8.0,0.0
64722,9147,17,119,17,153,34,18,7.0,0.0
64723,6290,10,80,10,100,20,11,8.0,0.0
64724,24330,0,350,0,400,50,51,7.0,0.0
64727,2533,4,28,4,36,8,5,7.0,0.0
64728,3100,6,30,6,42,12,7,5.0,0.0
64730,3101,6,30,6,42,12,7,5.0,0.0
64733,5436,12,60,12,84,24,13,5.0,0.0
64734,6428,10,80,10,100,20,11,8.0,0.0
64736,6312,10,80,10,100,20,11,8.0,0.0
64737,2681,5,25,5,35,10,6,5.0,0.0
64743,6307,10,80,10,100,20,11,8.0,0.0
64745,6438,10,80,10,100,20,11,8.0,0.0
64747,3020,5,35,5,45,10,6,7.0,0.0
64748,1465,2,12,2,16,4,3,6.0,0.0
6475,484942,0,9000,0,9500,500,501,18.0,0.5
64750,165803,339,1695,339,2373,678,340,5.0,0.0
64751,6259,10,80,10,100,20,11,8.0,0.0
64753,1465,2,12,2,16,4,3,6.0,0.0
64756,1465,2,12,2,16,4,3,6.0,0.0
64759,3104,6,30,6,42,12,7,5.0,0.0
6476,475865,0,9000,0,9500,500,501,18.0,0.0
64760,9161,17,119,17,153,34,18,7.0,0.0
64761,9146,17,119,17,153,34,18,7.0,0.0
64763,9225,15,135,15,165,30,16,9.0,0.0
64766,3025,5,35,5,45,10,6,7.0,0.0
6477,476393,0,9000,0,9500,500,501,18.0,0.0
64775,1465,2,12,2,16,4,3,6.0,0.0
6478,481783,0,9000,0,9500,500,501,18.0,0.0
64780,6919,10,90,10,110,20,11,9.0,0.0
64798,245585,1000,1000,1000,3000,2000,1001,1.0,0.0
64799,21722,18,305,18,341,36,19,16.944,0.0
648,450300,0,9000,0,9500,500,501,18.0,0.0
6480,1421159,0,23682,0,24182,500,501,47.364,0.0
64800,6763,10,90,10,110,20,11,9.0,0.0
64801,1473,2,12,2,16,4,3,6.0,0.0
64803,6720,10,90,10,110,20,11,9.0,0.0
64805,5741,10,70,10,90,20,11,7.0,0.0
64806,5738664,477,3816,477,4770,954,478,8.0,0.0
64809,6862,10,90,10,110,20,11,9.0,0.0
6481,470487,0,9000,0,9500,500,501,18.0,0.0
64816,9145,17,119,17,153,34,18,7.0,0.0
64817,9634,18,126,18,162,36,19,7.0,0.0
64819,6294,10,80,10,100,20,11,8.0,0.0
6482,275783,0,5500,0,6000,500,501,11.0,0.0
64820,1467,2,12,2,16,4,3,6.0,0.0
64822,3100,6,30,6,42,12,7,5.0,0.0
64823,6429,10,80,10,100,20,11,8.0,0.0
64826,3107,6,30,6,42,12,7,5.0,0.0
64827,6451,10,80,10,100,20,11,8.0,0.0
6483,275691,500,5500,500,6500,1000,501,11.0,0.0
64831,6729,10,90,10,110,20,11,9.0,0.0
64835,9648,18,126,18,162,36,19,7.0,0.0
64838,6308,10,80,10,100,20,11,8.0,0.0
6484,272593,0,4000,0,4500,500,501,8.0,0.0
64849,3125,6,30,6,42,12,7,5.0,0.0
6485,508002,500,9000,500,10000,1000,501,18.0,0.0
64854,1473,2,12,2,16,4,3,6.0,0.0
6486,459172,500,9000,500,10000,1000,501,18.0,0.0
64863,6449,10,80,10,100,20,11,8.0,0.0
64868,6459,10,80,10,100,20,11,8.0,0.0
64869,1469,2,12,2,16,4,3,6.0,0.0
6487,275457,0,5500,0,6000,500,501,11.0,0.0
64870,3101,6,30,6,42,12,7,5.0,0.0
64871,6876,10,90,10,110,20,11,9.0,0.0
64872,2685,5,25,5,35,10,6,5.0,0.0
64876,6373,10,80,10,100,20,11,8.0,0.0
64879,9224,17,119,17,153,34,18,7.0,0.0
6488,363262,500,10000,500,11000,1000,501,20.0,0.0
64880,6356,10,80,10,100,20,11,8.0,0.0
64882,645958,1000,8929,1000,10929,2000,1001,8.929,0.0
64887,14550,57,57,57,171,114,58,1.0,0.0
6489,369754,500,10000,500,11000,1000,501,20.0,0.0
649,1190659,0,19038,0,19538,500,501,38.076,0.0
6490,1014095,500,16725,500,17725,1000,501,33.45,0.0
64900,4095,0,30,0,40,10,11,3.0,0.0
64904,916288,1000,12230,1000,14230,2000,1001,12.23,0.0
64907,2739419,1000,28970,1000,30970,2000,1001,28.97,0.0
64908,60855,246,246,246,738,492,247,1.0,0.0
6491,3147825,500,114578,500,115578,1000,501,229.156,0.0
64912,177720,723,723,723,2169,1446,724,1.0,0.0
64913,9215,17,119,17,153,34,18,7.0,0.0
64917,165803,339,1695,339,2373,678,340,5.0,0.0
64918,130680,531,531,531,1593,1062,532,1.0,0.0
64921,130680,531,531,531,1593,1062,532,1.0,0.0
64925,25913,52,364,52,468,104,53,7.0,0.0
64926,6479,10,80,10,100,20,11,8.0,0.0
64927,158788,327,1635,327,2289,654,328,5.0,0.0
64928,159805,0,2034,0,2260,226,227,9.0,0.0
64929,141547,223,1784,223,2230,446,224,8.0,0.0
6493,617080,0,9081,0,9581,500,501,18.162,0.5
64930,130680,531,531,531,1593,1062,532,1.0,0.0
64931,477786,1000,5000,1000,7000,2000,1001,5.0,0.0
64932,1325,2,8,2,12,4,3,4.0,0.0
64933,130680,531,531,531,1593,1062,532,1.0,0.0
64934,1484,2,12,2,16,4,3,6.0,0.0
64935,8731,16,112,16,144,32,17,7.0,0.0
64936,132805,531,531,531,1593,1062,532,1.0,0.0
64937,132805,531,531,531,1593,1062,532,1.0,0.0
64938,6352,10,80,10,100,20,11,8.0,0.0
64939,132805,531,531,531,1593,1062,532,1.0,0.0
6494,226311,0,3006,0,3506,500,501,6.012,0.0
64940,132805,531,531,531,1593,1062,532,1.0,0.0
64941,3106,6,30,6,42,12,7,5.0,0.0
64942,130680,531,531,531,1593,1062,532,1.0,0.0
64943,130680,531,531,531,1593,1062,532,1.0,0.0
64944,130680,531,531,531,1593,1062,532,1.0,0.0
64945,6431,10,80,10,100,20,11,8.0,0.0
64946,130680,531,531,531,1593,1062,532,1.0,0.0
64947,3106,6,30,6,42,12,7,5.0,0.0
64948,60855,246,246,246,738,492,247,1.0,0.0
64949,245585,1000,1000,1000,3000,2000,1001,1.0,0.0
64950,177720,723,723,723,2169,1446,724,1.0,0.0
64951,130680,531,531,531,1593,1062,532,1.0,0.0
64952,695789,1000,10000,1000,12000,2000,1001,10.0,0.0
64956,1414282,0,22641,0,23641,1000,1001,22.641,0.0
6496,12685,0,100,0,125,25,26,4.0,0.5
6497,140627,0,2688,0,2856,168,169,16.0,0.0
6498,2115471,1263,24050,1263,27011,2961,1700,14.164,0.0
6499,19231,0,234,0,247,13,14,18.0,0.5
650,1522183,0,32973,0,33473,500,501,65.946,0.5
6501,32133,0,300,0,375,75,76,4.0,0.0
6503,47838,25,975,25,1025,50,26,39.0,1.0
6504,60481,0,800,0,900,100,101,8.0,0.0
6505,292501,0,3668,0,3740,72,73,50.944,0.0
6506,454212,0,8436,0,8936,500,501,16.872,0.0
6508,494010,0,7542,0,7964,422,423,17.872,0.0
6509,1553151,500,21488,500,22488,1000,501,42.976,0.0
6510,219351,277,2006,277,2560,554,278,7.242,0.0
6511,396263,500,5500,500,6500,1000,501,11.0,0.0
6512,270634,500,3500,500,4500,1000,501,7.0,0.0
6513,184860,0,3570,0,3780,210,211,17.0,0.0
6514,631342,500,12488,500,13488,1000,501,24.976,1.0
65144,2339353,1000,33481,1000,35481,2000,1001,33.481,0.0
65145,2278383,1000,32309,1000,34309,2000,1001,32.309,0.0
65146,2278383,1000,32309,1000,34309,2000,1001,32.309,0.0
65147,243580,1000,1000,1000,3000,2000,1001,1.0,0.0
6515,60330,0,636,0,727,91,92,6.989,0.0
6516,324830,0,4498,0,4998,500,501,8.996,0.0
6517,636762,0,8527,0,9027,500,501,17.054,0.0
6518,297769,0,3566,0,4066,500,501,7.132,0.0
65181,581580,1000,9000,1000,11000,2000,1001,9.0,0.0
65189,166597,113,748,113,974,226,114,6.619,0.0
6519,376934,500,5000,500,6000,1000,501,10.0,0.0
65190,120620,213,1064,213,1490,426,214,4.995,0.0
65191,114409,153,2156,153,2462,306,154,14.092,0.0
65192,311046,0,3955,0,4469,514,515,7.695,0.5
65198,38549,0,464,0,490,26,27,17.846,0.0
65199,28390,109,109,109,327,218,110,1.0,0.0
6520,23820,0,483,0,504,21,22,23.0,0.5
65200,87350,0,1248,0,1404,156,157,8.0,0.0
65202,53900,0,675,0,810,135,136,5.0,0.0
65203,6401,0,75,0,90,15,16,5.0,0.0
65204,479782,1000,6918,1000,8918,2000,1001,6.918,0.0
65205,558388,1000,9000,1000,11000,2000,1001,9.0,0.0
65206,5421,12,48,12,72,24,13,4.0,0.0
65208,1149558,1000,23000,1000,25000,2000,1001,23.0,0.0
65209,2018202,155,1085,155,1395,310,156,7.0,0.0
6521,2085408,0,22614,0,23114,500,501,45.228,0.0
65210,19159,32,188,32,252,64,33,5.875,0.0
65214,1254168,1000,10000,1000,12000,2000,1001,10.0,0.0
65215,15435,19,203,19,241,38,20,10.684,0.0
65216,2652,4,28,4,36,8,5,7.0,0.0
65217,137099,0,1820,0,2080,260,261,7.0,0.0
65218,55287,0,764,0,822,58,59,13.172,0.0
65219,11968,23,161,23,207,46,24,7.0,0.0
65223,673864,432,16416,432,17280,864,433,38.0,0.0
65224,299847,744,3720,744,5208,1488,745,5.0,0.0
65225,783203,1000,14000,1000,16000,2000,1001,14.0,0.0
65227,95630,0,1296,0,1440,144,145,9.0,0.0
65228,49258,0,780,0,858,78,79,10.0,0.0
6523,304687,0,2907,0,3407,500,501,5.814,0.0
65233,25650,35,370,35,440,70,36,10.571,0.0
65234,4447,0,50,0,60,10,11,5.0,0.0
65237,684746,1000,9824,1000,11824,2000,1001,9.824,0.0
65239,126138,0,1534,0,1732,198,199,7.747,0.0
6524,16076,0,198,0,222,24,25,8.25,0.0
65245,97031,0,1344,0,1536,192,193,7.0,0.0
65246,684387,1000,10780,1000,12780,2000,1001,10.78,0.0
65247,504896,1000,7984,1000,9984,2000,1001,7.984,0.0
65248,38722,0,394,0,441,47,48,8.383,0.0
6525,336035,500,5003,500,6003,1000,501,10.006,0.0
65250,579419,1000,8922,1000,10922,2000,1001,8.922,0.0
65255,6119,0,90,0,100,10,11,9.0,0.0
65259,48718,108,540,108,756,216,109,5.0,0.0
6526,770433,0,11092,0,11328,236,237,47.0,0.0
65260,655176,1000,6873,1000,8873,2000,1001,6.873,0.0
65263,535559,1000,8000,1000,10000,2000,1001,8.0,0.0
65264,58184,122,854,122,1098,244,123,7.0,0.0
65265,7078,10,90,10,110,20,11,9.0,0.0
65266,100554,207,1446,207,1860,414,208,6.986,0.0
65267,360726,624,5616,624,6864,1248,625,9.0,0.0
65268,8265,0,117,0,130,13,14,9.0,0.0
6527,3763075,0,75023,0,75523,500,501,150.046,0.0
65270,35935,60,520,60,640,120,61,8.667,0.0
65271,609751,1000,9999,1000,11999,2000,1001,9.999,0.0
65272,480105,1000,6928,1000,8928,2000,1001,6.928,0.0
65273,88994,153,918,153,1224,306,154,6.0,0.0
65274,27311,59,354,59,472,118,60,6.0,0.5
65275,3606,0,24,0,30,6,7,4.0,0.0
65276,18634,0,296,0,312,16,17,18.5,0.0
65277,19120,0,296,0,312,16,17,18.5,0.0
65278,6608,10,90,10,110,20,11,9.0,0.0
65279,57194,126,747,126,999,252,127,5.929,0.0
6528,63894,33,792,33,858,66,34,24.0,0.0
65280,474797,1000,6530,1000,8530,2000,1001,6.53,0.5
65281,162578,0,2664,0,2808,144,145,18.5,0.0
65282,5899,0,72,0,84,12,13,6.0,0.0
65283,12541,22,176,22,220,44,23,8.0,0.0
65284,512318,1000,7528,1000,9528,2000,1001,7.528,0.0
65285,20464,28,448,28,504,56,29,16.0,0.0
65286,15220,0,176,0,198,22,23,8.0,0.0
65287,147710,9,99,9,117,18,10,11.0,0.0
65288,576049,635,1905,635,3175,1270,636,3.0,0.0
65289,566665,1000,8964,1000,10964,2000,1001,8.964,0.0
6529,58872,0,480,0,640,160,161,3.0,0.0
65290,6726,14,83,14,111,28,15,5.929,0.0
65292,295357,510,4990,510,6010,1020,511,9.784,0.0
65294,491079,869,6730,869,8468,1738,870,7.745,0.0
65295,839417,1000,14098,1000,16098,2000,1001,14.098,0.0
65296,437632,1000,5432,1000,7432,2000,1001,5.432,0.0
65298,12358,0,160,0,180,20,21,8.0,0.0
65299,24335,46,276,46,368,92,47,6.0,0.0
6530,524746,0,7973,0,8473,500,501,15.946,0.0
65300,165161,260,2350,260,2870,520,261,9.038,0.0
65302,209290,441,2205,441,3087,882,442,5.0,0.0
65303,1572592,1000,35180,1000,37180,2000,1001,35.18,0.0
65304,31303,60,385,60,505,120,61,6.417,0.0
65305,84445,0,1170,0,1300,130,131,9.0,0.0
65306,7259,15,90,15,120,30,16,6.0,0.0
65309,3866,4,39,4,47,8,5,9.75,0.0
6531,52539,0,789,0,830,41,42,19.244,0.0
65310,539461,1000,8988,1000,10988,2000,1001,8.988,0.0
65311,662719,1000,10993,1000,12993,2000,1001,10.993,0.0
65312,193051,109,1753,109,1971,218,110,16.083,0.5
65313,228394,392,3136,392,3920,784,393,8.0,0.5
65315,74227,0,908,0,1020,112,113,8.107,0.0
65316,2289,4,20,4,28,8,5,5.0,0.0
65317,146152,109,1853,109,2071,218,110,17.0,0.0
65318,30351,51,459,51,561,102,52,9.0,0.0
65319,28616,68,340,68,476,136,69,5.0,1.0
6532,348030,0,4500,0,5000,500,501,9.0,0.0
65320,104414,0,1420,0,1570,150,151,9.467,0.0
65322,55173,90,810,90,990,180,91,9.0,0.0
65323,14783,30,210,30,270,60,31,7.0,0.0
65324,244416,531,3186,531,4248,1062,532,6.0,0.0
65325,41136,68,612,68,748,136,69,9.0,0.0
65327,24412,50,350,50,450,100,51,7.0,0.0
65329,460040,0,5036,0,5888,852,853,5.911,0.0
6533,401933,0,6102,0,6602,500,501,12.204,0.5
65330,109463,198,1584,198,1980,396,199,8.0,0.0
65333,11755,17,136,17,170,34,18,8.0,0.0
65336,60669,108,837,108,1053,216,109,7.75,0.0
65337,146280,109,1853,109,2071,218,110,17.0,0.0
65338,64927,120,960,120,1200,240,121,8.0,0.0
65339,7999693,1000,9000,1000,11000,2000,1001,9.0,0.0
6534,99170,0,1541,0,1649,108,109,14.269,0.0
65340,30035,55,437,55,547,110,56,7.945,0.0
65341,47643,108,540,108,756,216,109,5.0,0.0
65342,312079,495,4613,495,5603,990,496,9.319,0.0
65347,446256,1000,6000,1000,8000,2000,1001,6.0,0.0
65348,1340220,1000,21000,1000,23000,2000,1001,21.0,0.0
65349,16151,29,232,29,290,58,30,8.0,0.0
6535,186710,0,2309,0,2518,209,210,11.048,0.0
65352,132766,0,1561,0,1769,208,209,7.505,0.0
65353,256328,450,3798,450,4698,900,451,8.44,0.0
65359,299849,500,4500,500,5500,1000,501,9.0,0.5
6536,440679,0,5284,0,5784,500,501,10.568,0.0
65361,7167,15,89,15,119,30,16,5.933,0.0
65362,7622851,1000,13000,1000,15000,2000,1001,13.0,0.0
65363,145509,109,1853,109,2071,218,110,17.0,0.0
65367,75730,144,1148,144,1436,288,145,7.972,0.0
65368,6031,10,90,10,110,20,11,9.0,0.0
65369,55715,117,585,117,819,234,118,5.0,0.0
6537,26802,0,281,0,338,57,58,4.93,0.0
65372,3618076,1000,7000,1000,9000,2000,1001,7.0,0.0
65375,108772,170,1513,170,1853,340,171,8.9,0.0
65377,175948,252,4032,252,4536,504,253,16.0,0.0
65378,12340,29,145,29,203,58,30,5.0,0.0
65379,42043539,1000,25000,1000,27000,2000,1001,25.0,0.0
6538,39449,0,456,0,513,57,58,8.0,0.0
65380,259596,1000,1000,1000,3000,2000,1001,1.0,0.0
65382,9185,14,111,14,139,28,15,7.929,0.0
65383,4380462,1000,16000,1000,18000,2000,1001,16.0,0.0
65385,1615,4,4,4,12,8,5,1.0,0.0
65386,123867,255,1785,255,2295,510,256,7.0,0.0
65387,689294,1000,8916,1000,10916,2000,1001,8.916,0.0
65388,55690,99,891,99,1089,198,100,9.0,0.0
6539,7696,0,65,0,70,5,6,13.0,0.0
65393,5924095,1000,16973,1000,18973,2000,1001,16.973,0.0
65396,169593,336,2352,336,3024,672,337,7.0,0.0
654,57958,32,256,32,320,64,33,8.0,0.0
6540,39949,0,507,0,528,21,22,24.143,0.5
65400,6607,10,90,10,110,20,11,9.0,0.0
65406,277804,326,4238,326,4890,652,327,13.0,0.0
65407,10120,17,136,17,170,34,18,8.0,0.0
6541,299936,500,5500,500,6500,1000,501,11.0,0.0
65417,67898,145,1015,145,1305,290,146,7.0,0.0
6542,6269,0,48,0,60,12,13,4.0,0.0
65423,107834,170,1292,170,1632,340,171,7.6,0.0
6543,427716,0,8500,0,9000,500,501,17.0,0.5
65434,434691,1000,5998,1000,7998,2000,1001,5.998,0.0
65437,236450,310,3680,310,4300,620,311,11.871,0.0
6544,44932,0,784,0,833,49,50,16.0,0.5
65440,74278,140,808,140,1088,280,141,5.771,0.0
6545,338736,0,4891,0,5391,500,501,9.782,0.5
65452,693219,1000,10000,1000,12000,2000,1001,10.0,0.0
6546,62669,0,590,0,627,37,38,15.946,0.0
65461,70574,172,855,172,1199,344,173,4.971,0.0
65464,2255608,1000,27000,1000,29000,2000,1001,27.0,0.0
6547,36207,36,504,36,576,72,37,14.0,0.0
6548,754561,500,12452,500,13452,1000,501,24.904,0.5
65483,126839,109,1635,109,1853,218,110,15.0,0.0
6549,403145,500,5000,500,6000,1000,501,10.0,0.0
6550,41100,83,332,83,498,166,84,4.0,0.0
6551,379594,0,7000,0,7500,500,501,14.0,0.0
65510,96701,200,1400,200,1800,400,201,7.0,0.0
65511,164187,335,2053,335,2723,670,336,6.128,0.0
65512,63866,64,928,64,1056,128,65,14.5,0.0
65513,1019007,1000,18000,1000,20000,2000,1001,18.0,0.0
65515,454934,662,5281,662,6605,1324,663,7.977,0.0
65516,32728,0,432,0,480,48,49,9.0,0.0
65517,277617,1000,1000,1000,3000,2000,1001,1.0,0.0
65519,562627,1000,6000,1000,8000,2000,1001,6.0,0.0
6552,6732,8,64,8,88,24,18,4.0,0.0
65521,207977,303,2424,303,3030,606,304,8.0,0.0
65522,165505,165,1484,165,1814,330,166,8.994,0.0
65524,653571,1000,7946,1000,9946,2000,1001,7.946,0.5
65526,436783,1000,4042,1000,6042,2000,1001,4.042,0.0
65527,1166128,1000,13607,1000,15607,2000,1001,13.607,0.0
65528,933907,1000,12000,1000,14000,2000,1001,12.0,0.0
65529,37079,60,600,60,720,120,61,10.0,0.0
6553,365351,0,4000,0,4500,500,501,8.0,0.0
65530,132384,119,1304,119,1542,238,120,10.958,0.0
65537,48451,96,568,96,760,192,97,5.917,0.5
65538,643355,1000,6917,1000,8917,2000,1001,6.917,0.0
6554,1146356,0,20356,0,20856,500,501,40.712,0.0
65540,505848,1000,5000,1000,7000,2000,1001,5.0,0.0
65541,277617,1000,1000,1000,3000,2000,1001,1.0,0.0
65542,33640,11,498,11,520,22,12,45.273,0.0
65543,781520,1000,12936,1000,14936,2000,1001,12.936,0.0
65545,1891902,1000,33911,1000,35911,2000,1001,33.911,0.0
65548,11143,38,38,38,114,76,39,1.0,0.0
65549,3473,5,30,5,40,10,6,6.0,0.0
6555,230631,0,3930,0,4323,393,394,10.0,0.0
65551,18141,38,190,38,266,76,39,5.0,0.0
65552,67291,94,964,94,1152,188,95,10.255,0.0
65553,277617,1000,1000,1000,3000,2000,1001,1.0,0.0
65554,408245,561,5048,561,6170,1122,562,8.998,0.0
65555,793497,886,9746,886,11518,1772,887,11.0,0.0
65556,18659,31,213,31,275,62,32,6.871,0.0
6556,2502005,1484,28365,1484,31833,3468,1986,14.297,0.0
65561,13063,15,165,15,195,30,16,11.0,0.0
65566,58949,120,696,120,936,240,121,5.8,0.0
6557,117378,61,1267,61,1412,145,86,15.083,0.0
65574,28750,55,271,55,381,110,56,4.927,0.0
65575,45570,0,534,0,623,89,90,6.0,0.0
65576,29273,62,296,62,420,124,63,4.774,0.5
65579,2002,5,5,5,15,10,6,1.0,0.0
6558,57511,0,1140,0,1254,114,115,10.0,0.0
65581,91184,126,1134,126,1386,252,127,9.0,0.0
65582,186640,662,662,662,1986,1324,663,1.0,0.0
65584,43782,60,540,60,660,120,61,9.0,0.0
65585,49452,61,610,61,732,122,62,10.0,0.5
65586,281618,1000,1000,1000,3000,2000,1001,1.0,0.0
65587,64612,61,690,61,812,122,62,11.311,0.0
6559,276463,0,3500,0,4000,500,501,7.0,0.0
65591,635203,651,7789,651,9091,1302,652,11.965,0.0
65593,146204,274,1914,274,2462,548,275,6.985,0.0
65594,102180,126,1260,126,1512,252,127,10.0,0.0
65595,4772,15,15,15,45,30,16,1.0,0.0
65596,27745,65,259,65,389,130,66,3.985,0.0
65597,109099,243,1204,243,1690,486,244,4.955,0.0
65599,31145,60,300,60,420,120,61,5.0,0.0
6560,10295,0,110,0,126,16,17,6.875,0.0
65600,68901,243,243,243,729,486,244,1.0,0.0
65603,277617,1000,1000,1000,3000,2000,1001,1.0,0.5
65604,17005,34,170,34,238,68,35,5.0,0.5
65605,47685,60,540,60,660,120,61,9.0,0.0
65606,179784,261,2020,261,2542,522,262,7.739,0.0
65609,81340,139,822,139,1100,278,140,5.914,0.0
6561,543185,500,10509,500,11509,1000,501,21.018,0.0
65612,60557,93,697,93,883,186,94,7.495,0.0
65617,77480,138,816,138,1092,276,139,5.913,0.0
65618,555237,1000,6000,1000,8000,2000,1001,6.0,0.0
6562,43166,105,525,105,735,210,106,5.0,0.5
65621,543926,1000,7626,1000,9626,2000,1001,7.626,0.5
65622,14106,48,48,48,144,96,49,1.0,0.0
65624,39232,65,378,65,508,130,66,5.815,0.0
65627,771146,1000,11000,1000,13000,2000,1001,11.0,0.0
65628,17237,60,60,60,180,120,61,1.0,0.0
6563,305567,0,4000,0,4500,500,501,8.0,0.0
65630,277617,1000,1000,1000,3000,2000,1001,1.0,0.0
65631,67135,124,868,124,1116,248,125,7.0,0.0
65632,24215,52,247,52,351,104,53,4.75,1.0
65636,4148,7,35,7,49,14,8,5.0,0.0
65638,281618,1000,1000,1000,3000,2000,1001,1.0,0.0
6564,331560,175,6825,175,7175,350,176,39.0,0.0
65644,14106,48,48,48,144,96,49,1.0,0.0
6566,32189,0,300,0,375,75,76,4.0,0.0
65661,95841,0,1180,0,1376,196,197,6.02,0.6666666666666666
65662,15230,52,52,52,156,104,53,1.0,0.0
65663,23289,48,288,48,384,96,49,6.0,0.0
65664,40593,97,485,97,679,194,98,5.0,0.0
65668,16970,33,201,33,267,66,34,6.091,0.0
6567,315119,0,4500,0,5000,500,501,9.0,0.0
65670,281618,1000,1000,1000,3000,2000,1001,1.0,0.0
65672,2170,3,15,3,21,6,4,5.0,0.0
65675,277617,1000,1000,1000,3000,2000,1001,1.0,0.0
65677,66317,136,816,136,1088,272,137,6.0,0.0
6568,6010,0,66,0,78,12,13,5.5,0.0
65680,39635,62,496,62,620,124,63,8.0,0.0
65681,169896,182,2184,182,2548,364,183,12.0,0.5
65682,70831,156,624,156,936,312,157,4.0,0.0
65683,9048,30,30,30,90,60,31,1.0,0.0
65684,31557,62,372,62,496,124,63,6.0,0.0
65686,537841,1000,7000,1000,9000,2000,1001,7.0,0.0
65687,277617,1000,1000,1000,3000,2000,1001,1.0,0.0
65689,91980,171,1188,171,1530,342,172,6.947,0.0
6569,145504,259,1813,259,2331,518,260,7.0,0.0
65692,7212,15,60,15,90,30,16,4.0,0.0
65693,35519,126,126,126,378,252,127,1.0,0.0
65697,13636,47,47,47,141,94,48,1.0,0.0
65698,33857,120,120,120,360,240,121,1.0,0.0
65699,1012357,1000,13006,1000,15006,2000,1001,13.006,0.0
6570,493501,0,11790,0,12183,393,394,30.0,0.0
65700,2975,5,25,5,35,10,6,5.0,0.0
65701,5938,15,45,15,75,30,16,3.0,0.0
65702,16406,57,57,57,171,114,58,1.0,0.0
65706,162970,170,1651,170,2064,413,243,9.712,0.0
65707,27295,44,308,44,396,88,45,7.0,0.0
65709,33597,46,635,46,727,92,47,13.804,0.0
6571,170221,0,2619,0,2910,291,292,9.0,1.0
65710,281618,1000,1000,1000,3000,2000,1001,1.0,0.0
65711,27486,97,97,97,291,194,98,1.0,0.0
65712,27924,48,390,48,486,96,49,8.125,0.0
65716,7265,24,24,24,72,48,25,1.0,0.0
65719,277617,1000,1000,1000,3000,2000,1001,1.0,0.0
6572,184734,0,3570,0,3780,210,211,17.0,0.0
65722,884729,1000,14662,1000,16662,2000,1001,14.662,0.0
65723,6379,12,60,12,84,24,13,5.0,0.0
65724,121943,438,438,438,1314,876,439,1.0,0.0
65728,14106,48,48,48,144,96,49,1.0,0.0
65729,93459,242,726,242,1210,484,243,3.0,0.0
6573,136947,0,1129,0,1468,339,340,3.33,0.0
65731,36024,126,126,126,378,252,127,1.0,0.0
65739,43208,75,510,75,660,150,76,6.8,0.0
65740,277617,1000,1000,1000,3000,2000,1001,1.0,0.0
65743,8650,29,29,29,87,58,30,1.0,0.0
65745,47445,0,588,0,686,98,99,6.0,0.0
65747,26303,48,328,48,424,96,49,6.833,0.0
6575,361361,500,7130,500,8130,1000,501,14.26,0.0
65750,3305,6,30,6,42,12,7,5.0,0.0
65751,22388,48,240,48,336,96,49,5.0,0.0
65752,281618,1000,1000,1000,3000,2000,1001,1.0,0.0
65753,54639,0,570,0,665,95,96,6.0,0.0
65755,23054,81,81,81,243,162,82,1.0,0.0
6576,181023,0,2252,0,2452,200,201,11.26,0.5
65760,9204,31,31,31,93,62,32,1.0,0.0
65762,277617,1000,1000,1000,3000,2000,1001,1.0,0.0
65763,1309010,1000,18000,1000,20000,2000,1001,18.0,0.0
65764,3342,6,24,6,36,12,7,4.0,0.0
65765,22997,60,240,60,360,120,61,4.0,0.0
65767,73191,262,262,262,786,524,263,1.0,0.0
65768,16354,56,56,56,168,112,57,1.0,0.0
65769,23885,84,84,84,252,168,85,1.0,0.0
6577,105578,0,1240,0,1395,155,156,8.0,0.0
65770,277617,1000,1000,1000,3000,2000,1001,1.0,0.0
65772,277617,1000,1000,1000,3000,2000,1001,1.0,0.0
65775,478966,0,4000,0,5000,1000,1001,4.0,0.0
65777,15575,54,54,54,162,108,55,1.0,0.0
65778,13636,47,47,47,141,94,48,1.0,0.0
65779,17237,60,60,60,180,120,61,1.0,0.0
6578,284056,500,3572,500,4572,1000,501,7.144,0.5
65780,16683,58,58,58,174,116,59,1.0,0.0
65781,16406,57,57,57,171,114,58,1.0,0.0
65785,33944,55,390,55,500,110,56,7.091,0.0
65787,178652,192,2285,192,2669,384,193,11.901,0.0
6579,89624,88,1408,88,1584,176,89,16.0,0.0
65791,281618,1000,1000,1000,3000,2000,1001,1.0,0.0
65792,4316,6,42,6,54,12,7,7.0,0.0
65796,5307,0,40,0,50,10,11,4.0,0.0
65797,5564,6,66,6,78,12,7,11.0,0.0
65799,68901,243,243,243,729,486,244,1.0,0.0
6580,571483,0,8855,0,9240,385,386,23.0,0.0
65800,3397,5,30,5,40,10,6,6.0,0.0
65801,277617,1000,1000,1000,3000,2000,1001,1.0,0.0
65804,15134,38,114,38,190,76,39,3.0,0.0
65805,281618,1000,1000,1000,3000,2000,1001,1.0,0.0
65814,418759,1000,4000,1000,6000,2000,1001,4.0,0.0
65815,95566,61,581,61,737,156,86,9.525,0.0
65816,3941,12,12,12,36,24,13,1.0,0.0
65818,281618,1000,1000,1000,3000,2000,1001,1.0,0.0
65819,17875,29,164,29,222,58,30,5.655,0.0
6582,9850,0,107,0,123,16,17,6.688,0.0
65820,75803,0,922,0,1041,119,120,7.748,0.0
65821,277617,1000,1000,1000,3000,2000,1001,1.0,0.0
65822,82527,144,964,144,1252,288,145,6.694,0.0
65823,36023,70,459,70,599,140,71,6.557,0.0
65824,36024,126,126,126,378,252,127,1.0,0.0
65826,2556,7,7,7,21,14,8,1.0,0.0
65827,114187,410,410,410,1230,820,411,1.0,0.0
6583,31064,0,320,0,400,80,81,4.0,0.0
65831,39752,14,868,14,896,28,15,62.0,0.0
65832,10486,27,81,27,135,54,28,3.0,0.0
65834,277617,1000,1000,1000,3000,2000,1001,1.0,0.0
65835,1787,3,9,3,15,6,4,3.0,0.0
65836,49817,91,637,91,819,182,92,7.0,0.5
65837,2632,5,20,5,30,10,6,4.0,0.0
65838,15413,37,111,37,185,74,38,3.0,0.0
65839,13626,27,162,27,216,54,28,6.0,0.0
6584,125287,197,1143,197,1537,394,198,5.802,0.0
65844,277617,1000,1000,1000,3000,2000,1001,1.0,0.0
65845,4271,13,13,13,39,26,14,1.0,0.0
65848,2291,4,16,4,24,8,5,4.0,0.0
6585,309157,0,4000,0,4500,500,501,8.0,0.0
65851,3110,9,9,9,27,18,10,1.0,0.0
65853,183549,651,651,651,1953,1302,652,1.0,0.0
65854,87318,313,313,313,939,626,314,1.0,0.0
65855,37735,134,134,134,402,268,135,1.0,0.0
65856,2617,5,20,5,30,10,6,4.0,0.0
6586,558146,500,10369,500,11369,1000,501,20.738,0.0
65860,8789,18,72,18,108,36,19,4.0,0.0
65861,281618,1000,1000,1000,3000,2000,1001,1.0,0.0
65863,2556,7,7,7,21,14,8,1.0,0.0
65864,281618,1000,1000,1000,3000,2000,1001,1.0,0.0
65865,277617,1000,1000,1000,3000,2000,1001,1.0,0.0
65866,19453,68,68,68,204,136,69,1.0,0.0
65867,14949,51,51,51,153,102,52,1.0,0.0
6587,4006,0,36,0,42,6,7,6.0,0.0
65870,62098,97,1067,97,1261,194,98,11.0,0.75
65872,115828,410,410,410,1230,820,411,1.0,0.0
65876,25502,45,270,45,360,90,46,6.0,0.0
65877,3147,9,9,9,27,18,10,1.0,0.0
65878,277617,1000,1000,1000,3000,2000,1001,1.0,0.0
65879,27486,97,97,97,291,194,98,1.0,0.75
6588,516623,0,9000,0,9500,500,501,18.0,0.0
65880,15021,52,52,52,156,104,53,1.0,0.0
65881,277617,1000,1000,1000,3000,2000,1001,1.0,0.0
65883,39120,139,139,139,417,278,140,1.0,0.0
65886,3387,10,10,10,30,20,11,1.0,0.0
65887,11095,19,142,19,180,38,20,7.474,0.0
65888,6157,20,20,20,60,40,21,1.0,0.0
65893,348617,1000,2000,1000,4000,2000,1001,2.0,0.0
65894,27209,96,96,96,288,192,97,1.0,0.0
65896,850278,1000,12000,1000,14000,2000,1001,12.0,0.0
65897,281618,1000,1000,1000,3000,2000,1001,1.0,0.0
6590,455244,0,8186,0,8686,500,501,16.372,0.0
65902,15852,55,55,55,165,110,56,1.0,0.0
65905,277617,1000,1000,1000,3000,2000,1001,1.0,0.0
65906,277617,1000,1000,1000,3000,2000,1001,1.0,0.0
65908,68770,146,876,146,1168,292,147,6.0,0.0
65909,4490,7,41,7,55,14,8,5.857,0.0
6591,3337120,0,30262,0,30762,500,501,60.524,0.0
65911,23945,45,270,45,360,90,46,6.0,0.0
65912,2833,8,8,8,24,16,9,1.0,0.0
65914,40072,84,504,84,672,168,85,6.0,0.0
65915,281618,1000,1000,1000,3000,2000,1001,1.0,0.0
65916,24725,52,312,52,416,104,53,6.0,0.0
65917,18068,63,63,63,189,126,64,1.0,0.0
65919,772746,1000,12000,1000,14000,2000,1001,12.0,0.0
65920,281618,1000,1000,1000,3000,2000,1001,1.0,0.0
65922,4495,14,14,14,42,28,15,1.0,0.0
65923,277617,1000,1000,1000,3000,2000,1001,1.0,0.0
65924,38903,95,285,95,475,190,96,3.0,0.0
65925,163493,588,588,588,1764,1176,589,1.0,0.0
65926,9481,32,32,32,96,64,33,1.0,0.0
65931,7265,24,24,24,72,48,25,1.0,0.0
65932,277617,1000,1000,1000,3000,2000,1001,1.0,0.0
65934,249584,886,886,886,2658,1772,887,1.0,0.0
65935,14095,15,120,15,150,30,16,8.0,0.0
65936,5148,10,50,10,70,20,11,5.0,0.0
65937,16683,58,58,58,174,116,59,1.0,0.0
65939,27763,98,98,98,294,196,99,1.0,0.0
6594,32433,0,408,0,459,51,52,8.0,0.0
65942,2279,6,6,6,18,12,7,1.0,0.0
65943,27186,72,216,72,360,144,73,3.0,0.0
65944,5603,18,18,18,54,36,19,1.0,0.0
65949,520725,1000,7000,1000,9000,2000,1001,7.0,0.0
65950,33857,120,120,120,360,240,121,1.0,0.0
65951,33857,120,120,120,360,240,121,1.0,0.0
65953,281618,1000,1000,1000,3000,2000,1001,1.0,0.0
65955,85933,308,308,308,924,616,309,1.0,0.0
65956,4959,11,44,11,66,22,12,4.0,0.0
65957,670933,0,9000,0,10000,1000,1001,9.0,0.0
65958,56256,198,198,198,594,396,199,1.0,0.0
65959,5603,18,18,18,54,36,19,1.0,0.0
6596,10302,0,189,0,194,5,6,37.8,1.0
65960,1461,3,3,3,9,6,4,1.0,0.0
65961,4811,12,36,12,60,24,13,3.0,0.0
65963,98737,260,780,260,1300,520,261,3.0,0.0
65964,281618,1000,1000,1000,3000,2000,1001,1.0,0.0
65966,2556,7,7,7,21,14,8,1.0,0.5
65968,703738,1000,6946,1000,8946,2000,1001,6.946,0.0
65969,17237,60,60,60,180,120,61,1.0,0.0
65970,27875,97,97,97,291,194,98,1.0,0.0
65973,277617,1000,1000,1000,3000,2000,1001,1.0,0.0
65974,548512,1000,6000,1000,8000,2000,1001,6.0,0.0
65975,68728,76,914,76,1066,152,77,12.026,0.0
65976,4279,5,45,5,55,10,6,9.0,0.0
65978,3347,5,35,5,45,10,6,7.0,0.0
6598,70716,0,1344,0,1428,84,85,16.0,0.0
65980,15852,55,55,55,165,110,56,1.0,0.0
65984,33857,120,120,120,360,240,121,1.0,0.0
65986,37735,134,134,134,402,268,135,1.0,0.0
65989,25824,91,91,91,273,182,92,1.0,0.0
65991,16735,32,189,32,253,64,33,5.906,0.0
65992,3664,11,11,11,33,22,12,1.0,0.0
65993,277617,1000,1000,1000,3000,2000,1001,1.0,0.0
65994,93751,119,1308,119,1546,238,120,10.992,0.0
65995,281618,1000,1000,1000,3000,2000,1001,1.0,0.0
65996,28156,98,98,98,294,196,99,1.0,0.0
65997,916826,1000,6000,1000,8000,2000,1001,6.0,0.0
65998,25854,61,244,61,366,122,62,4.0,0.0
65999,277617,1000,1000,1000,3000,2000,1001,1.0,0.0
66,44966,182,458,182,776,318,186,3.343,0.0
6600,1454001,500,19673,500,20673,1000,501,39.346,0.0
66000,10744,19,114,19,152,38,20,6.0,0.0
66007,8373,28,28,28,84,56,29,1.0,0.0
66008,277617,1000,1000,1000,3000,2000,1001,1.0,0.0
66009,8373,28,28,28,84,56,29,1.0,0.0
6601,622620,0,15000,0,15500,500,501,30.0,0.0
66010,25270,89,89,89,267,178,90,1.0,0.0
66011,5787,11,55,11,77,22,12,5.0,0.0
66012,3904,7,35,7,49,14,8,5.0,0.0
66013,38289,136,136,136,408,272,137,1.0,0.0
66014,5318,10,49,10,69,20,11,4.9,0.0
66015,1619,3,9,3,15,6,4,3.0,0.0
66017,92783,99,1384,99,1582,198,100,13.98,0.0
66018,16129,56,56,56,168,112,57,1.0,0.0
6602,289307,0,5000,0,5500,500,501,10.0,0.0
66020,3664,11,11,11,33,22,12,1.0,0.0
66021,55694,196,196,196,588,392,197,1.0,0.0
66022,3072,0,29,0,34,5,6,5.8,0.0
66023,17514,61,61,61,183,122,62,1.0,0.0
66025,277617,1000,1000,1000,3000,2000,1001,1.0,0.0
66026,29702,105,105,105,315,210,106,1.0,0.0
66028,10953,20,140,20,180,40,21,7.0,0.0
66029,23941,83,83,83,249,166,84,1.0,0.0
6603,1265805,0,13882,0,14188,306,307,45.366,0.0
66031,16073,55,55,55,165,110,56,1.0,0.0
66032,9481,32,32,32,96,64,33,1.0,0.0
66034,277617,1000,1000,1000,3000,2000,1001,1.0,0.0
66035,277617,1000,1000,1000,3000,2000,1001,1.0,0.0
66036,20007,70,70,70,210,140,71,1.0,0.0
66037,56571,202,202,202,606,404,203,1.0,0.0
6604,88282,0,1568,0,1666,98,99,16.0,0.5
66041,13636,47,47,47,141,94,48,1.0,0.0
66042,23608,83,83,83,249,166,84,1.0,0.0
66044,26932,95,95,95,285,190,96,1.0,0.0
66045,277617,1000,1000,1000,3000,2000,1001,1.0,0.0
66046,348617,1000,2000,1000,4000,2000,1001,2.0,0.0
6605,242539,0,4198,0,4420,222,223,18.91,0.5
66050,176235,634,634,634,1902,1268,635,1.0,0.0
66051,2023,5,5,5,15,10,6,1.0,0.0
66052,3664,11,11,11,33,22,12,1.0,0.0
66053,26033,72,216,72,360,144,73,3.0,0.0
66056,277617,1000,1000,1000,3000,2000,1001,1.0,0.0
66057,35519,126,126,126,378,252,127,1.0,0.0
66058,3567,4,40,4,48,8,5,10.0,0.0
66059,4422,9,45,9,63,18,10,5.0,0.0
6606,652805,0,9500,0,10000,500,501,19.0,0.0
66061,277617,1000,1000,1000,3000,2000,1001,1.0,0.0
66062,51760,182,182,182,546,364,183,1.0,0.0
66063,40505,144,144,144,432,288,145,1.0,0.0
66064,15575,54,54,54,162,108,55,1.0,0.0
66065,2279,6,6,6,18,12,7,1.0,0.0
66066,281618,1000,1000,1000,3000,2000,1001,1.0,0.0
66067,33767,77,314,77,468,154,78,4.078,0.0
66068,26465,72,216,72,360,144,73,3.0,0.0
66069,2641596,1000,22115,1000,24115,2000,1001,22.115,1.0
6607,353699,0,5500,0,6000,500,501,11.0,0.0
66070,55789,111,444,111,666,222,112,4.0,0.0
66071,2556,7,7,7,21,14,8,1.0,0.0
66072,281618,1000,1000,1000,3000,2000,1001,1.0,0.0
66073,2279,6,6,6,18,12,7,1.0,0.0
66074,114142,404,404,404,1212,808,405,1.0,0.0
66075,462257,1000,5000,1000,7000,2000,1001,5.0,0.0
66076,27486,97,97,97,291,194,98,1.0,0.5
66077,2417,5,15,5,25,10,6,3.0,0.0
66078,16406,57,57,57,171,114,58,1.0,0.0
66079,13359,46,46,46,138,92,47,1.0,0.0
6608,425423,0,8445,0,8945,500,501,16.89,0.0
66080,51031,182,182,182,546,364,183,1.0,0.0
66081,615256,39,156,39,234,78,40,4.0,0.0
66082,158259,561,561,561,1683,1122,562,1.0,0.0
66083,20458,42,198,42,282,84,43,4.714,0.0
66084,27486,97,97,97,291,194,98,1.0,1.0
66085,944589,1000,12991,1000,14991,2000,1001,12.991,0.0
66087,3110,9,9,9,27,18,10,1.0,0.0
66088,26932,95,95,95,285,190,96,1.0,0.0
66089,277617,1000,1000,1000,3000,2000,1001,1.0,0.0
6609,82705,0,1008,0,1120,112,113,9.0,0.0
66090,396864,1000,3000,1000,5000,2000,1001,3.0,0.0
66091,121167,429,429,429,1287,858,430,1.0,0.0
66093,6607,13,51,13,77,26,14,3.923,0.0
66094,265162,339,4294,339,4972,678,340,12.667,0.0
66095,7153408,530,5264,530,6324,1060,531,9.932,0.0
66096,54909,196,196,196,588,392,197,1.0,0.0
66097,24716,87,87,87,261,174,88,1.0,0.0
6610,298381,469,4221,469,5159,938,470,9.0,0.0
66100,27486,97,97,97,291,194,98,1.0,0.0
66101,13636,47,47,47,141,94,48,1.0,0.0
66103,20563,30,270,30,330,60,31,9.0,0.0
66104,23507,47,282,47,376,94,48,6.0,0.0
66105,9233,24,72,24,120,48,25,3.0,0.0
66106,277617,1000,1000,1000,3000,2000,1001,1.0,0.0
66107,18450,48,144,48,240,96,49,3.0,0.0
66108,13636,47,47,47,141,94,48,1.0,0.0
66109,277617,1000,1000,1000,3000,2000,1001,1.0,0.0
6611,1123097,0,17000,0,17500,500,501,34.0,0.0
66110,13636,47,47,47,141,94,48,1.0,0.0
66112,3110,9,9,9,27,18,10,1.0,0.0
66113,35519,126,126,126,378,252,127,1.0,0.0
66114,2345957,1000,22092,1000,24092,2000,1001,22.092,0.0
66115,3664,11,11,11,33,22,12,1.0,0.0
66116,39434,105,315,105,525,210,106,3.0,0.0
66117,3724,8,26,8,42,16,9,3.25,0.0
66118,16682,22,154,22,242,88,67,7.0,0.0
66119,325773,962,1924,962,3848,1924,963,2.0,0.0
6612,1799047,0,23000,0,23500,500,501,46.0,0.0
66120,108647,390,390,390,1170,780,391,1.0,0.0
66121,5223,8,55,8,71,16,9,6.875,0.0
66122,19824,0,245,0,280,35,36,7.0,0.0
66124,40505,144,144,144,432,288,145,1.0,0.0
66125,5815,10,60,10,80,20,11,6.0,0.0
66126,12982,44,44,44,132,88,45,1.0,0.0
66127,56571,202,202,202,606,404,203,1.0,0.0
66129,25270,89,89,89,267,178,90,1.0,0.0
6613,257314,0,3377,0,3877,500,501,6.754,0.0
66130,41082,144,144,144,432,288,145,1.0,0.0
66131,5909,12,58,12,82,24,13,4.833,0.0
66133,34134,121,121,121,363,242,122,1.0,0.0
66134,1448,3,3,3,9,6,4,1.0,0.0
66135,4368,8,37,8,53,16,9,4.625,0.0
66136,24993,88,88,88,264,176,89,1.0,0.0
66137,3428,10,10,10,30,20,11,1.0,0.0
66138,45175,111,333,111,555,222,112,3.0,0.0
66139,29897,72,288,72,432,144,73,4.0,0.0
66140,121167,429,429,429,1287,858,430,1.0,0.0
66141,33694,77,318,77,472,154,78,4.13,0.0
66142,277617,1000,1000,1000,3000,2000,1001,1.0,0.0
66144,277617,1000,1000,1000,3000,2000,1001,1.0,0.0
66145,277617,1000,1000,1000,3000,2000,1001,1.0,0.0
66146,27875,97,97,97,291,194,98,1.0,0.0
66147,18345,64,64,64,192,128,65,1.0,0.0
66148,56571,202,202,202,606,404,203,1.0,0.0
66149,17237,60,60,60,180,120,61,1.0,0.0
6615,3900,0,36,0,45,9,10,4.0,0.0
66150,8767,29,29,29,87,58,30,1.0,0.0
66152,16683,58,58,58,174,116,59,1.0,0.0
66153,281618,1000,1000,1000,3000,2000,1001,1.0,0.0
66156,277617,1000,1000,1000,3000,2000,1001,1.0,0.0
66157,277617,1000,1000,1000,3000,2000,1001,1.0,0.0
66158,281618,1000,1000,1000,3000,2000,1001,1.0,0.0
66160,98098,184,1277,184,1645,368,185,6.94,0.0
66164,277617,1000,1000,1000,3000,2000,1001,1.0,0.0
66166,8840,14,70,14,98,28,15,5.0,0.0
6617,33832,0,408,0,459,51,52,8.0,0.0
66171,19467,24,288,24,336,48,25,12.0,0.0
66172,4552,14,14,14,42,28,15,1.0,0.0
66173,5477,10,60,10,80,20,11,6.0,0.0
66175,77612,274,274,274,822,548,275,1.0,0.0
66176,8927,30,30,30,90,60,31,1.0,0.0
66177,1325000,1000,26000,1000,28000,2000,1001,26.0,0.0
66178,24993,88,88,88,264,176,89,1.0,0.0
66179,6199,13,52,13,78,26,14,4.0,0.0
66181,3453009,1000,12386,1000,14386,2000,1001,12.386,0.0
66184,3574,5,30,5,40,10,6,6.0,0.0
66185,4833,15,15,15,45,30,16,1.0,0.0
66186,281618,1000,1000,1000,3000,2000,1001,1.0,0.0
66187,2117,4,12,4,20,8,5,3.0,0.0
66188,2002,5,5,5,15,10,6,1.0,0.0
66189,40505,144,144,144,432,288,145,1.0,0.0
6619,365134,0,7140,0,7560,420,421,17.0,0.0
66190,243278,0,2299,0,2874,575,576,3.998,0.0
66191,35519,126,126,126,378,252,127,1.0,0.0
66193,961436,1000,15992,1000,17992,2000,1001,15.992,1.0
66194,5049,16,16,16,48,32,17,1.0,0.0
66195,11259,14,140,14,168,28,15,10.0,0.0
66197,54909,196,196,196,588,392,197,1.0,0.0
66198,26823,72,216,72,360,144,73,3.0,0.0
66199,61795,181,362,181,724,362,182,2.0,0.0
6620,458750,0,8500,0,9000,500,501,17.0,0.0
66200,26915,54,378,54,486,108,55,7.0,0.0
66205,16683,58,58,58,174,116,59,1.0,0.0
66207,108370,389,389,389,1167,778,390,1.0,0.0
66209,277617,1000,1000,1000,3000,2000,1001,1.0,0.0
6621,2286996,0,27999,0,28499,500,501,55.998,0.0
66211,277617,1000,1000,1000,3000,2000,1001,1.0,0.0
66213,17895,30,183,30,243,60,31,6.1,0.0
66214,29964,72,288,72,432,144,73,4.0,0.0
66215,277617,1000,1000,1000,3000,2000,1001,1.0,0.0
66216,281618,1000,1000,1000,3000,2000,1001,1.0,0.0
66217,6238,9,63,9,81,18,10,7.0,0.0
66218,27105,72,216,72,360,144,73,3.0,0.0
66219,32681,60,420,60,540,120,61,7.0,0.0
6622,420204,0,4903,0,5403,500,501,9.806,0.0
66220,22506,58,174,58,290,116,59,3.0,0.0
66221,281618,1000,1000,1000,3000,2000,1001,1.0,0.0
66222,277617,1000,1000,1000,3000,2000,1001,1.0,0.0
66223,21771,42,294,42,378,84,43,7.0,0.0
66224,17759,61,61,61,183,122,62,1.0,0.0
66225,277617,1000,1000,1000,3000,2000,1001,1.0,0.0
66227,112525,404,404,404,1212,808,405,1.0,0.0
66229,26344,61,244,61,366,122,62,4.0,0.0
66231,54909,196,196,196,588,392,197,1.0,0.0
66232,277617,1000,1000,1000,3000,2000,1001,1.0,0.0
66235,25939,72,216,72,360,144,73,3.0,0.0
66236,12251,42,42,42,126,84,43,1.0,0.0
66237,26378,93,93,93,279,186,94,1.0,0.0
66238,29116,72,288,72,432,144,73,4.0,0.0
6624,559942,0,8919,0,9378,459,460,19.431,0.0
66242,26428,72,216,72,360,144,73,3.0,0.0
66244,56571,202,202,202,606,404,203,1.0,0.0
66245,277617,1000,1000,1000,3000,2000,1001,1.0,0.0
66246,2304,6,6,6,18,12,7,1.0,0.0
66247,2002,5,5,5,15,10,6,1.0,0.0
66248,3333,5,30,5,40,10,6,6.0,0.0
6625,5339,5,85,5,95,10,6,17.0,0.0
66253,277617,1000,1000,1000,3000,2000,1001,1.0,0.0
66254,84412,148,1036,148,1332,296,149,7.0,0.0
66256,277617,1000,1000,1000,3000,2000,1001,1.0,0.0
6626,382449,0,8002,0,8502,500,501,16.004,0.0
66260,909082,1000,15536,1000,17536,2000,1001,15.536,0.0
66261,1091218,1000,14141,1000,16141,2000,1001,14.141,0.0
66262,2002,5,5,5,15,10,6,1.0,1.0
66264,4621,9,36,9,54,18,10,4.0,0.0
6627,507054,0,6000,0,6500,500,501,12.0,0.0
66270,5526,7,51,7,65,14,8,7.286,0.0
66274,25720,72,216,72,360,144,73,3.0,0.0
66275,281618,1000,1000,1000,3000,2000,1001,1.0,0.0
66278,16916,58,58,58,174,116,59,1.0,0.0
66279,277617,1000,1000,1000,3000,2000,1001,1.0,0.0
6628,743836,0,17287,0,17787,500,501,34.574,0.0
66281,1985,3,15,3,21,6,4,5.0,0.0
66282,16916,58,58,58,174,116,59,1.0,0.0
66285,52409,120,600,120,840,240,121,5.0,0.0
66287,158259,561,561,561,1683,1122,562,1.0,0.0
6629,362517,0,6000,0,6500,500,501,12.0,0.0
66292,79598,120,801,120,1041,240,121,6.675,0.0
66293,10035,34,34,34,102,68,35,1.0,0.0
66297,3110,9,9,9,27,18,10,1.0,0.0
66298,45104,61,525,61,647,122,62,8.607,0.0
6630,225200,0,3850,0,4235,385,386,10.0,0.0
66300,2556,7,7,7,21,14,8,1.0,0.0
66305,12251,42,42,42,126,84,43,1.0,1.0
66308,86764,311,311,311,933,622,312,1.0,0.0
66314,67928,243,243,243,729,486,244,1.0,0.0
66319,1696,3,9,3,15,6,4,3.0,0.0
6632,243148,140,2890,140,3218,328,190,15.372,0.0
66320,2815,6,18,6,30,12,7,3.0,0.0
66321,83715,189,756,189,1134,378,190,4.0,0.0
66323,202085,182,1145,182,1509,364,183,6.291,0.0
66325,277617,1000,1000,1000,3000,2000,1001,1.0,0.0
66326,8927,30,30,30,90,60,31,1.0,0.0
66327,3787920,124,992,124,1240,248,125,8.0,0.0
66328,55694,196,196,196,588,392,197,1.0,0.0
6633,171518,0,2357,0,2567,210,211,11.224,0.0
66330,16991,39,195,39,273,78,40,5.0,0.0
66334,277617,1000,1000,1000,3000,2000,1001,1.0,0.0
66335,86764,311,311,311,933,622,312,1.0,0.0
66336,25614,61,244,61,366,122,62,4.0,0.0
66337,37229,68,476,68,612,136,69,7.0,0.0
66340,15852,55,55,55,165,110,56,1.0,0.0
66342,23944,60,240,60,360,120,61,4.0,0.0
66343,281618,1000,1000,1000,3000,2000,1001,1.0,0.0
66344,28040,99,99,99,297,198,100,1.0,0.0
66345,1373482,1000,10784,1000,12784,2000,1001,10.784,0.0
66347,2279,6,6,6,18,12,7,1.0,0.0
66349,2002,5,5,5,15,10,6,1.0,0.0
6635,339953,0,4500,0,5000,500,501,9.0,0.0
66350,29521,72,288,72,432,144,73,4.0,0.0
66352,11856,28,112,28,168,56,29,4.0,0.0
66354,2743,5,20,5,30,10,6,4.0,0.0
66355,23159,63,189,63,315,126,64,3.0,0.0
66362,47885,128,384,128,640,256,129,3.0,0.0
66365,86764,311,311,311,933,622,312,1.0,0.0
66368,83163,298,298,298,894,596,299,1.0,0.0
6637,357706,0,6000,0,6500,500,501,12.0,0.0
66370,86764,311,311,311,933,622,312,1.0,0.0
66372,17754,48,144,48,240,96,49,3.0,0.0
66374,3873072,24,216,24,264,48,25,9.0,0.0
66376,86764,311,311,311,933,622,312,1.0,0.0
66377,86764,311,311,311,933,622,312,1.0,0.0
66379,16916,58,58,58,174,116,59,1.0,0.0
6638,273892,0,3926,0,4426,500,501,7.852,0.0
66381,3570,7,28,7,42,14,8,4.0,0.0
66382,2705236,158,3792,158,4108,316,159,24.0,0.0
66383,7265,24,24,24,72,48,25,1.0,0.0
66384,51760,182,182,182,546,364,183,1.0,0.0
66385,3941,12,12,12,36,24,13,1.0,0.0
66386,53306,38,304,38,409,105,62,8.0,0.0
66389,2556,7,7,7,21,14,8,1.0,0.0
6639,619179,0,9295,0,9795,500,501,18.59,0.0
66390,277617,1000,1000,1000,3000,2000,1001,1.0,0.0
66392,16335,24,240,24,288,48,25,10.0,0.0
66393,40505,144,144,144,432,288,145,1.0,0.0
66394,2145,4,16,4,24,8,5,4.0,0.0
66398,13913,48,48,48,144,96,49,1.0,0.0
66399,249584,886,886,886,2658,1772,887,1.0,0.0
6640,106879,0,1323,0,1470,147,148,9.0,0.0
66400,2607355,6,158,6,170,12,7,26.333,0.0
66401,1753,3,9,3,15,6,4,3.0,0.0
66403,14449597,11,293,11,315,22,12,26.636,0.0
66404,6157,20,20,20,60,40,21,1.0,0.0
66405,213353,768,768,768,2304,1536,769,1.0,0.0
66409,4495,14,14,14,42,28,15,1.0,0.0
66412,1359806,932,14639,932,16503,1864,933,15.707,0.0
66413,1448,3,3,3,9,6,4,1.0,0.0
66422,277617,1000,1000,1000,3000,2000,1001,1.0,0.0
66424,277617,1000,1000,1000,3000,2000,1001,1.0,0.0
66430,279651,993,993,993,2979,1986,994,1.0,0.0
66431,25824,91,91,91,273,182,92,1.0,0.0
66432,25270,89,89,89,267,178,90,1.0,0.0
66433,159892,575,575,575,1725,1150,576,1.0,0.0
66434,9125369,1000,12694,1000,14694,2000,1001,12.694,0.0
66435,277617,1000,1000,1000,3000,2000,1001,1.0,0.0
66436,2145,4,16,4,24,8,5,4.0,0.0
66437,20846,24,258,24,306,48,25,10.75,0.0
66438,13913,48,48,48,144,96,49,1.0,0.0
66439,905967,414,12079,414,12907,828,415,29.176,0.5
6644,549717,0,8499,0,8999,500,501,16.998,0.0
66440,277617,1000,1000,1000,3000,2000,1001,1.0,0.0
66444,277617,1000,1000,1000,3000,2000,1001,1.0,0.0
66445,50754,181,181,181,543,362,182,1.0,0.0
66446,56334,125,625,125,875,250,126,5.0,0.0
66449,17237,60,60,60,180,120,61,1.0,0.0
6645,2274049,0,14068,0,14568,500,501,28.136,0.0
66450,277617,1000,1000,1000,3000,2000,1001,1.0,0.0
66451,2556,7,7,7,21,14,8,1.0,0.0
66453,285119,172,1892,172,2236,344,173,11.0,0.0
66456,277617,1000,1000,1000,3000,2000,1001,1.0,0.0
66457,24679,55,218,55,328,110,56,3.964,0.0
66458,615611,509,10374,509,11392,1018,510,20.381,0.0
66462,2023,5,5,5,15,10,6,1.0,0.0
66463,3684,7,28,7,42,14,8,4.0,0.0
66464,702943,1000,8000,1000,10000,2000,1001,8.0,0.0
6647,44888,0,784,0,833,49,50,16.0,0.0
66471,553785,1000,8112,1000,10112,2000,1001,8.112,0.0
66474,5818502,389,3897,389,4675,778,390,10.018,0.0
66478,95451,39,1287,39,1365,78,40,33.0,0.0
66485,13913,48,48,48,144,96,49,1.0,0.0
6649,880891,500,12403,500,13403,1000,501,24.806,0.0
66497,2599059,1000,18611,1000,20611,2000,1001,18.611,0.0
66498,1068080,541,5423,541,6505,1082,542,10.024,0.0
6650,206648,0,3000,0,3500,500,501,6.0,0.0
66500,13821,29,169,29,227,58,30,5.828,0.0
66501,5870629,175,2468,175,2818,350,176,14.103,0.0
66502,2947402,1000,11575,1000,13575,2000,1001,11.575,0.0
66505,14744,51,51,51,153,102,52,1.0,0.0
6651,269274,0,3456,0,3888,432,433,8.0,1.0
66512,9329,31,31,31,93,62,32,1.0,0.0
66513,17478,60,60,60,180,120,61,1.0,0.0
66515,20284,71,71,71,213,142,72,1.0,0.0
66516,15021,52,52,52,156,104,53,1.0,0.0
66518,1350072,1000,22255,1000,24255,2000,1001,22.255,0.0
66519,10603,17,119,17,153,34,18,7.0,1.0
6652,186195,0,1999,0,2499,500,501,3.998,0.0
66525,3690550,1000,7017,1000,9017,2000,1001,7.017,0.0
66526,16163133,1000,8046,1000,10046,2000,1001,8.046,0.5
66529,277617,1000,1000,1000,3000,2000,1001,1.0,0.0
6653,7889,0,44,0,66,22,22,4.0,0.0
66532,673934,1000,8832,1000,10832,2000,1001,8.832,0.0
66536,186207,670,670,670,2010,1340,671,1.0,0.0
66537,3191472,93,855,93,1041,186,94,9.194,0.0
66538,10161967,780,5460,780,7020,1560,781,7.0,0.0
66539,792466,545,3270,545,4360,1090,546,6.0,0.0
6654,345059,500,3603,500,4603,1000,501,7.206,0.0
66540,716637,1000,10240,1000,12240,2000,1001,10.24,0.0
66543,486509,718,7479,718,8915,1436,719,10.416,0.0
66545,38817350,645,11742,645,13032,1290,646,18.205,0.0
66546,277617,1000,1000,1000,3000,2000,1001,1.0,0.0
6655,369880,0,5479,0,5979,500,501,10.958,0.5
66551,10035,34,34,34,102,68,35,1.0,0.0
66552,3569623,221,1547,221,1989,442,222,7.0,0.0
66553,63190,47,558,47,652,94,48,11.872,0.0
66558,266745,34,303,34,371,68,35,8.912,0.0
66559,281618,1000,1000,1000,3000,2000,1001,1.0,1.0
6656,28488,0,275,0,330,55,56,5.0,0.0
66560,16406,57,57,57,171,114,58,1.0,0.5
66561,8927,30,30,30,90,60,31,1.0,0.0
66564,4245653,365,3285,365,4015,730,366,9.0,0.0
66565,13636,47,47,47,141,94,48,1.0,0.0
6657,157149,0,2160,0,2216,56,57,38.571,0.0
66570,1070450,52,780,52,884,104,53,15.0,0.0
66571,40199266,99,876,99,1074,198,100,8.848,0.0
6658,1580641,500,21205,500,22205,1000,501,42.41,0.0
66581,281618,1000,1000,1000,3000,2000,1001,1.0,0.0
66583,277617,1000,1000,1000,3000,2000,1001,1.0,0.0
66584,1083812,1000,7000,1000,9000,2000,1001,7.0,0.0
66585,103183,365,365,365,1095,730,366,1.0,0.0
66586,277617,1000,1000,1000,3000,2000,1001,1.0,0.0
6659,623829,0,10500,0,11000,500,501,21.0,0.0
66591,2465458,17,153,17,187,34,18,9.0,0.0
66597,281618,1000,1000,1000,3000,2000,1001,1.0,0.0
66598,797325,20,200,20,240,40,21,10.0,0.0
66599,3520512,1000,60439,1000,62439,2000,1001,60.439,0.0
6660,155356,0,1600,0,1920,320,321,5.0,0.0
66602,281618,1000,1000,1000,3000,2000,1001,1.0,0.0
66603,277617,1000,1000,1000,3000,2000,1001,1.0,0.0
66612,643967,29,174,29,232,58,30,6.0,0.0
66615,277617,1000,1000,1000,3000,2000,1001,1.0,0.0
6662,339928,0,4500,0,5000,500,501,9.0,0.0
66629,152639,541,541,541,1623,1082,542,1.0,0.0
6663,409389,500,8000,500,9000,1000,501,16.0,0.0
66632,37917779,1000,9322,1000,11322,2000,1001,9.322,0.0
66638,13596,30,150,30,210,60,31,5.0,0.0
6664,427123,0,8500,0,9000,500,501,17.0,0.0
6665,433988,0,8500,0,9000,500,501,17.0,0.0
66650,1407188,1000,16799,1000,18799,2000,1001,16.799,0.0
6666,353940,0,1000,0,1500,500,501,2.0,0.0
66669,560866,1,8,1,10,2,2,8.0,0.0
6667,624551,0,6942,0,7442,500,501,13.884,0.0
66670,281618,1000,1000,1000,3000,2000,1001,1.0,0.0
66672,1774,2,12,2,16,4,3,6.0,0.0
66677,277617,1000,1000,1000,3000,2000,1001,1.0,0.0
6668,361066,0,6000,0,6500,500,501,12.0,0.0
66687,277617,1000,1000,1000,3000,2000,1001,1.0,0.0
6669,65590,0,550,0,660,110,111,5.0,0.0
66692,298155,330,2111,330,2771,660,331,6.397,0.0
66694,998446,868,6076,868,7812,1736,869,7.0,0.0
66695,1523969,1000,25955,1000,27955,2000,1001,25.955,0.0
66698,5326,17,17,17,51,34,18,1.0,1.0
6670,1262,0,6,0,8,2,3,3.0,0.0
66700,454821,414,4967,414,5795,828,415,11.998,0.0
66704,205446,1,8,1,10,2,2,8.0,0.0
66711,11721,16,186,16,218,32,17,11.625,0.0
66712,2042385,231,2541,231,3003,462,232,11.0,0.0
66717,5037791,1000,8197,1000,10197,2000,1001,8.197,0.0
6672,429263,0,8500,0,9000,500,501,17.0,0.0
66723,277617,1000,1000,1000,3000,2000,1001,1.0,0.0
66726,340657,279,5328,279,5886,558,280,19.097,0.0
66729,277617,1000,1000,1000,3000,2000,1001,1.0,0.0
6673,864426,0,18239,0,18739,500,501,36.478,0.0
66730,832437,1000,10000,1000,12000,2000,1001,10.0,0.0
66735,989185,1000,5984,1000,7984,2000,1001,5.984,0.0
66736,553176,1000,6688,1000,8688,2000,1001,6.688,0.0
66737,931608,1000,13648,1000,15648,2000,1001,13.648,0.0
66738,41649,42,594,42,678,84,43,14.143,0.0
6674,883459,0,15500,0,16000,500,501,31.0,0.0
66746,115295,414,414,414,1242,828,415,1.0,0.0
66748,98590,120,1413,120,1653,240,121,11.775,0.0
66749,13140557,1000,6414,1000,8414,2000,1001,6.414,0.0
6675,351806,0,4500,0,5000,500,501,9.0,0.0
66754,1105701,670,18520,670,19860,1340,671,27.642,0.0
66758,5049,16,16,16,48,32,17,1.0,0.0
66761,30710271,1000,6000,1000,8000,2000,1001,6.0,0.0
66763,894651,1000,10000,1000,12000,2000,1001,10.0,0.0
66764,33777,30,568,30,628,60,31,18.933,0.0
66766,142642,2,16,2,20,4,3,8.0,0.0
66768,3221263,1000,7083,1000,9083,2000,1001,7.083,0.0
66769,7265,24,24,24,72,48,25,1.0,0.0
6677,366163,500,6999,500,7999,1000,501,13.998,0.0
66770,5440052,31,213,31,275,62,32,6.871,0.0
66773,562171,1000,5000,1000,7000,2000,1001,5.0,0.5
66779,6050340,90,2389,90,2569,180,91,26.544,0.0
6678,417984,0,7500,0,8000,500,501,15.0,0.5
66780,281618,1000,1000,1000,3000,2000,1001,1.0,0.0
66782,15443,24,216,24,264,48,25,9.0,0.0
66786,1327203,54,378,54,486,108,55,7.0,0.0
66787,25014,45,305,45,395,90,46,6.778,0.0
66788,1683638,1000,9182,1000,11182,2000,1001,9.182,0.0
6679,12495,0,84,0,96,12,13,7.0,0.0
66793,7723,12,56,12,80,24,13,4.667,0.0
66794,1661,1,3,1,6,3,3,3.0,0.0
66795,3360,4,16,4,28,12,9,4.0,0.0
66797,1787617,1614,24088,1614,27316,3228,1616,14.924,0.5
66798,1821027,1663,24493,1663,27819,3326,1665,14.728,0.5
66799,29914,12,391,12,415,24,13,32.583,0.0
6680,3978044,1813,42626,1813,46752,4126,2315,18.429,0.0
66802,40218,82,531,82,695,164,84,6.476,0.0
66803,6291,12,70,12,94,24,13,5.833,0.0
66804,29914,12,391,12,415,24,13,32.583,0.0
66805,3851,5,39,5,49,10,6,7.8,0.0
66806,12328,22,149,22,193,44,24,6.773,0.0
66807,4575,7,49,7,63,14,8,7.0,0.0
66808,5487,12,36,12,60,24,13,3.0,0.0
66809,6229,14,41,14,69,28,15,2.929,0.0
6681,29093,0,560,0,595,35,36,16.0,0.0
66810,4575,7,49,7,63,14,8,7.0,0.0
66811,1341,2,6,2,10,4,3,3.0,0.0
66812,1354,2,6,2,10,4,3,3.0,0.0
66813,69227,4,28,4,36,8,5,7.0,0.0
66814,443193,132,1054,132,1318,264,133,7.985,0.0
6682,7546,0,87,0,98,11,12,7.909,0.5
6685,222833,0,2000,0,2500,500,501,4.0,0.0
6686,70629,0,1344,0,1428,84,85,16.0,0.0
6687,110357,0,1296,0,1458,162,163,8.0,0.0
6688,214044,0,2000,0,2500,500,501,4.0,0.5
6689,190044,0,2240,0,2520,280,281,8.0,0.0
6690,137445,0,1729,0,1976,247,248,7.0,0.0
6691,40026,92,368,92,552,184,93,4.0,0.0
6692,992686,0,17823,0,18323,500,501,35.646,0.0
6693,421891,0,8404,0,8904,500,501,16.808,1.0
6694,775651,0,15500,0,16000,500,501,31.0,0.0
6695,168737,0,2397,0,2448,51,52,47.0,0.0
6696,719413,0,13580,0,14080,500,501,27.16,0.0
6697,491535,500,6000,500,7000,1000,501,12.0,0.0
6698,657834,0,11298,0,11798,500,501,22.596,0.0
6699,230015,0,4165,0,4410,245,246,17.0,0.5
67,4976800,9607,57634,9607,76845,19211,9608,5.999,0.0
6700,71433,0,800,0,960,160,161,5.0,0.0
6701,381076,0,5028,0,5528,500,501,10.056,0.0
6702,93000,0,1597,0,1691,94,95,16.989,0.0
6703,465131,0,1687,0,1775,88,89,19.17,0.0
6704,988630,0,17760,0,18260,500,501,35.52,0.0
6705,1558529,0,33000,0,33500,500,501,66.0,0.0
6706,862323,0,12500,0,13000,500,501,25.0,0.0
6707,671196,0,12623,0,13484,861,816,25.246,0.0
6708,53882,0,520,0,608,88,89,5.909,0.0
6709,503879,0,9000,0,9500,500,501,18.0,0.0
6710,577612,0,13079,0,13579,500,501,26.158,0.0
6711,4300,4,48,4,56,8,5,12.0,0.0
6712,6203,0,52,0,65,13,14,4.0,0.0
6714,77981,0,1058,0,1104,46,47,23.0,0.0
6715,1532940,0,16000,0,16500,500,501,32.0,0.0
6716,2507,0,36,0,38,2,3,18.0,0.0
6717,756998,0,12000,0,12500,500,501,24.0,0.0
6718,61479,101,808,101,1010,202,102,8.0,0.0
6719,31909,60,410,60,530,120,61,6.833,0.0
6720,215093,0,2907,0,3230,323,324,9.0,0.5
6721,446317,0,8420,0,8920,500,501,16.84,0.0
6722,837269,0,13559,0,14059,500,501,27.118,0.5
6723,417830,0,7318,0,7737,419,420,17.465,0.0
6725,35640,0,320,0,400,80,81,4.0,0.0
6726,33784,80,320,80,480,160,81,4.0,0.0
6727,173168,0,2065,0,2360,295,296,7.0,0.0
6728,548145,0,9972,0,10472,500,501,19.944,0.0
6729,351470,500,5000,500,6000,1000,501,10.0,0.0
6730,268844,0,2765,0,3265,500,501,5.53,0.0
6731,49522,0,414,0,552,138,139,3.0,0.0
6732,477066,0,7000,0,7500,500,501,14.0,0.0
6733,3007,3,42,3,48,6,4,14.0,0.0
6734,395598,0,4500,0,5000,500,501,9.0,0.0
6735,372221,0,5000,0,5500,500,501,10.0,0.0
6736,494344,0,6000,0,6500,500,501,12.0,0.0
6737,139286,58,1912,58,2028,116,59,32.966,0.0
6738,358644,500,5000,500,6000,1000,501,10.0,0.0
6739,421485,500,5408,500,6408,1000,501,10.816,0.0
6740,12985,0,146,0,165,19,20,7.684,0.0
6741,127765,0,1452,0,1485,33,34,44.0,0.0
6742,292355,0,5000,0,5500,500,501,10.0,0.0
6743,383957,0,5000,0,5500,500,501,10.0,0.0
6744,880117,0,14000,0,14500,500,501,28.0,0.0
6745,33722,80,320,80,480,160,81,4.0,0.0
6746,665776,0,15540,0,16040,500,501,31.08,0.0
6747,2656923,1487,29198,1487,32672,3474,1989,14.695,0.0
6748,48401,0,177,0,236,59,60,3.0,0.0
6749,708346,0,12599,0,13099,500,501,25.198,0.0
6750,249698,0,3692,0,3953,261,262,14.146,0.0
6751,362221,0,5500,0,6000,500,501,11.0,0.0
6753,19501,19,190,19,228,38,20,10.0,0.0
6754,32312,80,320,80,480,160,81,4.0,0.0
6755,34822,0,583,0,613,30,31,19.433,0.0
6757,123706,0,1620,0,1800,180,181,9.0,0.0
6758,567054,0,10492,0,10992,500,501,20.984,0.0
6759,242604,0,3000,0,3500,500,501,6.0,0.0
6760,43951,0,611,0,624,13,14,47.0,0.0
6762,158665,228,2442,228,2898,456,229,10.711,0.5
6763,54941,0,508,0,594,86,87,5.907,0.0
6764,441384,500,6000,500,7000,1000,501,12.0,0.0
6765,458597,0,10000,0,10500,500,501,20.0,0.0
6766,839975,0,9468,0,9968,500,501,18.936,0.5
6767,31540,80,320,80,480,160,81,4.0,0.0
6768,356535,0,5503,0,6003,500,501,11.006,0.0
6769,176072,0,2791,0,2991,200,201,13.955,0.0
6770,140781,0,2688,0,2856,168,169,16.0,0.0
6771,434799,0,8500,0,9000,500,501,17.0,0.0
6772,414685,0,5500,0,6000,500,501,11.0,0.0
6777,209640,0,2266,0,2766,500,501,4.532,0.0
6778,336744,0,4500,0,5000,500,501,9.0,0.0
6779,281327,0,4536,0,4860,324,325,14.0,0.0
6780,1383265,0,31892,0,32392,500,501,63.784,0.0
67810,70456,141,1268,141,1550,282,142,8.993,0.5
67812,762225,1000,9812,1000,11812,2000,1001,9.812,0.5
67813,22700,50,284,50,384,100,51,5.68,0.0
67814,1571633,1000,34000,1000,36000,2000,1001,34.0,0.0
67816,4936,6,60,6,72,12,7,10.0,0.5
67817,22174,48,288,48,384,96,49,6.0,0.0
67819,2410336,1000,31171,1000,33171,2000,1001,31.171,0.0
6782,2300429,0,57392,0,57892,500,501,114.784,0.0
67820,4307,7,49,7,63,14,8,7.0,0.0
67821,744835,1000,9857,1000,11857,2000,1001,9.857,0.5
67822,3079,10,10,10,30,20,11,1.0,0.0
67823,36651,0,146,0,292,146,147,1.0,0.0
67825,509497,1000,8951,1000,10951,2000,1001,8.951,0.0
67828,1298969,1000,19000,1000,21000,2000,1001,19.0,0.0
6783,17281,0,294,0,308,14,15,21.0,0.0
6784,288978,0,2993,0,3493,500,501,5.986,0.0
67841,3867,8,32,8,48,16,9,4.0,0.0
67845,4456,8,40,8,56,16,9,5.0,0.0
67846,107086,139,1807,139,2085,278,140,13.0,0.0
67847,477500,792,6300,792,7884,1584,793,7.955,0.5
6785,1898411,0,30460,0,30960,500,501,60.92,0.0
6786,36036,0,672,0,714,42,43,16.0,0.0
67864,23775,48,240,48,336,96,49,5.0,0.0
67866,3745,7,28,7,42,14,8,4.0,0.0
6787,37675,0,468,0,494,26,27,18.0,0.0
67872,159721,139,2363,139,2641,278,140,17.0,0.5
67875,31647,69,414,69,552,138,70,6.0,0.0
67876,284671,139,4180,139,4458,278,140,30.072,0.0
67877,84469,139,1112,139,1390,278,140,8.0,0.5
6788,401144,0,3359,0,3859,500,501,6.718,0.0
67889,62552,103,1028,103,1234,206,104,9.981,0.0
6789,385828,0,5500,0,6000,500,501,11.0,0.0
67890,4171,8,32,8,48,16,9,4.0,0.0
67898,1303153,1000,19000,1000,21000,2000,1001,19.0,0.0
67899,399081,437,5681,437,6555,874,438,13.0,0.0
6790,263745,0,2868,0,3346,478,479,6.0,0.0
67902,2229,4,16,4,24,8,5,4.0,0.5
67904,919425,1000,14000,1000,16000,2000,1001,14.0,0.0
67905,1307739,1000,19000,1000,21000,2000,1001,19.0,0.0
67906,1317231,1000,19000,1000,21000,2000,1001,19.0,0.0
67909,1824,0,5,0,10,5,6,1.0,0.0
6791,289369,0,4997,0,5497,500,501,9.994,0.0
67911,1303193,1000,19000,1000,21000,2000,1001,19.0,0.5
67913,80228,139,1082,139,1360,278,140,7.784,0.0
67916,1298780,1000,19000,1000,21000,2000,1001,19.0,0.0
67917,6332,4,84,4,92,8,5,21.0,0.5
6792,1208862,0,18356,0,18856,500,501,36.712,0.0
67920,2596,5,20,5,30,10,6,4.0,0.0
67926,821826,631,11989,631,13251,1262,632,19.0,0.5
6793,330965,0,5249,0,5412,163,164,32.202,0.0
67930,1303435,1000,19000,1000,21000,2000,1001,19.0,0.5
67931,1298144,1000,19000,1000,21000,2000,1001,19.0,0.0
67933,825735,636,12084,636,13356,1272,637,19.0,0.5
67934,864006,1000,13000,1000,15000,2000,1001,13.0,0.0
67937,1303142,1000,19000,1000,21000,2000,1001,19.0,0.0
67938,38338,53,669,53,775,106,54,12.623,0.0
67939,42457,59,530,59,648,118,60,8.983,0.5
6794,100918,0,1759,0,1920,161,162,10.925,0.0
67940,1301314,1000,19000,1000,21000,2000,1001,19.0,0.0
67941,22709,51,255,51,357,102,52,5.0,0.5
67942,17807,53,159,53,265,106,54,3.0,0.0
67943,12293,9,171,9,189,18,10,19.0,0.0
67944,1297437,1000,19000,1000,21000,2000,1001,19.0,0.0
67945,230665,446,2651,446,3543,892,447,5.944,0.5
67946,345361,1000,4000,1000,6000,2000,1001,4.0,0.0
67947,1299750,1000,19000,1000,21000,2000,1001,19.0,0.0
67948,4146,5,40,5,50,10,6,8.0,0.0
67949,826977,635,12065,635,13335,1270,636,19.0,0.5
6795,16967,0,192,0,216,24,25,8.0,0.0
67953,1442602,1000,21000,1000,23000,2000,1001,21.0,0.0
67954,21218,58,232,58,348,116,59,4.0,0.0
67955,53466,37,777,37,851,74,38,21.0,0.0
67957,1301956,1000,19000,1000,21000,2000,1001,19.0,0.0
67958,527129,405,7695,405,8505,810,406,19.0,0.0
67961,17500,53,159,53,265,106,54,3.0,0.0
67962,498304,384,7296,384,8064,768,385,19.0,0.0
67963,44442,59,530,59,648,118,60,8.983,0.0
67964,459794,1000,6000,1000,8000,2000,1001,6.0,0.0
67965,478846,369,7011,369,7749,738,370,19.0,0.0
67966,1303221,1000,19000,1000,21000,2000,1001,19.0,0.0
67967,4126,5,40,5,50,10,6,8.0,0.0
67968,1298981,1000,19000,1000,21000,2000,1001,19.0,0.0
67969,2019,1,21,1,23,2,2,21.0,0.0
6797,83398,0,810,0,945,135,136,6.0,0.0
67977,1297979,1000,19000,1000,21000,2000,1001,19.0,0.0
67978,1305429,1000,19000,1000,21000,2000,1001,19.0,0.0
67979,823141,634,12046,634,13314,1268,635,19.0,0.5
6798,88919,0,936,0,960,24,25,39.0,0.0
67980,99027,158,1548,158,1864,316,159,9.797,0.0
67981,1308036,1000,19000,1000,21000,2000,1001,19.0,0.0
67982,42424,59,530,59,648,118,60,8.983,0.5
67983,1299840,1000,19000,1000,21000,2000,1001,19.0,0.0
67988,1301828,1000,19000,1000,21000,2000,1001,19.0,0.0
67990,43175,59,531,59,649,118,60,9.0,0.0
67994,5773,4,76,4,84,8,5,19.0,0.0
68,210785,936,2056,936,3690,1634,940,2.908,0.0
680,92631,82,840,82,1004,164,83,10.244,0.0
6800,464255,0,6112,0,6435,323,324,18.923,0.0
68005,43057,59,530,59,648,118,60,8.983,0.0
68006,1446773,1000,21000,1000,23000,2000,1001,21.0,0.5
68007,17124,53,159,53,265,106,54,3.0,0.0
6801,972324,0,17166,0,17666,500,501,34.332,0.0
68012,17219,53,159,53,265,106,54,3.0,0.0
68014,1298098,1000,19000,1000,21000,2000,1001,19.0,0.5
68015,1308044,1000,19000,1000,21000,2000,1001,19.0,0.0
68018,44789,59,531,59,649,118,60,9.0,0.5
6802,39341,0,200,0,240,40,41,5.0,0.0
6803,108302,0,1308,0,1570,262,263,4.992,0.0
68034,1302191,1000,19000,1000,21000,2000,1001,19.0,0.0
68035,4476,3,57,3,63,6,4,19.0,0.0
68036,1297143,1000,19000,1000,21000,2000,1001,19.0,0.0
68037,1302451,1000,19000,1000,21000,2000,1001,19.0,0.0
68038,1306441,1000,19000,1000,21000,2000,1001,19.0,0.0
68039,1302477,1000,19000,1000,21000,2000,1001,19.0,0.0
6804,1574820,0,26500,0,27000,500,501,53.0,0.0
68040,829624,639,12141,639,13419,1278,640,19.0,0.5
68041,827031,637,12103,637,13377,1274,638,19.0,0.5
68042,1302730,1000,19000,1000,21000,2000,1001,19.0,0.0
68043,1302764,1000,19000,1000,21000,2000,1001,19.0,0.0
68044,1305871,1000,19000,1000,21000,2000,1001,19.0,0.0
68046,23474,16,336,16,368,32,17,21.0,0.5
68047,47743,33,693,33,759,66,34,21.0,0.0
68048,29363,58,522,58,638,116,59,9.0,0.0
6805,406174,500,5497,500,6497,1000,501,10.994,0.0
68050,31046,59,531,59,649,118,60,9.0,0.0
68057,17594,53,159,53,265,106,54,3.0,0.0
68059,17594,53,159,53,265,106,54,3.0,0.0
6806,836370,0,13595,0,14095,500,501,27.19,1.0
68061,1297934,1000,19000,1000,21000,2000,1001,19.0,0.0
6807,22301,0,210,0,242,32,33,6.562,0.0
68077,17218,53,159,53,265,106,54,3.0,0.0
68079,1302305,1000,19000,1000,21000,2000,1001,19.0,0.0
6808,397801,0,5500,0,6000,500,501,11.0,0.0
68087,261117,199,3781,199,4179,398,200,19.0,0.0
68088,291246,222,4218,222,4662,444,223,19.0,0.0
6809,298664,0,4239,0,4710,471,472,9.0,0.0
68093,1302012,1000,19000,1000,21000,2000,1001,19.0,0.0
68095,1302523,1000,19000,1000,21000,2000,1001,19.0,0.5
68096,1306433,1000,19000,1000,21000,2000,1001,19.0,0.0
6810,24670,0,252,0,278,26,27,9.692,0.0
68104,3003,0,20,0,24,4,5,5.0,0.0
68108,2895,0,20,0,24,4,5,5.0,0.0
68109,3140,0,20,0,24,4,5,5.0,0.0
6811,53028,0,583,0,673,90,91,6.478,0.0
68110,3011,0,20,0,24,4,5,5.0,0.0
68111,2886,0,20,0,24,4,5,5.0,0.0
68112,2967,0,24,0,28,4,5,6.0,0.0
68113,5432,10,50,10,70,20,11,5.0,0.5
68115,725887,1000,10340,1000,12340,2000,1001,10.34,0.0
68119,900978,1000,11938,1000,13938,2000,1001,11.938,0.0
68122,2311023,1000,43251,1000,45251,2000,1001,43.251,0.0
6813,864343,0,12500,0,13000,500,501,25.0,0.0
68136,1375737,1000,22982,1000,24982,2000,1001,22.982,0.0
6814,232653,0,2201,0,2701,500,501,4.402,0.0
6815,688419,0,12387,0,12887,500,501,24.774,0.0
68154,21382,17,289,17,323,34,18,17.0,0.0
6816,29262,0,327,0,381,54,55,6.056,0.0
68160,455187,1000,4000,1000,6000,2000,1001,4.0,0.0
68162,267607,1000,1000,1000,3000,2000,1001,1.0,0.0
6817,211451,500,2000,500,3000,1000,501,4.0,0.0
68178,17428,63,63,63,189,126,64,1.0,0.0
68185,267607,1000,1000,1000,3000,2000,1001,1.0,0.0
6819,563319,0,9967,0,10467,500,501,19.934,0.5
682,2427,0,16,0,20,4,5,4.0,0.0
6820,272052,500,3701,500,4701,1000,501,7.402,0.0
68202,11750,28,112,28,168,56,29,4.0,0.0
6821,299427,0,4000,0,4500,500,501,8.0,0.0
68219,469169,734,5866,734,7334,1468,735,7.992,0.0
6822,976713,0,17193,0,17693,500,501,34.386,0.0
68228,267607,1000,1000,1000,3000,2000,1001,1.0,0.0
6823,422036,0,5763,0,6263,500,501,11.526,0.5
68236,267607,1000,1000,1000,3000,2000,1001,1.0,0.0
6824,597953,0,11491,0,11991,500,501,22.982,0.0
68240,17695,64,64,64,192,128,65,1.0,0.0
68241,267607,1000,1000,1000,3000,2000,1001,1.0,0.0
68244,271608,1000,1000,1000,3000,2000,1001,1.0,0.0
68249,5486,18,18,18,54,36,19,1.0,0.0
6825,301320,500,4000,500,5000,1000,501,8.0,0.0
68250,271608,1000,1000,1000,3000,2000,1001,1.0,0.0
68252,17695,64,64,64,192,128,65,1.0,0.0
68254,429037,483,4830,483,5796,966,484,10.0,0.0
68255,267607,1000,1000,1000,3000,2000,1001,1.0,0.0
68256,8083,28,28,28,84,56,29,1.0,0.0
68257,86848,323,323,323,969,646,324,1.0,0.0
68259,535285,441,8060,441,8942,882,442,18.277,0.0
6826,839552,0,12000,0,12500,500,501,24.0,0.0
68261,85527,100,1064,100,1264,200,101,10.64,0.0
68265,14224,51,51,51,153,102,52,1.0,0.0
68267,267607,1000,1000,1000,3000,2000,1001,1.0,0.0
68268,271608,1000,1000,1000,3000,2000,1001,1.0,0.0
6827,347940,0,5000,0,5500,500,501,10.0,0.0
68270,2169265,1000,40255,1000,42255,2000,1001,40.255,0.0
68271,267607,1000,1000,1000,3000,2000,1001,1.0,0.0
68274,5215,17,17,17,51,34,18,1.0,0.0
68276,146923,548,548,548,1644,1096,549,1.0,0.0
6828,538035,0,9401,0,9901,500,501,18.802,0.0
6829,570335,0,9423,0,9923,500,501,18.846,0.0
683,6186,0,56,0,70,14,15,4.0,0.0
6830,22453,0,264,0,297,33,34,8.0,0.0
68303,5486,18,18,18,54,36,19,1.0,0.0
68313,267607,1000,1000,1000,3000,2000,1001,1.0,0.0
68314,338743,707,4949,707,6363,1414,708,7.0,0.0
68315,18496,67,67,67,201,134,68,1.0,0.0
68316,267607,1000,1000,1000,3000,2000,1001,1.0,0.0
6832,759656,0,17137,0,17637,500,501,34.274,0.0
68327,3277,10,10,10,30,20,11,1.0,0.0
68328,14224,51,51,51,153,102,52,1.0,0.0
6833,673360,0,18891,0,19391,500,501,37.782,0.0
68331,6748,23,23,23,69,46,24,1.0,0.0
68332,64020,156,780,156,1092,312,157,5.0,0.0
6834,32506,0,283,0,342,59,60,4.797,0.0
68341,267607,1000,1000,1000,3000,2000,1001,1.0,0.0
68344,21467,34,305,34,373,68,35,8.971,0.0
68347,271608,1000,1000,1000,3000,2000,1001,1.0,0.0
6835,9759,0,114,0,134,20,21,5.7,0.0
68351,271608,1000,1000,1000,3000,2000,1001,1.0,0.0
68354,6748,23,23,23,69,46,24,1.0,0.0
6836,631424,0,8125,0,8625,500,501,16.25,0.0
6837,855827,0,10803,0,11303,500,501,21.606,0.0
68379,267607,1000,1000,1000,3000,2000,1001,1.0,0.0
68383,271608,1000,1000,1000,3000,2000,1001,1.0,0.0
68384,271608,1000,1000,1000,3000,2000,1001,1.0,0.0
6839,145157,0,1984,0,2108,124,125,16.0,0.0
68391,16360,59,59,59,177,118,60,1.0,0.0
68394,70797,259,259,259,777,518,260,1.0,0.0
68395,6917,15,60,15,90,30,16,4.0,0.0
68396,267607,1000,1000,1000,3000,2000,1001,1.0,0.0
68398,512559,1000,8000,1000,10000,2000,1001,8.0,0.5
68399,267607,1000,1000,1000,3000,2000,1001,1.0,0.0
6840,325562,500,4000,500,5000,1000,501,8.0,0.0
68401,267607,1000,1000,1000,3000,2000,1001,1.0,0.0
68403,199522,734,734,734,2202,1468,735,1.0,0.0
68404,9280,32,32,32,96,64,33,1.0,0.0
68405,267607,1000,1000,1000,3000,2000,1001,1.0,0.0
68406,81508,303,303,303,909,606,304,1.0,0.0
68407,271608,1000,1000,1000,3000,2000,1001,1.0,0.0
68408,1453,1,5,1,8,3,3,5.0,0.0
68409,2383,3,18,3,24,6,4,6.0,0.0
6841,237871,0,2500,0,3000,500,501,5.0,0.0
68410,3506,3,9,3,15,6,4,3.0,0.0
68411,2669,2,24,2,28,4,3,12.0,0.0
68413,249589,1000,1000,1000,3000,2000,1001,1.0,0.0
68414,2522001,1981,49463,1981,53425,3962,1983,24.969,0.0
68415,756699,1000,9873,1000,11873,2000,1001,9.873,0.0
68416,3120,7,21,7,35,14,8,3.0,0.0
68420,484448,640,6312,640,7592,1280,641,9.863,0.0
68422,144311,0,1777,0,1975,198,199,8.975,0.0
68424,543115,931,6781,931,8643,1862,932,7.284,0.0
6843,6925,0,109,0,115,6,7,18.167,0.0
68431,656922,0,8952,0,9599,647,648,13.836,0.5
68432,1742823,0,27153,0,28103,950,951,28.582,0.75
68434,374604,0,6558,0,6717,159,160,41.245,0.0
68436,205285,274,2706,274,3254,548,275,9.876,0.0
68438,1921997,0,24354,0,24513,159,160,153.17,0.0
68441,401750,0,6166,0,6325,159,160,38.78,0.0
68442,722834,0,9874,0,10874,1000,1001,9.874,0.0
68444,1254630,0,13574,0,13733,159,160,85.371,0.0
68445,4648787,0,55094,0,55253,159,160,346.503,0.0
68446,43980,0,756,0,774,18,19,42.0,0.0
68447,253590,1000,1000,1000,3000,2000,1001,1.0,0.0
68449,574098,1000,6513,1000,8513,2000,1001,6.513,0.0
6845,479935,0,7000,0,7500,500,501,14.0,0.0
68450,235239,0,950,0,1900,950,951,1.0,0.0
68451,523566,0,13446,0,13608,162,163,83.0,0.0
68452,2171086,0,43413,0,44413,1000,1001,43.413,0.0
68454,3405,0,32,0,40,8,9,4.0,0.0
68459,7072498,0,51464,0,51964,500,501,102.928,0.0
6846,576942,0,13196,0,13696,500,501,26.392,0.0
68460,161692,647,647,647,1941,1294,648,1.0,0.0
68463,2376,0,20,0,25,5,6,4.0,0.0
68464,247589,0,1000,0,2000,1000,1001,1.0,0.0
68465,31257,0,342,0,428,86,87,3.977,0.0
68466,2021,0,16,0,20,4,5,4.0,0.0
68467,750991,1000,9855,1000,11855,2000,1001,9.855,0.0
68471,2778,0,24,0,30,6,7,4.0,0.0
68474,2585,0,24,0,26,2,3,12.0,0.0
68475,151040,0,1660,0,2000,340,341,4.882,0.0
68477,4349,0,56,0,64,8,9,7.0,0.0
68478,492670,0,12628,0,12792,164,165,77.0,0.0
68480,2716,3,18,3,27,9,7,6.0,0.0
6849,454743,0,9222,0,9414,192,193,48.031,0.0
68490,1655,0,9,0,12,3,4,3.0,0.5
68493,1303,0,6,0,8,2,3,3.0,0.5
68495,1301,0,6,0,8,2,3,3.0,0.0
68500,175812,0,2272,0,2513,241,242,9.427,0.5
68501,1299,0,6,0,8,2,3,3.0,0.0
68503,1301,0,6,0,8,2,3,3.0,0.0
68508,1302,0,6,0,8,2,3,3.0,0.0
68509,1662,0,9,0,12,3,4,3.0,0.0
6851,285416,0,3000,0,3500,500,501,6.0,0.0
68510,12308,0,152,0,168,16,17,9.5,0.5
68511,138216,0,1786,0,1974,188,189,9.5,0.5
68514,1660,0,9,0,12,3,4,3.0,0.0
68515,2004,0,12,0,16,4,5,3.0,0.0
68516,1302,0,6,0,8,2,3,3.0,0.0
68517,1999,0,12,0,16,4,5,3.0,0.0
6852,411441,500,5929,500,6929,1000,501,11.858,0.0
68521,1300,0,6,0,8,2,3,3.0,0.0
68523,2010,0,12,0,16,4,5,3.0,0.5
68526,1302,0,6,0,8,2,3,3.0,0.0
68527,1298,0,6,0,8,2,3,3.0,0.0
68528,1664,0,9,0,12,3,4,3.0,0.0
68532,1667,0,9,0,12,3,4,3.0,0.0
68539,2006,0,12,0,16,4,5,3.0,0.0
6854,125205,0,1905,0,2080,175,176,10.886,0.0
68540,2011,0,12,0,16,4,5,3.0,0.0
68543,1311,0,6,0,8,2,3,3.0,0.0
68544,1307,0,6,0,8,2,3,3.0,0.0
68546,295175,672,3360,672,4704,1344,673,5.0,0.0
6855,898358,0,14829,0,15152,323,324,45.91,0.0
68551,43347,169,169,169,507,338,170,1.0,0.0
68552,911160,338,19266,338,19942,676,340,57.0,0.0
68558,153419,0,1975,0,2173,198,199,9.975,0.0
68560,14035,54,54,54,162,108,55,1.0,0.0
68564,281607,54,324,54,432,108,55,6.0,0.0
68566,164281,647,647,647,1941,1294,648,1.0,0.0
68568,249589,1000,1000,1000,3000,2000,1001,1.0,0.0
68569,164281,647,647,647,1941,1294,648,1.0,0.0
6857,1081482,0,16500,0,17000,500,501,33.0,0.0
68573,161692,647,647,647,1941,1294,648,1.0,0.0
68574,161692,647,647,647,1941,1294,648,1.0,0.0
68577,920787,1000,4090,1000,6090,2000,1001,4.09,0.0
68578,1336,3,3,3,9,6,4,1.0,0.0
6858,315195,0,5191,0,5468,277,278,18.74,0.0
68585,34675,0,138,0,276,138,139,1.0,0.0
68589,304934,380,1900,380,2660,760,381,5.0,0.0
6859,1526845,485,20596,485,21566,970,486,42.466,0.0
68590,249589,1000,1000,1000,3000,2000,1001,1.0,0.0
68592,8433,31,31,31,93,62,32,1.0,0.0
68594,12116,45,45,45,135,90,47,1.0,0.0
68595,1604231,1000,31620,1000,33620,2000,1002,31.62,0.0
686,1784,2,14,2,19,5,4,7.0,0.0
6860,1571661,500,21941,500,22941,1000,501,43.882,0.0
68606,3156,10,10,10,30,20,12,1.0,0.0
68607,1862328,1999,27286,1999,31284,3998,2001,13.65,0.0
6861,340102,500,4660,500,5660,1000,501,9.32,0.0
68619,75860,294,294,294,882,588,296,1.0,0.0
6862,65750,34,816,34,884,68,35,24.0,0.0
68621,280234,460,2569,460,3494,925,467,5.585,0.0
68622,317596,1000,2854,1000,4854,2000,1002,2.854,0.0
68638,859061,537,10780,537,11854,1074,539,20.074,0.0
6864,398868,0,5000,0,5500,500,501,10.0,0.0
68646,1091506,0,20283,0,21283,1000,1001,20.283,0.0
68647,1229873,1000,18996,1000,20996,2000,1002,18.996,0.0
6865,709313,0,16462,0,16962,500,501,32.924,0.0
68656,131202,251,1004,251,1757,753,504,4.0,0.0
6866,1116436,0,4348,0,4729,381,382,11.412,0.0
68662,1660204,1000,32735,1000,34735,2000,1002,32.735,0.0
68666,11623,0,122,0,147,25,26,4.88,0.0
68668,9110,6,62,6,98,36,31,10.333,0.0
6867,991238,0,17930,0,18430,500,501,35.86,0.0
68671,590876,0,8000,0,9000,1000,1001,8.0,0.0
68678,1080358,1000,13837,1000,15837,2000,1002,13.837,0.0
6868,286573,0,3000,0,3500,500,501,6.0,0.0
68682,681998,1000,10950,1000,12950,2000,1002,10.95,0.0
68683,1082183,1000,13898,1000,15898,2000,1002,13.898,0.0
68685,92843,133,1476,133,1742,266,135,11.098,0.0
68687,81856,43,646,43,732,86,45,15.023,0.5
68689,92230,71,1703,71,1845,142,73,23.986,0.0
6869,446844,500,8000,500,9000,1000,501,16.0,0.0
68693,112214,93,2232,93,2418,186,95,24.0,0.5
68694,1425,1,8,1,11,3,4,8.0,0.0
68700,71005,123,861,123,1107,246,125,7.0,0.0
68715,73635,45,629,45,719,90,47,13.978,0.0
68716,1154811,1000,20088,1000,22088,2000,1002,20.088,0.0
6872,32140,0,320,0,400,80,81,4.0,0.0
68721,260597,1000,1000,1000,3000,2000,1002,1.0,0.0
68722,8115,10,77,10,107,30,19,7.7,0.0
68725,1670327,1000,24810,1000,26810,2000,1002,24.81,0.0
68726,256596,1000,1000,1000,3000,2000,1002,1.0,0.0
68728,647231,1000,8978,1000,10978,2000,1002,8.978,0.5
68729,5211,13,52,13,78,26,15,4.0,0.0
6873,171706,0,2848,0,2963,115,116,24.765,0.0
68734,347232,713,4991,713,6417,1426,715,7.0,0.0
68735,42598,76,532,76,684,152,78,7.0,0.0
68739,585880,1000,6000,1000,8000,2000,1002,6.0,0.0
6874,736743,0,11500,0,12000,500,501,23.0,0.0
68743,6649,13,78,13,104,26,15,6.0,0.0
68745,164165,0,747,0,950,203,204,3.68,0.5
68747,7097,13,91,13,117,26,15,7.0,0.0
68748,937818,0,12000,0,13000,1000,1001,12.0,0.0
6875,387541,0,8000,0,8500,500,501,16.0,0.0
68752,1156759,1000,20349,1000,22349,2000,1002,20.349,0.0
68754,6131,11,66,11,88,22,13,6.0,0.0
68758,87397,143,572,143,1001,429,284,4.0,0.0
6876,1271174,0,9500,0,10000,500,501,19.0,0.0
6877,512318,0,7489,0,7989,500,501,14.978,0.75
6878,103849,0,1472,0,1504,32,33,46.0,0.0
6879,63041,0,946,0,989,43,44,22.0,0.0
68791,256596,1000,1000,1000,3000,2000,1002,1.0,0.0
68793,557981,1000,6000,1000,8000,2000,1002,6.0,0.0
6880,665594,0,13494,0,13994,500,501,26.988,0.0
68811,1190559,2000,18997,2000,22997,4000,2003,9.498,0.0
68819,69625,48,744,48,840,96,50,15.5,0.0
68822,714901,730,10221,730,11681,1460,732,14.001,0.0
68825,1137415,1000,20824,1000,22824,2000,1002,20.824,0.0
68829,241711,294,4061,294,4649,588,296,13.813,0.0
6883,52831,23,725,23,771,46,24,31.522,0.0
68833,7727,0,57,0,76,19,20,3.0,0.0
6884,161658,269,2152,269,2690,538,270,8.0,0.0
68846,9674590,1000,300000,1000,302000,2000,1002,300.0,0.0
68851,260597,1000,1000,1000,3000,2000,1002,1.0,0.0
68852,575843,1000,9485,1000,11485,2000,1002,9.485,0.0
68854,505765,1000,5000,1000,7000,2000,1002,5.0,0.5
68857,230760,141,3713,141,3995,282,143,26.333,0.0
68858,299390,149,3278,149,3576,298,151,22.0,0.0
68859,19559,36,324,36,396,72,38,9.0,0.0
6886,574480,0,9518,0,10018,500,501,19.036,0.0
68862,1820441,1000,27998,1000,30998,3000,2002,27.998,0.0
68863,8445583,1000,214338,1000,216338,2000,1002,214.338,0.0
68868,26708,102,102,102,306,204,104,1.0,0.0
6887,7858,0,88,0,99,11,12,8.0,0.5
68871,574004,1000,9460,1000,11460,2000,1002,9.46,0.0
68872,256596,1000,1000,1000,3000,2000,1002,1.0,0.0
68874,5061,10,30,10,60,30,20,3.0,0.0
68878,97001,168,1173,168,1509,336,170,6.982,0.0
6888,478037,0,6845,0,7345,500,501,13.69,0.5
68882,17360,43,172,43,258,86,45,4.0,0.0
6890,375513,500,3348,500,4348,1000,501,6.696,0.0
68907,77037,294,294,294,882,588,296,1.0,0.0
68909,509919,1000,7000,1000,9000,2000,1002,7.0,0.0
6891,384205,0,5500,0,6000,500,501,11.0,0.0
68910,1101644,1000,12999,1000,14999,2000,1002,12.999,0.0
68915,45303,100,500,100,700,200,102,5.0,0.0
68927,64711,137,548,137,822,274,139,4.0,0.0
68932,5740,12,60,12,84,24,14,5.0,0.0
68940,19824869,874,75427,874,77175,1748,876,86.301,0.0
68941,315197,250,4251,250,5001,750,369,17.004,0.0
68942,21657,81,81,81,243,162,83,1.0,0.0
68946,5286,14,42,14,70,28,16,3.0,0.0
68949,4421,9,36,9,54,18,11,4.0,0.0
6895,452608,0,8330,0,8820,490,491,17.0,0.0
68951,5026,14,42,14,70,28,16,3.0,0.0
68954,75860,294,294,294,882,588,296,1.0,0.0
68957,10068,37,37,37,111,74,39,1.0,0.0
6896,329441,0,3808,0,4284,476,477,8.0,0.0
68963,10217,37,37,37,111,74,39,1.0,0.0
6897,352256,0,5000,0,5500,500,501,10.0,0.0
68972,27117,102,102,102,306,204,104,1.0,0.0
68973,75860,294,294,294,882,588,296,1.0,0.0
68975,20739,28,411,28,467,56,30,14.679,0.5
6898,236489,0,2588,0,3088,500,501,5.176,0.0
6899,327364,500,4000,500,5000,1000,501,8.0,0.0
68993,175244,176,2044,176,2396,352,178,11.614,0.0
68994,422788,960,5686,960,7606,1920,962,5.923,0.5
68995,10068,37,37,37,111,74,39,1.0,0.0
68996,1855299,1000,24322,1000,26322,2000,1002,24.322,0.0
68998,10068,37,37,37,111,74,39,1.0,0.0
69,1575797,4945,12884,4945,24782,11898,5335,3.256,1.0
69001,10068,37,37,37,111,74,39,1.0,0.0
69004,803155,0,12515,0,13515,1000,1001,12.515,0.0
69005,24943,57,228,57,342,114,59,4.0,0.0
69006,342262,272,2452,272,3268,816,347,9.015,0.5
69012,178778,392,2352,392,3136,784,394,6.0,0.0
69016,32470,50,350,50,500,150,102,7.0,0.0
69018,7480,12,84,12,108,24,14,7.0,0.0
6902,79007,0,1085,0,1240,155,156,7.0,0.0
69024,126872,73,1387,73,1533,146,75,19.0,0.0
69026,147278,250,1830,250,2330,500,252,7.32,0.0
69029,7238,12,72,12,96,24,14,6.0,0.5
6903,794515,0,13140,0,13640,500,501,26.28,1.0
69030,3810,5,55,5,65,10,7,11.0,0.5
69032,10068,37,37,37,111,74,39,1.0,0.0
69036,22709,16,240,16,272,32,18,15.0,0.0
69037,1709607,1000,24819,1000,26819,2000,1002,24.819,0.0
6904,412962,0,6899,0,7399,500,501,13.798,0.0
69044,180237,699,699,699,2097,1398,700,1.0,0.0
69045,2498263,1000,40708,1000,42708,2000,1002,40.708,0.0
69051,1595,0,9,0,12,3,4,3.0,0.0
69052,179540,699,699,699,2097,1398,701,1.0,0.0
69054,10068,37,37,37,111,74,39,1.0,0.0
6906,1468941,0,33000,0,33500,500,501,66.0,0.0
69060,703342,1000,10091,1000,12091,2000,1002,10.091,0.0
69061,17518,45,123,45,213,90,47,2.733,0.0
69065,292284,65,455,65,585,130,67,7.0,0.0
69067,126034,323,1578,323,2224,646,325,4.885,0.0
69068,110539,171,1272,171,1614,342,173,7.439,0.0
6907,216409,0,2000,0,2500,500,501,4.0,0.5
69071,237713,493,2465,493,3451,986,495,5.0,0.0
69072,327933,625,3704,625,4954,1250,627,5.926,0.0
69073,679805,1000,10884,1000,12884,2000,1002,10.884,0.0
69077,120013,96,1632,96,1824,192,98,17.0,0.0
6908,514267,0,7363,0,7863,500,501,14.726,0.0
69080,228396,498,2988,498,3984,996,500,6.0,0.5
69081,10068,37,37,37,111,74,39,1.0,0.0
69085,1782353,1000,31434,1000,33434,2000,1002,31.434,0.0
69086,55746,144,576,144,864,288,146,4.0,0.0
6909,447664,0,8425,0,8925,500,501,16.85,0.0
69091,77037,294,294,294,882,588,296,1.0,0.0
69093,2664728,1000,16983,1000,18983,2000,1002,16.983,0.0
69097,807681,1000,11460,1000,13460,2000,1002,11.46,0.0
69098,26339,39,310,39,388,78,41,7.949,0.0
69099,10068,37,37,37,111,74,39,1.0,0.0
691,4534,6,30,6,54,24,19,5.0,0.0
6910,284054,500,3000,500,4000,1000,501,6.0,0.0
69102,36513,81,388,81,550,162,83,4.79,0.0
69103,106804,0,1443,0,1480,37,38,39.0,0.0
69105,256596,1000,1000,1000,3000,2000,1002,1.0,0.0
69106,19284,73,73,73,219,146,75,1.0,0.0
69107,959446,1000,19000,1000,21000,2000,1002,19.0,0.0
69109,277513,690,2760,690,4140,1380,692,4.0,0.0
6911,484008,0,7807,0,8307,500,501,15.614,0.0
69110,75205,86,344,86,768,424,334,4.0,0.0
69112,6342,13,39,13,65,26,15,3.0,0.0
69114,69141,0,707,0,808,101,102,7.0,0.0
69120,6181,0,88,0,99,11,12,8.0,0.0
69121,17954,0,359,0,383,24,25,14.958,0.5
69124,77037,294,294,294,882,588,296,1.0,0.0
69128,948626,1000,13812,1000,15812,2000,1002,13.812,0.0
6913,2151131,0,23282,0,23782,500,501,46.564,0.0
69131,10068,37,37,37,111,74,39,1.0,0.0
69132,18865,15,135,15,165,30,17,9.0,0.0
69133,65911,150,600,150,900,300,152,4.0,0.0
69135,10068,37,37,37,111,74,39,1.0,0.0
69136,79344,86,1045,86,1217,172,88,12.151,0.0
69137,47524,0,974,0,1053,79,80,12.329,0.0
69138,38740,149,149,149,447,298,151,1.0,0.0
6914,463479,0,8500,0,9000,500,501,17.0,0.0
6915,1797147,0,22973,0,23473,500,501,45.946,0.0
69150,17249,0,198,0,220,22,23,9.0,0.0
69153,162102,0,2008,0,2259,251,252,8.0,0.0
6916,5354,0,45,0,54,9,10,5.0,0.0
69162,38740,149,149,149,447,298,151,1.0,0.0
69164,910821,1000,13000,1000,15000,2000,1002,13.0,0.0
69167,26178,46,368,46,460,92,48,8.0,0.0
69168,421469,384,5585,384,6353,768,386,14.544,0.0
69169,6603,15,60,15,90,30,17,4.0,0.0
6917,267495,500,3000,500,4000,1000,501,6.0,0.0
69175,105081,247,988,247,1482,494,249,4.0,0.0
69177,5682,10,60,10,80,20,12,6.0,0.0
69178,1641907,1000,25874,1000,27874,2000,1002,25.874,0.0
6918,38411,0,348,0,464,116,117,3.0,0.0
69180,200470,54,378,54,486,108,56,7.0,0.0
69184,38782,92,357,92,541,184,94,3.88,0.0
69188,7685,14,56,14,84,28,16,4.0,0.0
6919,159619,60,2143,60,2263,120,61,35.717,0.0
69192,654052,1000,6299,1000,8299,2000,1002,6.299,0.0
69196,2319,3,24,3,30,6,5,8.0,0.0
69198,714882,1000,10072,1000,12072,2000,1002,10.072,0.0
6920,342761,500,4500,500,5500,1000,501,9.0,0.0
69202,6655,13,78,13,104,26,15,6.0,0.0
69205,20506,28,411,28,467,56,30,14.679,0.5
69208,226783,310,3100,310,3720,620,312,10.0,0.0
69209,13857,30,150,30,210,60,32,5.0,0.0
6921,298705,500,4000,500,5000,1000,501,8.0,0.0
69210,7465,0,65,0,78,13,14,5.0,1.0
69211,12372,12,158,12,182,24,14,13.167,1.0
69212,75860,294,294,294,882,588,296,1.0,0.0
69213,939169,2000,15000,2000,19000,4000,2003,7.5,1.0
69214,776867,1000,11077,1000,13077,2000,1002,11.077,0.0
69215,41044,158,158,158,474,316,160,1.0,0.0
69217,969437,1000,19000,1000,21000,2000,1002,19.0,0.0
69218,1743,2,16,2,20,4,4,8.0,0.0
69219,73306,59,1415,59,1533,118,61,23.983,0.0
6922,118156,0,1200,0,1440,240,241,5.0,0.0
69220,38740,149,149,149,447,298,151,1.0,0.0
69225,75860,294,294,294,882,588,296,1.0,0.0
69226,77037,294,294,294,882,588,296,1.0,0.0
69227,4786,3,51,3,57,6,5,17.0,0.0
69228,10500,16,194,16,226,32,18,12.125,1.0
6923,77797,0,1058,0,1104,46,47,23.0,0.0
69232,56339,65,931,65,1061,130,67,14.323,1.0
69233,27821,29,430,29,488,58,31,14.828,0.5
69234,75860,294,294,294,882,588,296,1.0,0.0
69237,2749609,1000,58368,1000,60368,2000,1002,58.368,0.0
6924,230361,0,4165,0,4410,245,246,17.0,0.0
69243,256596,1000,1000,1000,3000,2000,1002,1.0,0.0
69244,966407,1000,11077,1000,14077,3000,2002,11.077,1.0
6925,302307,500,3500,500,4500,1000,501,7.0,1.0
69255,260597,1000,1000,1000,3000,2000,1002,1.0,0.0
6926,300204,0,4000,0,4500,500,501,8.0,0.0
6927,8038588,0,161592,0,162092,500,501,323.184,0.0
69270,2546,5,15,5,25,10,7,3.0,0.0
69272,1154247,1000,19231,1000,21231,2000,1002,19.231,0.0
69273,26736,53,265,53,371,106,55,5.0,0.0
69277,38740,149,149,149,447,298,151,1.0,0.0
69282,4763,9,45,9,63,18,11,5.0,0.0
69283,8761,19,127,19,165,38,21,6.684,1.0
69288,1018651,1000,15410,1000,17410,2000,1002,15.41,0.0
6929,349545,500,4830,500,5830,1000,501,9.66,0.0
69299,968163,0,11070,0,13070,2000,2001,11.07,0.0
6930,109253,240,1200,240,1680,480,241,5.0,0.0
69302,7996,20,59,20,99,40,22,2.95,0.0
69306,38740,149,149,149,447,298,151,1.0,0.0
6931,735901,0,17108,0,17608,500,501,34.216,0.0
69313,39337,149,149,149,447,298,151,1.0,0.0
69317,1112846,1000,17579,1000,19579,2000,1002,17.579,0.5
69319,234804,276,2208,276,2760,552,278,8.0,0.0
6932,50499,0,724,0,761,37,38,19.568,0.0
69320,111217,86,2056,86,2228,172,88,23.907,0.0
6933,312391,0,4830,0,5040,210,211,23.0,0.0
6934,442877,0,9000,0,9500,500,501,18.0,0.0
6935,67260,0,324,0,540,216,217,3.0,0.0
6936,397140,500,5500,500,6500,1000,501,11.0,0.0
6937,1774107,0,49549,0,50049,500,501,99.098,0.0
6938,488707,0,11004,0,11397,393,394,28.0,0.0
6939,484116,0,4861,0,4930,69,70,70.449,0.0
694,17708,36,141,36,213,72,37,3.917,0.0
6940,454143,0,8430,0,8930,500,501,16.86,0.0
6941,34699,0,320,0,400,80,81,4.0,0.0
6942,68430,0,969,0,1012,43,44,22.535,0.0
6943,644318,500,12111,500,13111,1000,501,24.222,0.0
6944,936317,500,20000,500,21000,1000,501,40.0,0.0
6945,248436,0,4000,0,4500,500,501,8.0,0.0
6946,5483,0,60,0,72,12,11,10.0,0.0
6947,349116,0,5000,0,5500,500,501,10.0,0.0
6948,364742,0,6000,0,6500,500,501,12.0,0.0
6949,1901066,0,39000,0,39500,500,501,78.0,0.0
695,1673475,1,5,1,7,2,2,5.0,0.0
6950,355624,0,4447,0,4947,500,501,8.894,0.0
69504,2341967,103,927,103,1133,206,105,9.0,0.5
69508,41044,158,158,158,474,316,160,1.0,0.0
6951,8095,0,60,0,80,20,21,3.0,0.0
69511,3955,10,30,10,50,20,12,3.0,0.0
69512,4948,17,17,17,51,34,19,1.0,0.0
69519,2180,3,18,3,24,6,5,6.0,0.0
6952,567046,0,14000,0,14500,500,501,28.0,0.0
69520,154522,94,2094,94,2282,188,96,22.277,0.0
69521,3719,9,26,9,44,18,11,2.889,0.0
69525,7139,11,88,11,110,22,13,8.0,0.0
69527,10217,37,37,37,111,74,39,1.0,0.0
69528,10068,37,37,37,111,74,39,1.0,0.0
69530,18675,40,240,40,320,80,42,6.0,0.0
69532,6611,17,68,17,102,34,19,4.0,0.0
69534,3587,8,32,8,48,16,10,4.0,0.0
69536,53881,47,799,47,893,94,49,17.0,0.0
69538,38786,101,404,101,606,202,103,4.0,0.0
69539,4661,3,53,3,59,6,5,17.667,0.0
6954,272506,500,3658,500,4658,1000,501,7.316,0.0
69541,781560,1000,8270,1000,10270,2000,1002,8.27,0.0
69542,935188,266,8492,266,9024,532,268,31.925,0.0
69544,41044,158,158,158,474,316,160,1.0,0.0
69550,39337,149,149,149,447,298,151,1.0,0.0
69552,1250,2,6,2,10,4,4,3.0,0.0
69553,2654,3,24,3,30,6,5,8.0,0.0
69557,47291,8,686,8,702,16,10,85.75,0.0
6956,56883,0,978,0,1033,55,56,17.782,0.0
69565,1582,3,9,3,15,6,5,3.0,0.0
69566,926382,1000,12998,1000,14998,2000,1002,12.998,0.0
69567,30294,81,222,81,384,162,83,2.741,0.0
69569,1666522,1000,24965,1000,26965,2000,1002,24.965,0.5
6957,10543,0,180,0,195,15,16,12.0,0.0
69570,105278,94,1594,94,1782,188,96,16.957,0.0
69574,952920,1000,14914,1000,16914,2000,1002,14.914,0.0
6958,588541,0,9609,0,10109,500,501,19.218,0.0
69587,810772,866,8173,866,9905,1732,868,9.438,0.5
6959,970491,0,22313,0,22813,500,501,44.626,0.0
69604,7297,13,65,13,91,26,15,5.0,0.0
69607,127115,165,1320,165,1815,495,330,8.0,0.0
69609,21332,81,81,81,243,162,83,1.0,0.0
6961,382170,0,5000,0,5500,500,501,10.0,0.0
69611,883,1,2,1,4,2,3,2.0,0.0
69612,256596,1000,1000,1000,3000,2000,1002,1.0,0.0
6962,343576,0,4496,0,4996,500,501,8.992,0.0
69624,9948,18,126,18,162,36,20,7.0,0.0
69626,155471,39,733,39,811,78,41,18.795,0.0
6963,535836,0,9500,0,10000,500,501,19.0,0.0
69635,256596,1000,1000,1000,3000,2000,1002,1.0,0.0
69636,545264,1000,6975,1000,8975,2000,1002,6.975,0.0
69639,1876,5,5,5,15,10,7,1.0,0.0
6964,304756,500,3500,500,4500,1000,501,7.0,0.5
69643,1666933,1000,24867,1000,26867,2000,1002,24.867,0.0
69645,2640,5,25,5,35,10,7,5.0,0.0
69646,178063,32,160,32,224,64,34,5.0,0.0
6965,284892,0,3500,0,4000,500,501,7.0,0.0
69651,18909,0,240,0,280,40,41,6.0,0.0
69652,33595,80,320,80,480,160,82,4.0,0.0
69653,48001,105,630,105,840,210,107,6.0,0.0
6966,336397,500,4000,500,5000,1000,501,8.0,0.0
69660,19540,74,74,74,222,148,76,1.0,0.0
69661,154484,361,1805,361,2527,722,363,5.0,0.0
6967,492536,500,6000,500,7000,1000,501,12.0,0.0
69670,7153,14,70,14,98,28,16,5.0,0.0
69673,905225,1000,13907,1000,15907,2000,1002,13.907,0.0
69679,10068,37,37,37,111,74,39,1.0,0.0
6969,28882,0,575,0,600,25,26,23.0,0.5
69693,4272,6,36,6,48,12,8,6.0,0.0
697,64461,0,378,0,441,63,64,6.0,0.5
6970,322612,0,2716,0,3216,500,501,5.432,0.5
69715,12623,22,132,22,176,44,24,6.0,0.0
6972,1787542,0,22499,0,22999,500,501,44.998,0.0
6973,121569,0,1119,0,1272,153,154,7.314,0.0
69734,1019172,1000,11000,1000,13000,2000,1002,11.0,0.0
69738,10068,37,37,37,111,74,39,1.0,0.0
6974,345446,0,4531,0,5031,500,501,9.062,0.0
69746,2595,0,18,0,24,6,7,3.0,0.0
6975,7313,0,76,0,80,4,5,19.0,0.0
69751,22330,30,270,30,330,60,32,9.0,0.0
6976,5955,0,55,0,66,11,12,5.0,0.0
69762,96612,72,1249,72,1393,144,74,17.347,0.0
69763,4948,17,17,17,51,34,19,1.0,0.0
69768,7433,9,135,9,153,18,11,15.0,0.0
6977,1987,0,15,0,18,3,4,5.0,0.0
69771,256596,1000,1000,1000,3000,2000,1002,1.0,0.0
69774,10217,37,37,37,111,74,39,1.0,0.0
69775,179540,699,699,699,2097,1398,701,1.0,0.0
69776,24347,12,240,12,264,24,14,20.0,0.0
69779,908593,1000,13000,1000,15000,2000,1002,13.0,0.0
6978,423610,500,6500,500,7500,1000,501,13.0,1.0
69783,10836,40,40,40,120,80,42,1.0,0.0
6979,131033,60,1799,60,1919,120,61,29.983,0.0
69790,32191,70,438,70,578,140,72,6.257,0.0
698,13683358,0,119000,0,119500,500,501,238.0,0.0
6980,377798,0,5500,0,6000,500,501,11.0,0.0
69805,322767,146,4672,146,4964,292,148,32.0,0.0
69808,3232,6,33,6,45,12,8,5.5,0.0
6981,111359,0,1304,0,1467,163,164,8.0,0.0
69813,84487,192,1346,192,1730,384,195,7.01,0.0
69815,41044,158,158,158,474,316,160,1.0,0.0
69816,66334,175,579,175,929,350,177,3.309,0.0
6982,249776,408,2764,408,3580,816,409,6.775,0.5
69821,1589,3,9,3,15,6,5,3.0,0.0
69824,4374,5,50,5,60,10,7,10.0,0.0
69825,825613,1000,11050,1000,13050,2000,1002,11.05,1.0
69826,6228,22,22,22,66,44,24,1.0,0.0
69827,5575,11,55,11,77,22,13,5.0,0.0
69828,154914,189,2079,189,2457,378,191,11.0,0.0
6983,2269181,0,21818,0,22255,437,438,49.927,0.5
69831,734006,1000,9111,1000,11111,2000,1002,9.111,0.0
69834,1727,3,9,3,15,6,5,3.0,0.0
69835,185977,713,713,713,2139,1426,715,1.0,0.0
69837,19284,73,73,73,219,146,75,1.0,0.0
69838,852,1,1,1,3,2,3,1.0,0.0
69839,26964,103,103,103,309,206,105,1.0,0.0
6984,345000,0,5013,0,5513,500,501,10.026,1.0
69842,4104,7,35,7,49,14,9,5.0,0.0
6985,1660478,0,35463,0,35963,500,501,70.926,0.0
69858,5149,11,44,11,66,22,13,4.0,0.0
6986,239663,0,3500,0,4000,500,501,7.0,0.0
69861,21332,81,81,81,243,162,83,1.0,0.0
69863,256596,1000,1000,1000,3000,2000,1002,1.0,0.0
69867,7068,11,77,11,99,22,13,7.0,0.0
69869,38740,149,149,149,447,298,151,1.0,0.0
6987,456102,0,8330,0,8820,490,491,17.0,0.0
69871,7591,16,80,16,112,32,18,5.0,0.0
69873,12913,20,160,20,200,40,22,8.0,0.0
69874,2894,5,25,5,35,10,7,5.0,0.0
69875,256596,1000,1000,1000,3000,2000,1002,1.0,0.0
69876,7790,5,160,5,170,10,7,32.0,0.0
69879,3987,10,30,10,50,20,12,3.0,0.0
6988,233817,500,3000,500,4000,1000,501,6.0,0.0
69882,2394623,1000,33478,1000,35478,2000,1002,33.478,0.0
69885,5399,8,48,8,64,16,10,6.0,0.0
69889,2896,7,17,7,31,14,9,2.429,0.0
69890,1564,0,9,0,12,3,4,3.0,0.0
69891,5782,11,55,11,77,22,13,5.0,0.0
69893,19284,73,73,73,219,146,75,1.0,0.0
69895,5941,12,72,12,96,24,14,6.0,0.0
6990,327701,0,4656,0,5156,500,501,9.312,0.0
69900,10068,37,37,37,111,74,39,1.0,0.0
69901,10217,37,37,37,111,74,39,1.0,0.0
69907,5204,18,18,18,54,36,20,1.0,0.0
69908,25172,96,96,96,288,192,98,1.0,0.0
69909,10068,37,37,37,111,74,39,1.0,0.0
6991,260917,0,2679,0,3179,500,501,5.358,0.0
69912,2263439,995,34022,995,37007,2985,1992,34.193,0.0
69917,3717,12,12,12,36,24,14,1.0,0.0
6992,35729,0,320,0,400,80,81,4.0,0.0
69920,6708,6,96,6,108,12,8,16.0,0.0
69921,6534,17,51,17,85,34,19,3.0,0.0
69923,256596,1000,1000,1000,3000,2000,1002,1.0,0.0
69924,288475,437,3059,437,3933,874,439,7.0,0.0
69925,8809,20,80,20,120,40,22,4.0,0.0
6993,380326,500,5500,500,6500,1000,501,11.0,0.0
69931,2644,8,8,8,24,16,10,1.0,0.0
69932,2575,6,18,6,30,12,8,3.0,0.0
69934,1912,3,15,3,21,6,5,5.0,0.0
69936,38740,149,149,149,447,298,151,1.0,0.0
6994,370708,500,5402,500,6402,1000,501,10.804,0.0
69945,2132,6,6,6,18,12,8,1.0,0.0
69948,10068,37,37,37,111,74,39,1.0,0.0
6995,178282,0,3105,0,3389,284,285,10.933,0.0
69950,4516,8,48,8,64,16,10,6.0,0.0
69955,34186,76,304,76,456,152,78,4.0,0.0
69961,25172,96,96,96,288,192,98,1.0,0.0
69963,10068,37,37,37,111,74,39,1.0,0.0
69966,35045,56,392,56,504,112,58,7.0,0.0
69968,10068,37,37,37,111,74,39,1.0,0.0
69969,25557,96,96,96,288,192,98,1.0,0.0
6997,681536,0,12936,0,13436,500,501,25.872,1.0
69971,476359,1000,6000,1000,8000,2000,1002,6.0,0.0
69976,10068,37,37,37,111,74,39,1.0,0.0
6998,310337,458,3972,458,5346,1374,917,8.672,0.5
69984,39337,149,149,149,447,298,151,1.0,0.0
69985,38740,149,149,149,447,298,151,1.0,0.0
69987,38740,149,149,149,447,298,151,1.0,0.0
69989,1443961,1000,10155,1000,13155,3000,2002,10.155,0.0
6999,26752,0,391,0,414,23,24,17.0,0.0
69990,41677,158,158,158,474,316,160,1.0,0.0
69992,3474,5,35,5,45,10,7,7.0,0.0
69994,57629,72,648,72,792,144,74,9.0,0.0
69995,1377,3,3,3,9,6,5,1.0,0.0
69996,3812,6,36,6,48,12,8,6.0,0.0
69997,38740,149,149,149,447,298,151,1.0,0.0
69998,6876,17,51,17,85,34,19,3.0,0.0
69999,20685,9,378,9,396,18,11,42.0,0.0
7,16369964,38908,77824,38908,218930,141106,31088,11.996,0.0
70,7136,28,70,28,119,49,32,3.333,0.0
7000,284904,0,3500,0,4000,500,501,7.0,0.0
70000,1402872,1000,24956,1000,26956,2000,1002,24.956,0.0
70001,7082,6,69,6,81,12,8,11.5,0.5
70004,1288,0,7,0,8,1,2,7.0,0.0
70005,4250,9,36,9,54,18,11,4.0,0.0
70006,1241,2,6,2,10,4,3,3.0,0.0
7001,77018,0,581,0,664,83,84,7.0,0.0
70013,38740,149,149,149,447,298,151,1.0,0.0
70017,39337,149,149,149,447,298,151,1.0,0.0
7002,475452,0,6500,0,7000,500,501,13.0,0.0
70020,12534,0,47,0,94,47,48,1.0,0.0
70028,2937,9,9,9,27,18,11,1.0,0.0
70029,41677,158,158,158,474,316,160,1.0,0.0
7003,870183,500,19500,500,20500,1000,501,39.0,0.0
70031,1249,0,7,0,8,1,2,7.0,0.0
70032,1584254,1000,16000,1000,18000,2000,1002,16.0,0.0
70037,894810,1000,13933,1000,15933,2000,1002,13.933,0.0
70039,38740,149,149,149,447,298,151,1.0,0.0
7004,117193,0,1413,0,1570,157,158,9.0,0.0
70046,1734502,1000,27286,1000,29286,2000,1002,27.286,0.0
7005,477745,0,8581,0,9081,500,501,17.162,0.0
7006,892357,500,12399,500,13399,1000,501,24.798,0.5
70063,7529,0,99,0,108,9,10,11.0,0.0
70075,10217,37,37,37,111,74,39,1.0,0.0
70077,9366,18,81,18,117,36,20,4.5,0.0
70081,10068,37,37,37,111,74,39,1.0,0.0
70084,2972,5,25,5,35,10,7,5.0,0.0
70085,19577,73,73,73,219,146,75,1.0,0.0
7009,1550229,500,20796,500,21796,1000,501,41.592,0.0
70091,624057,1000,9430,1000,11430,2000,1002,9.43,0.0
70099,1114,1,5,1,7,2,3,5.0,0.0
7010,322249,0,4500,0,5000,500,501,9.0,0.0
70100,1485,2,12,2,16,4,4,6.0,0.0
70102,12628,47,47,47,141,94,49,1.0,0.0
70106,1250,0,7,0,8,1,2,7.0,0.0
70108,138324,538,538,538,1614,1076,540,1.0,0.0
7011,1157491,0,23000,0,23500,500,501,46.0,1.0
70112,24916,95,95,95,285,190,97,1.0,0.0
70113,24916,95,95,95,285,190,97,1.0,0.0
70114,923548,1000,14969,1000,16969,2000,1002,14.969,0.0
70115,2642,4,28,4,36,8,6,7.0,0.0
70117,21846,33,297,33,363,66,35,9.0,0.0
7012,117406,61,1267,61,1412,145,86,15.083,0.0
70124,59988,232,232,232,696,464,234,1.0,0.0
70126,19284,73,73,73,219,146,75,1.0,0.0
7013,155703,0,1600,0,1920,320,321,5.0,0.0
70133,12628,47,47,47,141,94,49,1.0,0.0
70136,3591,5,45,5,55,10,7,9.0,0.0
7014,78809,0,891,0,972,81,82,11.0,0.0
70144,1099,0,4,0,5,1,2,4.0,0.0
70148,2191,3,21,3,27,6,5,7.0,1.0
70150,256596,1000,1000,1000,3000,2000,1002,1.0,0.5
70152,256596,1000,1000,1000,3000,2000,1002,1.0,0.0
70153,25172,96,96,96,288,192,98,1.0,0.0
70155,1364,3,3,3,9,6,5,1.0,0.0
70157,1725,3,12,3,18,6,5,4.0,0.0
70159,1897,5,5,5,15,10,7,1.0,0.0
70160,11400,16,140,16,172,32,18,8.75,0.0
70163,2552,4,22,4,30,8,6,5.5,0.0
70165,256596,1000,1000,1000,3000,2000,1002,1.0,0.0
70166,3473,7,28,7,42,14,9,4.0,0.0
70167,11348,42,42,42,126,84,44,1.0,0.0
70168,8276,30,30,30,90,60,32,1.0,1.0
70169,2268,5,15,5,25,10,7,3.0,0.0
7017,120824,0,1386,0,1540,154,155,9.0,0.0
70170,256596,1000,1000,1000,3000,2000,1002,1.0,0.0
70173,403543,412,6180,412,7004,824,413,15.0,0.0
702,368363,0,5678,0,6178,500,501,11.356,0.0
7020,8343,0,29,0,34,5,6,5.8,0.0
7021,276884,0,3324,0,3824,500,501,6.648,0.0
7023,125856,66,1362,66,1518,156,92,15.133,0.0
70240,13397,32,160,32,224,64,33,5.0,0.0
70248,6824,15,75,15,105,30,16,5.0,0.0
7027,464174,0,9000,0,9500,500,501,18.0,0.0
703,3457,0,43,0,48,5,6,8.6,0.0
7031,647596,500,9500,500,10500,1000,501,19.0,0.0
70318,3650,7,35,7,49,14,8,5.0,0.0
7032,1135098,484,17341,484,18309,968,485,35.829,0.0
70326,36090,110,330,110,550,220,111,3.0,0.0
7033,339508,0,4971,0,5471,500,501,9.942,0.0
7034,311630,0,4000,0,4500,500,501,8.0,0.0
70348,3600,7,35,7,49,14,8,5.0,0.0
7035,1950603,0,56200,0,56700,500,501,112.4,0.0
70350,243583,1000,1000,1000,3000,2000,1001,1.0,0.0
7036,386877,376,5059,376,5811,752,377,13.455,0.0
70366,247584,1000,1000,1000,3000,2000,1001,1.0,0.0
7037,547144,0,9972,0,10472,500,501,19.944,0.0
70371,46793,106,424,106,636,212,107,4.0,0.0
70382,30326,56,452,56,564,112,57,8.071,0.0
7039,621197,0,9065,0,9565,500,501,18.13,0.5
7040,341898,0,4500,0,5000,500,501,9.0,0.0
70403,5387,14,42,14,70,28,15,3.0,0.0
70405,39364,106,318,106,530,212,107,3.0,0.0
70406,6164,11,66,11,88,22,12,6.0,0.0
7041,72597,0,918,0,969,51,52,18.0,0.0
7042,8236,0,106,0,115,9,10,11.778,0.0
70428,6089,14,56,14,84,28,15,4.0,0.0
7043,347039,0,4500,0,5000,500,501,9.0,0.0
7044,106344,56,1198,56,1334,136,82,14.975,0.0
70441,8845,34,34,34,102,68,35,1.0,0.0
70445,5081,14,42,14,70,28,15,3.0,0.0
7045,28941,65,260,65,390,130,66,4.0,0.0
70456,3495,9,27,9,45,18,10,3.0,0.0
70458,243583,1000,1000,1000,3000,2000,1001,1.0,0.0
7046,75579,147,1029,147,1323,294,148,7.0,0.0
70462,243583,1000,1000,1000,3000,2000,1001,1.0,0.0
70467,27313,110,110,110,330,220,111,1.0,0.0
7047,304676,0,4000,0,4500,500,501,8.0,0.0
70473,13462,53,53,53,159,106,54,1.0,0.0
70474,243583,1000,1000,1000,3000,2000,1001,1.0,0.0
7048,10991426,0,227487,0,227987,500,501,454.974,0.0
70480,27754,110,110,110,330,220,111,1.0,0.0
7049,17286,37,178,37,252,74,38,4.811,0.0
70494,4345,10,40,10,60,20,11,4.0,0.0
7050,465652,0,4000,0,4500,500,501,8.0,0.0
70502,354046,515,5680,515,6710,1030,517,11.029,0.5
7051,343726,0,4965,0,5465,500,501,9.93,0.0
70513,243583,1000,1000,1000,3000,2000,1001,1.0,0.0
70516,243583,1000,1000,1000,3000,2000,1001,1.0,0.0
7052,301307,0,3500,0,4000,500,501,7.0,0.0
70521,243583,1000,1000,1000,3000,2000,1001,1.0,0.0
70527,3985,14,14,14,42,28,15,1.0,0.0
70528,1024602,1511,15969,1511,18991,3022,1513,10.568,0.0
7053,307377,0,4000,0,4500,500,501,8.0,0.0
70530,4042,14,14,14,42,28,15,1.0,0.0
70531,795713,1000,12918,1000,14918,2000,1001,12.918,0.0
70532,3985,14,14,14,42,28,15,1.0,0.0
70534,243583,1000,1000,1000,3000,2000,1001,1.0,0.0
70535,243583,1000,1000,1000,3000,2000,1001,1.0,0.0
70537,2284,7,7,7,21,14,8,1.0,0.0
7054,128321,0,1589,0,1816,227,228,7.0,0.0
70540,27313,110,110,110,330,220,111,1.0,0.0
70545,243583,1000,1000,1000,3000,2000,1001,1.0,0.0
70546,243583,1000,1000,1000,3000,2000,1001,1.0,0.0
70549,247584,1000,1000,1000,3000,2000,1001,1.0,0.0
7055,198246,0,2000,0,2500,500,501,4.0,0.0
70550,247584,1000,1000,1000,3000,2000,1001,1.0,0.0
70551,6415,24,24,24,72,48,25,1.0,0.0
70552,3499,12,12,12,36,24,13,1.0,0.0
70553,247584,1000,1000,1000,3000,2000,1001,1.0,0.0
70554,3985,14,14,14,42,28,15,1.0,0.0
70555,3985,14,14,14,42,28,15,1.0,0.0
70557,247584,1000,1000,1000,3000,2000,1001,1.0,0.0
70559,3256,11,11,11,33,22,12,1.0,0.0
7056,371189,0,6500,0,7000,500,501,13.0,0.0
70560,1555,4,4,4,12,8,5,1.0,0.0
70564,1078,2,2,2,6,4,3,1.0,0.0
70568,3054,10,10,10,30,20,11,1.0,0.0
70569,247584,1000,1000,1000,3000,2000,1001,1.0,0.0
7057,163277,0,2270,0,2472,202,203,11.238,0.5
70571,243583,1000,1000,1000,3000,2000,1001,1.0,0.0
70572,243583,1000,1000,1000,3000,2000,1001,1.0,0.0
70574,243583,1000,1000,1000,3000,2000,1001,1.0,0.0
70575,243583,1000,1000,1000,3000,2000,1001,1.0,0.0
70576,3985,14,14,14,42,28,15,1.0,0.0
70577,243583,1000,1000,1000,3000,2000,1001,1.0,0.0
70578,27313,110,110,110,330,220,111,1.0,0.0
70579,243583,1000,1000,1000,3000,2000,1001,1.0,0.0
7058,6055,0,36,0,60,24,25,3.0,0.5
70582,86362,353,353,353,1059,706,354,1.0,0.0
70584,4042,14,14,14,42,28,15,1.0,0.0
70585,9331,36,36,36,108,72,37,1.0,0.5
70586,247584,1000,1000,1000,3000,2000,1001,1.0,0.0
70589,1956,4,12,4,20,8,5,3.0,0.0
7059,334596,500,5000,500,6000,1000,501,10.0,0.0
70598,3985,14,14,14,42,28,15,1.0,0.0
70599,243583,1000,1000,1000,3000,2000,1001,1.0,0.0
7061,319934,0,3892,0,3964,72,73,54.056,0.0
70610,1186,2,6,2,10,4,3,3.0,0.0
70614,243583,1000,1000,1000,3000,2000,1001,1.0,0.0
70615,247584,1000,1000,1000,3000,2000,1001,1.0,0.0
70617,852210,846,11042,846,13580,2538,1287,13.052,0.0
70620,243583,1000,1000,1000,3000,2000,1001,1.0,0.0
70622,76156,311,311,311,933,622,312,1.0,0.0
70625,6901,26,26,26,78,52,27,1.0,0.5
70627,243583,1000,1000,1000,3000,2000,1001,1.0,0.0
70628,1555,4,4,4,12,8,5,1.0,0.0
70629,243583,1000,1000,1000,3000,2000,1001,1.0,0.0
7063,161697,455,1365,455,2275,910,456,3.0,1.0
70630,247584,1000,1000,1000,3000,2000,1001,1.0,0.0
70633,247584,1000,1000,1000,3000,2000,1001,1.0,0.0
70634,3301,11,11,11,33,22,12,1.0,0.0
70637,243583,1000,1000,1000,3000,2000,1001,1.0,0.0
70638,247584,1000,1000,1000,3000,2000,1001,1.0,0.0
70639,73430,91,1092,91,1274,182,92,12.0,0.0
7064,146760,320,1600,320,2240,640,321,5.0,0.0
70641,9750,23,98,23,144,46,24,4.261,0.0
70642,3256,11,11,11,33,22,12,1.0,0.0
70647,2066,6,6,6,18,12,7,1.0,0.0
7065,386965,454,6614,454,7522,908,455,14.568,0.0
70651,454342,568,6815,568,7951,1136,569,11.998,0.0
70652,243583,1000,1000,1000,3000,2000,1001,1.0,0.0
70654,4289,15,15,15,45,30,16,1.0,0.0
70655,114550,469,469,469,1407,938,470,1.0,0.0
70656,243583,1000,1000,1000,3000,2000,1001,1.0,0.0
70657,1528216,1000,33871,1000,35871,2000,1001,33.871,0.0
70658,140880,568,568,568,1704,1136,569,1.0,0.0
7066,6135374,0,171343,0,171843,500,501,342.686,0.0
70660,560830,1000,7000,1000,9000,2000,1001,7.0,0.0
70662,22696,91,91,91,273,182,92,1.0,0.0
70663,247584,1000,1000,1000,3000,2000,1001,1.0,0.0
70664,243583,1000,1000,1000,3000,2000,1001,1.0,0.0
70665,16378,65,65,65,195,130,66,1.0,0.0
70666,243583,1000,1000,1000,3000,2000,1001,1.0,0.0
7067,378791,0,6049,0,6390,341,342,17.739,0.0
7070,547818,0,9500,0,10000,500,501,19.0,0.6666666666666666
7071,376433,0,5500,0,6000,500,501,11.0,0.0
7072,466655,0,4000,0,4500,500,501,8.0,0.0
70720,1314856,0,14990,0,15990,1000,1001,14.99,0.0
70723,1345404,0,18000,0,19000,1000,1001,18.0,1.0
70728,518913,0,3054,0,3102,48,49,63.625,0.0
70729,235575,1000,1000,1000,3000,2000,1001,1.0,0.0
7073,56481,0,1232,0,1260,28,29,44.0,0.0
70736,91050,385,385,385,1155,770,386,1.0,0.0
7074,325080,0,4000,0,4500,500,501,8.0,0.0
70740,1946212,0,45492,0,46492,1000,1001,45.492,0.0
70743,91050,385,385,385,1155,770,386,1.0,0.0
7075,633209,0,9913,0,10413,500,501,19.826,0.5
70759,310316,0,4200,0,4800,600,601,7.0,0.0
70764,16828,68,68,68,204,136,69,1.0,0.0
70766,328728,0,8295,0,8765,470,471,17.649,0.0
70768,98088,408,408,408,1224,816,409,1.0,0.0
7077,17986,0,175,0,210,35,36,5.0,0.0
70773,233575,0,1000,0,2000,1000,1001,1.0,0.5
7078,2225798,1254,24747,1254,27688,2941,1689,14.669,0.0
7080,305534,411,3731,411,4553,822,412,9.078,0.0
7081,288408,0,5000,0,5500,500,501,10.0,0.0
70812,114080,483,483,483,1449,966,484,1.0,0.0
70814,353659,1000,3964,1000,5964,2000,1001,3.964,0.0
70826,88700,375,375,375,1125,750,376,1.0,0.0
70828,76420,68,1496,68,1632,136,69,22.0,0.0
7083,563258,500,8738,500,9738,1000,501,17.476,0.0
70831,11233,13,131,13,157,26,14,10.077,0.0
7084,286590,0,3500,0,4000,500,501,7.0,0.0
70840,52421,60,660,60,780,120,61,11.0,0.0
70841,114080,483,483,483,1449,966,484,1.0,0.0
70843,95639,0,408,0,816,408,409,1.0,0.0
70850,582163,0,7917,0,8917,1000,1001,7.917,0.0
70855,68124,0,815,0,978,163,164,5.0,0.0
70862,235575,1000,1000,1000,3000,2000,1001,1.0,0.0
70863,235575,1000,1000,1000,3000,2000,1001,1.0,0.0
70864,235575,1000,1000,1000,3000,2000,1001,1.0,0.0
70865,492288,0,6000,0,7000,1000,1001,6.0,0.0
7087,382875,0,6999,0,7499,500,501,13.998,0.0
70870,239576,1000,1000,1000,3000,2000,1001,1.0,0.0
70875,523673,1000,7000,1000,9000,2000,1001,7.0,0.0
70880,1517699,0,31000,0,32000,1000,1001,31.0,0.0
70883,122516,150,1950,150,2250,300,151,13.0,0.0
70885,2086326,22,88,22,154,66,45,4.0,0.5
70886,63933,0,1496,0,1564,68,69,22.0,0.0
7089,51595,0,433,0,521,88,89,4.92,0.0
7091,172421,0,2847,0,3066,219,220,13.0,0.0
70910,235575,1000,1000,1000,3000,2000,1001,1.0,0.0
70911,5004394,67,1280,67,1414,134,68,19.104,0.0
70912,84226,350,350,350,1050,700,351,1.0,0.0
70913,239576,1000,1000,1000,3000,2000,1001,1.0,0.0
70914,239576,1000,1000,1000,3000,2000,1001,1.0,0.0
70915,235575,1000,1000,1000,3000,2000,1001,1.0,0.0
70916,80475,340,340,340,1020,680,341,1.0,0.0
70917,235575,1000,1000,1000,3000,2000,1001,1.0,0.0
70918,80475,340,340,340,1020,680,341,1.0,0.0
70919,235575,1000,1000,1000,3000,2000,1001,1.0,0.0
7092,335846,0,4496,0,4996,500,501,8.992,0.0
70920,158026,0,670,0,1340,670,671,1.0,0.0
70921,2183,4,16,4,24,8,5,4.0,1.0
70922,67634,40,840,40,920,80,41,21.0,0.0
70923,235575,1000,1000,1000,3000,2000,1001,1.0,0.0
70924,665245,1000,9000,1000,11000,2000,1001,9.0,0.5
70925,2690,9,9,9,27,18,10,1.0,0.0
70926,235575,1000,1000,1000,3000,2000,1001,1.0,0.0
70927,239576,1000,1000,1000,3000,2000,1001,1.0,0.0
70928,88700,375,375,375,1125,750,376,1.0,0.0
70929,235575,1000,1000,1000,3000,2000,1001,1.0,0.0
7093,259916,0,2679,0,3179,500,501,5.358,0.0
70930,88700,375,375,375,1125,750,376,1.0,0.0
70931,239576,1000,1000,1000,3000,2000,1001,1.0,0.0
70932,235575,1000,1000,1000,3000,2000,1001,1.0,0.0
70933,1045,2,2,2,6,4,3,1.0,0.0
70935,235575,1000,1000,1000,3000,2000,1001,1.0,0.0
70936,233575,0,1000,0,2000,1000,1001,1.0,0.0
70937,239576,1000,1000,1000,3000,2000,1001,1.0,0.0
70938,3625643,18,216,18,252,36,19,12.0,0.5
70939,239576,1000,1000,1000,3000,2000,1001,1.0,0.0
70941,24035,2,312,2,316,4,3,156.0,0.0
70943,16320,67,67,67,201,134,68,1.0,0.0
70944,8019,20,90,20,130,40,21,4.5,0.0
70945,1045,2,2,2,6,4,3,1.0,0.0
70946,158025,670,670,670,2010,1340,671,1.0,0.0
70947,235575,1000,1000,1000,3000,2000,1001,1.0,0.0
70948,6920,27,27,27,81,54,28,1.0,0.0
70949,235575,1000,1000,1000,3000,2000,1001,1.0,0.0
7095,445225,0,6500,0,7000,500,501,13.0,0.0
70951,235575,1000,1000,1000,3000,2000,1001,1.0,0.0
70952,1914,2,16,2,20,4,3,8.0,0.0
70953,5745,22,22,22,66,44,23,1.0,0.0
70954,233575,0,1000,0,2000,1000,1001,1.0,0.0
70955,40147,35,555,35,625,70,36,15.857,0.0
70956,1610511,1000,20141,1000,22141,2000,1001,20.141,0.0
70957,235575,1000,1000,1000,3000,2000,1001,1.0,0.0
70958,235575,1000,1000,1000,3000,2000,1001,1.0,0.0
70959,16320,67,67,67,201,134,68,1.0,0.0
7096,376141,0,5280,0,5500,220,221,24.0,0.0
70960,239576,1000,1000,1000,3000,2000,1001,1.0,0.0
70961,396715,240,5011,240,5491,480,241,20.879,0.0
70962,91050,385,385,385,1155,770,386,1.0,0.0
70963,233575,0,1000,0,2000,1000,1001,1.0,0.0
70964,39309,27,556,27,610,54,28,20.593,0.0
70966,239576,1000,1000,1000,3000,2000,1001,1.0,0.0
70967,235575,1000,1000,1000,3000,2000,1001,1.0,0.5
70968,239576,1000,1000,1000,3000,2000,1001,1.0,0.0
70969,235575,1000,1000,1000,3000,2000,1001,1.0,0.0
7097,137982,0,1726,0,1899,173,174,9.977,0.0
70970,91050,385,385,385,1155,770,386,1.0,0.0
70971,252155,294,3513,294,4101,588,295,11.949,0.0
70972,74279,68,1496,68,1632,136,69,22.0,0.0
70973,4126,10,30,10,50,20,11,3.0,0.0
70974,235575,1000,1000,1000,3000,2000,1001,1.0,0.0
70975,16828,68,68,68,204,136,69,1.0,0.0
70976,239576,1000,1000,1000,3000,2000,1001,1.0,0.0
70977,101987,0,1650,0,1800,150,151,11.0,0.0
70978,235575,1000,1000,1000,3000,2000,1001,1.0,0.0
70979,1071206,781,21868,781,23430,1562,782,28.0,0.0
7098,814546,500,13406,500,14406,1000,501,26.812,0.0
70980,4969,6,54,6,66,12,7,9.0,0.0
70981,235575,1000,1000,1000,3000,2000,1001,1.0,0.0
70982,235575,1000,1000,1000,3000,2000,1001,1.0,0.0
70983,1912,2,16,2,20,4,3,8.0,0.0
70984,151004,135,3105,135,3375,270,136,23.0,0.0
70985,21038,0,330,0,360,30,31,11.0,0.0
70987,35825,150,150,150,450,300,151,1.0,0.0
70988,41871,0,660,0,720,60,61,11.0,0.0
70989,10780,0,165,0,180,15,16,11.0,0.0
7099,418890,0,6622,0,7122,500,501,13.244,0.0
70990,5356,20,20,20,60,40,21,1.0,0.0
70991,235575,1000,1000,1000,3000,2000,1001,1.0,0.0
70992,17536,10,210,10,230,20,11,21.0,0.0
70993,1515,4,4,4,12,8,5,1.0,0.0
70994,5275,20,20,20,60,40,21,1.0,0.0
70995,235575,1000,1000,1000,3000,2000,1001,1.0,0.0
70996,14675,60,60,60,180,120,61,1.0,0.0
70997,16589,67,67,67,201,134,68,1.0,1.0
70998,4161,15,15,15,45,30,16,1.0,0.0
70999,16320,67,67,67,201,134,68,1.0,0.0
71,5485765,9623,67355,9623,86599,19244,9624,6.999,0.0
710,438342,0,9000,0,9500,500,501,18.0,0.0
7100,163974,67,2217,67,2351,134,68,33.09,0.0
71000,16320,67,67,67,201,134,68,1.0,0.0
71001,35825,150,150,150,450,300,151,1.0,0.0
71002,235575,1000,1000,1000,3000,2000,1001,1.0,0.0
71003,2966,10,10,10,30,20,11,1.0,0.0
71004,7625,30,30,30,90,60,31,1.0,0.0
71005,16555,68,68,68,204,136,69,1.0,0.0
71006,235575,1000,1000,1000,3000,2000,1001,1.0,0.0
71007,14675,60,60,60,180,120,61,1.0,0.0
71009,14916,60,60,60,180,120,61,1.0,0.0
71010,7625,30,30,30,90,60,31,1.0,0.0
71011,14675,60,60,60,180,120,61,1.0,0.0
71012,41969,60,660,60,780,120,61,11.0,0.0
71013,35825,150,150,150,450,300,151,1.0,0.0
71014,239579,1000,1000,1000,3000,2000,1001,1.0,0.0
71015,591673,1000,7356,1000,10356,3000,2002,4.386,0.0
71019,521394,0,7040,0,8040,1000,1001,7.04,0.0
7102,340164,0,4000,0,4500,500,501,8.0,0.0
71028,6369,0,64,0,80,16,17,4.0,0.0
71029,201612,336,3472,336,4144,672,338,10.333,0.0
7103,864862,0,12500,0,13000,500,501,25.0,0.0
7104,5071,0,36,0,48,12,13,3.0,0.5
71044,36117,0,365,0,487,122,123,2.992,0.5
7105,321259,0,4500,0,5000,500,501,9.0,0.0
71054,704072,0,9000,0,10000,1000,1001,9.0,0.0
7106,187074,500,2500,500,3500,1000,501,5.0,0.0
71062,710169,1000,9000,1000,11000,2000,1001,9.0,0.0
71069,3256,0,24,0,32,8,9,3.0,0.0
7107,286902,0,2355,0,2679,324,294,14.537,0.5
71071,369232,0,2292,0,3292,1000,1001,2.292,0.0
71074,589319,1000,8000,1000,10000,2000,1001,8.0,0.0
71075,588792,1000,8000,1000,10000,2000,1001,8.0,0.0
71076,597909,1000,8000,1000,10000,2000,1001,8.0,0.0
71077,593340,1000,8000,1000,10000,2000,1001,8.0,0.0
71078,760339,1000,13000,1000,15000,2000,1001,13.0,0.0
71079,138783,0,2388,0,2587,199,200,12.0,0.0
7108,367559,500,7076,500,8076,1000,501,14.152,0.0
71080,215111,72,2116,72,2533,417,263,29.389,0.0
71083,271611,1000,1000,1000,3000,2000,1001,1.0,0.0
71088,1293461,1000,21355,1000,23355,2000,1001,21.355,0.0
7109,683480,0,15611,0,16111,500,501,31.222,0.0
71091,756968,1000,11688,1000,13688,2000,1001,11.688,0.0
71094,635450,0,10080,0,10560,480,481,21.0,0.0
71097,1941,3,15,3,21,6,4,5.0,0.0
71098,1236740,1000,21361,1000,23361,2000,1001,21.361,0.0
711,50314,115,805,115,1035,230,116,7.0,0.0
71100,855701,1000,13992,1000,15992,2000,1001,13.992,0.0
71104,3600,7,28,7,42,14,8,4.0,0.0
71108,14506069,892,16087,892,17871,1784,893,18.035,0.0
71113,2075,4,12,4,20,8,5,3.0,0.0
7112,427038,500,8500,500,9500,1000,501,17.0,0.0
71121,275612,1000,1000,1000,3000,2000,1001,1.0,0.0
71122,271611,1000,1000,1000,3000,2000,1001,1.0,0.0
7114,36006,0,672,0,714,42,43,16.0,0.0
7115,620109,0,8669,0,9169,500,501,17.338,0.0
7116,404008,0,6000,0,6500,500,501,12.0,0.0
7117,56425,0,914,0,973,59,60,15.492,0.0
7118,162320,270,2160,270,2700,540,271,8.0,0.0
7119,455990,0,8923,0,9423,500,501,17.846,0.75
7120,840587,500,16687,500,17687,1000,501,33.374,0.0
7121,63519,0,655,0,786,131,132,5.0,0.0
7122,20750,0,298,0,320,22,23,13.545,0.0
7124,92440,0,1003,0,1123,120,121,8.358,0.0
7125,126066,0,1561,0,1784,223,224,7.0,0.0
7126,246008,0,2773,0,3273,500,501,5.546,0.0
7128,216705,0,2099,0,2395,296,297,7.091,0.0
7129,493102,0,8166,0,8666,500,501,16.332,0.5
7130,631369,0,12000,0,12500,500,501,24.0,0.0
71307,328052,669,4014,669,5352,1338,670,6.0,0.0
7131,1797578,0,22997,0,23497,500,501,45.994,0.0
7132,301755,0,3500,0,4000,500,501,7.0,0.0
7133,442943,0,9000,0,9500,500,501,18.0,0.0
71338,457228,1000,5000,1000,7000,2000,1001,5.0,0.0
71339,3022443,1000,56000,1000,58000,2000,1001,56.0,0.0
7134,127095,0,500,0,1000,500,501,1.0,0.0
71342,1321678,1000,19984,1000,21984,2000,1001,19.984,0.75
71343,247584,1000,1000,1000,3000,2000,1001,1.0,0.5
71344,755445,1000,10000,1000,12000,2000,1001,10.0,0.5
71346,1309746,1000,19863,1000,21863,2000,1001,19.863,0.0
71347,1381874,0,36000,0,37000,1000,1001,36.0,0.0
71348,160768,289,2601,289,3179,578,290,9.0,0.0
71349,181802,0,2085,0,2502,417,418,5.0,0.0
71351,79814,162,951,162,1275,324,163,5.87,0.0
71354,599762,0,8000,0,9000,1000,1001,8.0,0.0
71355,936131,1000,13943,1000,15943,2000,1001,13.943,0.0
71356,616366,0,8000,0,9000,1000,1001,8.0,0.0
71359,685016,1000,10000,1000,12000,2000,1001,10.0,0.0
7136,197584,0,5917,0,5973,56,57,105.661,0.0
71364,1971031,1000,31132,1000,33132,2000,1001,31.132,0.0
71367,243583,1000,1000,1000,3000,2000,1001,1.0,0.0
71369,247584,1000,1000,1000,3000,2000,1001,1.0,0.0
7137,1465098,0,29000,0,29500,500,501,58.0,0.0
71370,415580,1000,6000,1000,8000,2000,1001,6.0,0.0
71372,1315717,0,35000,0,36000,1000,1001,35.0,0.0
71373,13219,52,52,52,156,104,53,1.0,0.0
71374,1186689,1000,16990,1000,18990,2000,1001,16.99,0.0
71376,541641,0,7000,0,8000,1000,1001,7.0,0.0
71377,18002,0,276,0,299,23,24,12.0,0.0
71378,22748,0,110,0,165,55,56,2.0,0.5
71379,403660,0,5052,0,5894,842,843,6.0,0.0
7138,377772,0,5390,0,5890,500,501,10.78,0.0
71380,243583,1000,1000,1000,3000,2000,1001,1.0,0.0
71382,29274,52,364,52,468,104,53,7.0,0.0
71383,1110777,0,14154,0,14494,340,341,41.629,0.0
71384,465927,0,5814,0,6783,969,970,6.0,0.5
71385,550390,0,7000,0,8000,1000,1001,7.0,0.0
71387,49445,0,612,0,714,102,103,6.0,0.0
71389,35611,0,405,0,486,81,82,5.0,0.0
7139,769960,0,11092,0,11328,236,237,47.0,0.0
71394,367457,0,4830,0,5520,690,691,7.0,0.0
71395,243583,1000,1000,1000,3000,2000,1001,1.0,0.0
71396,483973,0,7902,0,8276,374,375,21.128,0.0
71397,164283,0,2128,0,2432,304,305,7.0,0.0
71398,216848,282,2800,282,3364,564,283,9.929,0.0
714,414945,0,8500,0,9000,500,501,17.0,0.0
7140,269132,0,4235,0,4735,500,501,8.47,0.0
71402,231627,0,2850,0,3325,475,476,6.0,0.0
71404,491921,0,6000,0,7000,1000,1001,6.0,0.0
71406,343893,0,4200,0,4900,700,701,6.0,0.0
71408,698045,1000,7911,1000,9911,2000,1001,7.911,0.5
71409,49579,42,756,42,840,84,43,18.0,0.0
7141,108752,0,996,0,1245,249,250,4.0,0.0
71411,587979,0,8000,0,9000,1000,1001,8.0,0.0
71412,18048,0,200,0,240,40,41,5.0,0.0
71416,370192,0,4542,0,5299,757,758,6.0,0.0
71417,1605388,1000,27000,1000,29000,2000,1001,27.0,0.0
71418,566802,1000,6755,1000,8755,2000,1001,6.755,0.0
7142,212436,0,2000,0,2500,500,501,4.0,0.5
71420,488384,0,6260,0,7260,1000,1001,6.26,0.0
71421,243583,1000,1000,1000,3000,2000,1001,1.0,0.0
71424,50564329,1000,8000,1000,10000,2000,1001,8.0,0.0
71425,353009,0,4272,0,4984,712,713,6.0,0.0
71426,542082,0,7000,0,8000,1000,1001,7.0,0.0
71428,593218,0,8000,0,9000,1000,1001,8.0,0.0
7143,52152,0,678,0,763,85,86,7.976,0.0
71432,16347,23,276,23,322,46,24,12.0,0.0
71433,502255,0,6000,0,7000,1000,1001,6.0,0.0
71438,61144,0,750,0,875,125,126,6.0,0.0
7144,236635,500,2500,500,3500,1000,501,5.0,0.0
71440,920518,1000,13953,1000,15953,2000,1001,13.953,0.5
71441,159064,0,1884,0,2198,314,315,6.0,0.0
71445,121595,0,1518,0,1771,253,254,6.0,0.0
71446,235304,35,210,35,280,70,36,6.0,0.5
71447,481391,337,6680,337,7354,674,338,19.822,0.0
7145,18681,0,162,0,204,42,43,3.857,0.0
71450,338110,0,4176,0,4872,696,697,6.0,0.0
71458,42671,0,522,0,609,87,88,6.0,0.75
71459,243583,1000,1000,1000,3000,2000,1001,1.0,0.0
7146,2609758,1498,27730,1498,31226,3496,2000,13.879,0.0
71463,15950,38,152,38,228,76,39,4.0,0.0
71464,247584,1000,1000,1000,3000,2000,1001,1.0,0.0
71467,1022653,0,17000,0,18000,1000,1001,17.0,0.0
7147,105996,0,1596,0,1647,51,52,31.294,0.0
71471,40637,70,490,70,630,140,71,7.0,1.0
71473,34977,50,500,50,600,100,51,10.0,0.0
71474,100288,204,1224,204,1632,408,205,6.0,0.0
71476,183576,0,2380,0,2720,340,341,7.0,1.0
71478,173798,0,2172,0,2534,362,363,6.0,0.0
71479,295249,0,3594,0,4193,599,600,6.0,0.5
7148,32375,80,320,80,480,160,81,4.0,0.0
71483,104238,119,1426,119,1664,238,120,11.983,0.0
71484,573892,0,8000,0,9000,1000,1001,8.0,0.0
71486,243583,1000,1000,1000,3000,2000,1001,1.0,0.0
7149,324420,500,4500,500,5500,1000,501,9.0,0.0
71490,136081,0,1785,0,2040,255,256,7.0,0.0
71491,92731,0,1211,0,1384,173,174,7.0,0.0
71492,61069,0,700,0,840,140,141,5.0,0.0
71494,247584,1000,1000,1000,3000,2000,1001,1.0,0.5
71495,86349,0,1056,0,1232,176,177,6.0,0.0
71496,247584,1000,1000,1000,3000,2000,1001,1.0,0.0
71497,54824,0,654,0,763,109,110,6.0,0.0
71499,243583,1000,1000,1000,3000,2000,1001,1.0,0.0
715,349093,0,7055,0,7470,415,416,17.0,0.0
7150,396897,0,7000,0,7500,500,501,14.0,0.0
71501,617852,1000,9000,1000,11000,2000,1001,9.0,0.0
71507,339763,0,4116,0,4802,686,687,6.0,0.0
71508,306188,0,3990,0,4560,570,571,7.0,0.5
71509,345409,0,4296,0,5012,716,717,6.0,0.0
7151,376916,500,5000,500,6000,1000,501,10.0,0.0
71511,247584,1000,1000,1000,3000,2000,1001,1.0,0.0
71512,80299,0,990,0,1155,165,166,6.0,0.0
71515,25880,20,160,20,200,40,21,8.0,0.0
7152,5969,0,55,0,66,11,12,5.0,0.0
71522,167128,0,2058,0,2401,343,344,6.0,0.0
71527,243583,1000,1000,1000,3000,2000,1001,1.0,0.0
7153,1144465,0,23000,0,23500,500,501,46.0,0.0
71530,111709,220,1320,220,1760,440,221,6.0,0.0
71534,243583,1000,1000,1000,3000,2000,1001,1.0,0.0
71537,243583,1000,1000,1000,3000,2000,1001,1.0,0.0
71541,152056,0,1860,0,2170,310,311,6.0,0.0
71543,66602,0,828,0,966,138,139,6.0,0.0
71544,1317443,0,24833,0,25833,1000,1001,24.833,0.0
71547,35521,0,432,0,504,72,73,6.0,0.0
71549,301985,0,3654,0,4263,609,610,6.0,0.0
7155,249371,0,4000,0,4500,500,501,8.0,0.0
71552,19410,0,234,0,273,39,40,6.0,0.0
71558,364494,0,4494,0,5243,749,750,6.0,0.0
71559,243583,1000,1000,1000,3000,2000,1001,1.0,0.0
7156,83041,0,1064,0,1216,152,153,7.0,0.0
71560,1363353,99,693,99,891,198,100,7.0,0.0
71561,202629,0,2472,0,2884,412,413,6.0,0.0
71564,146198,0,1918,0,2192,274,275,7.0,0.0
7157,325218,0,4000,0,4500,500,501,8.0,0.0
71576,49021,0,600,0,700,100,101,6.0,0.0
7158,9925,5,190,5,200,10,6,38.0,0.0
71580,457886,1000,5000,1000,7000,2000,1001,5.0,0.0
71582,707910,0,11000,0,12000,1000,1001,11.0,0.0
71588,70810,289,289,289,867,578,290,1.0,0.0
7159,1615811,0,32104,0,32604,500,501,64.208,0.0
71591,223561,0,2790,0,3255,465,466,6.0,0.0
71595,243583,1000,1000,1000,3000,2000,1001,1.0,0.0
716,800893,0,6000,0,6500,500,501,12.0,0.0
7160,5967,8,64,8,88,24,18,4.0,0.0
71600,243583,1000,1000,1000,3000,2000,1001,1.0,0.0
71601,23054039,57,684,57,798,114,58,12.0,0.0
71604,756392,1000,12533,1000,14533,2000,1001,12.533,0.0
71605,56679,0,696,0,812,116,117,6.0,0.0
7161,125355,0,1200,0,1440,240,241,5.0,0.0
71610,158070,0,1932,0,2254,322,323,6.0,0.0
71612,7499645,330,7727,330,8387,660,331,23.415,0.0
71618,1338731,8,40,8,56,16,9,5.0,0.0
7162,459930,0,8500,0,9000,500,501,17.0,0.5
71620,612888,1000,9000,1000,11000,2000,1001,9.0,0.0
71623,13428,52,52,52,156,104,53,1.0,0.0
71624,243583,1000,1000,1000,3000,2000,1001,1.0,0.0
71625,140027,0,1698,0,1981,283,284,6.0,0.0
71626,243583,1000,1000,1000,3000,2000,1001,1.0,0.0
71627,243583,1000,1000,1000,3000,2000,1001,1.0,0.0
71629,243583,1000,1000,1000,3000,2000,1001,1.0,0.0
7163,371842,0,5496,0,5996,500,501,10.992,0.0
71630,247584,1000,1000,1000,3000,2000,1001,1.0,0.0
71631,446936,1000,5000,1000,7000,2000,1001,5.0,0.0
71634,243583,1000,1000,1000,3000,2000,1001,1.0,0.0
71635,241583,0,1000,0,2000,1000,1001,1.0,0.5
71636,88707,66,1304,66,1436,132,67,19.758,0.0
7164,366565,500,5381,500,6381,1000,501,10.762,0.0
71645,10678,0,126,0,147,21,22,6.0,0.0
71646,243583,1000,1000,1000,3000,2000,1001,1.0,0.0
71647,243583,1000,1000,1000,3000,2000,1001,1.0,0.5
7165,4879,0,49,0,62,13,14,3.769,0.0
71650,1098508,1000,3000,1000,5000,2000,1001,3.0,0.0
71653,10203,0,120,0,140,20,21,6.0,0.0
71655,243583,1000,1000,1000,3000,2000,1001,1.0,0.0
7166,321163,0,4500,0,5000,500,501,9.0,0.0
71661,243583,1000,1000,1000,3000,2000,1001,1.0,0.0
71662,247584,1000,1000,1000,3000,2000,1001,1.0,0.0
71663,457261,1000,5000,1000,7000,2000,1001,5.0,0.0
71665,60987585,526,2630,526,3682,1052,527,5.0,0.0
7167,436147,0,5500,0,6000,500,501,11.0,0.0
71670,243583,1000,1000,1000,3000,2000,1001,1.0,0.0
71671,159262,653,653,653,1959,1306,654,1.0,0.0
71674,3601562,1000,2995,1000,4995,2000,1001,2.995,0.0
71678,44171332,813,12195,813,13821,1626,814,15.0,0.0
71679,3743,9,27,9,45,18,10,3.0,0.0
7168,424714,0,4000,0,4500,500,501,8.0,0.0
71680,368122,0,3960,0,4851,891,892,4.444,0.0
71681,243583,1000,1000,1000,3000,2000,1001,1.0,0.0
71682,46510,189,189,189,567,378,190,1.0,0.0
71684,361220,0,5840,0,6118,278,279,21.007,0.0
7169,163811,0,2270,0,2472,202,203,11.238,0.5
71690,243583,1000,1000,1000,3000,2000,1001,1.0,0.0
71691,1061731,955,10505,955,12415,1910,956,11.0,0.0
71694,243583,1000,1000,1000,3000,2000,1001,1.0,0.0
71698,243583,1000,1000,1000,3000,2000,1001,1.0,0.75
717,293303,0,5950,0,6300,350,351,17.0,0.0
7170,454844,0,8330,0,8820,490,491,17.0,0.0
71703,247584,1000,1000,1000,3000,2000,1001,1.0,0.8
7171,45856,0,372,0,496,124,125,3.0,0.0
71710,442729,1000,5000,1000,7000,2000,1001,5.0,0.0
71714,243583,1000,1000,1000,3000,2000,1001,1.0,0.75
71717,247584,1000,1000,1000,3000,2000,1001,1.0,0.0
7172,431022,0,4500,0,5000,500,501,9.0,0.0
71720,243583,1000,1000,1000,3000,2000,1001,1.0,0.0
71728,243583,1000,1000,1000,3000,2000,1001,1.0,0.0
7173,502465,0,8994,0,9494,500,501,17.988,0.0
71732,63932,0,767,0,906,139,140,5.518,0.0
7174,12881,0,128,0,160,32,33,4.0,0.75
7175,34548,39,505,39,583,78,40,12.949,0.0
71752,71967,289,289,289,867,578,290,1.0,0.0
7176,850222,500,11801,500,12801,1000,501,23.602,0.5
7177,300948,0,4000,0,4500,500,501,8.0,0.0
71770,102146,184,1149,184,1517,368,185,6.245,0.0
71773,243583,1000,1000,1000,3000,2000,1001,1.0,0.0
71774,93708,278,834,278,1390,556,279,3.0,0.0
7178,428637,500,8500,500,9500,1000,501,17.0,0.0
71788,243583,1000,1000,1000,3000,2000,1001,1.0,0.0
7179,437043,0,5374,0,5874,500,501,10.748,0.0
7180,223323,500,2500,500,3500,1000,501,5.0,0.0
7181,31094,0,369,0,410,41,42,9.0,0.0
7182,618216,306,8161,306,8773,612,307,26.67,1.0
7183,510014,0,9450,0,9950,500,501,18.9,0.0
7184,854737,0,12500,0,13000,500,501,25.0,0.0
7185,2336791,0,28526,0,29010,484,485,58.938,0.5
7186,35560,52,467,52,571,104,53,8.981,0.0
7187,415270,0,5768,0,5923,155,156,37.213,0.0
7188,775900,0,10807,0,11307,500,501,21.614,0.0
7189,496486,500,10000,500,11000,1000,501,20.0,0.0
7191,87907,0,1568,0,1666,98,99,16.0,0.0
7192,357850,0,5000,0,5500,500,501,10.0,0.0
7193,693480,0,16472,0,16972,500,501,32.944,0.0
7194,4817,0,48,0,57,9,10,5.333,0.0
71942,243583,1000,1000,1000,3000,2000,1001,1.0,0.0
71943,11743,0,120,0,144,24,25,5.0,0.0
71945,6896,14,98,14,126,28,15,7.0,0.0
71946,243583,1000,1000,1000,3000,2000,1001,1.0,0.0
71947,12285,0,134,0,161,27,28,4.963,0.0
71948,247584,1000,1000,1000,3000,2000,1001,1.0,0.0
71949,11133,0,125,0,150,25,26,5.0,0.0
7195,211174,273,2746,273,3292,546,274,10.059,0.0
71951,58574,0,625,0,750,125,126,5.0,0.0
71952,243583,1000,1000,1000,3000,2000,1001,1.0,0.0
71953,243583,1000,1000,1000,3000,2000,1001,1.0,0.0
71954,34319,0,375,0,450,75,76,5.0,0.0
71956,37591,0,432,0,480,48,49,9.0,0.0
71957,247584,1000,1000,1000,3000,2000,1001,1.0,0.0
71958,247584,1000,1000,1000,3000,2000,1001,1.0,0.0
71959,44205,0,499,0,599,100,101,4.99,0.5
7196,182060,0,1812,0,2180,368,369,4.924,0.0
71960,12358,0,125,0,150,25,26,5.0,0.0
71961,161949,216,1944,216,2376,432,217,9.0,0.0
71962,247584,1000,1000,1000,3000,2000,1001,1.0,0.0
71963,243583,1000,1000,1000,3000,2000,1001,1.0,0.0
71964,45755,0,500,0,600,100,101,5.0,0.0
71965,34951,0,375,0,450,75,76,5.0,0.0
71967,11333,0,125,0,150,25,26,5.0,0.0
71968,243583,1000,1000,1000,3000,2000,1001,1.0,0.0
71969,243583,1000,1000,1000,3000,2000,1001,1.0,0.0
7197,268544,0,3500,0,4000,500,501,7.0,0.0
71970,243583,1000,1000,1000,3000,2000,1001,1.0,0.0
71971,99010,0,1125,0,1350,225,226,5.0,0.0
71972,11268,0,125,0,150,25,26,5.0,0.0
71973,247584,1000,1000,1000,3000,2000,1001,1.0,0.5
71975,35008,0,375,0,450,75,76,5.0,0.0
71976,55045,0,625,0,750,125,126,5.0,0.0
71977,9011,0,84,0,105,21,22,4.0,0.0
71978,243583,1000,1000,1000,3000,2000,1001,1.0,0.0
7198,391562,0,8000,0,8500,500,501,16.0,0.0
71980,33241,0,375,0,450,75,76,5.0,0.0
71981,243583,1000,1000,1000,3000,2000,1001,1.0,0.0
71982,24640,99,99,99,297,198,100,1.0,0.0
71983,5686,21,21,21,63,42,22,1.0,0.0
7199,505690,500,7710,500,8710,1000,501,15.42,0.0
72,18463,72,179,72,305,126,76,3.315,0.0
7200,426610,500,8500,500,9500,1000,501,17.0,0.0
72003,657364,1000,8813,1000,10813,2000,1001,8.813,0.0
72004,6565,4,32,4,40,8,5,8.0,0.0
7201,39422,0,911,0,936,25,26,36.44,0.0
7202,410816,0,5000,0,5500,500,501,10.0,0.0
7203,15178,0,140,0,175,35,36,4.0,0.0
7204,465391,0,8500,0,9000,500,501,17.0,0.0
7205,11003,0,144,0,168,24,25,6.0,0.0
7206,405919,0,6482,0,6982,500,501,12.964,0.0
7207,170052,0,2248,0,2448,200,201,11.24,0.5
7208,348978,0,5000,0,5500,500,501,10.0,0.0
7210,911151,500,15562,500,16562,1000,501,31.124,0.0
7214,893265,0,14500,0,15000,500,501,29.0,0.0
7215,538863,0,10541,0,11041,500,501,21.082,0.0
7217,688885,0,10963,0,11463,500,501,21.926,0.0
7218,308610,0,6288,0,6681,393,394,16.0,0.0
7219,55054,0,547,0,657,110,111,4.973,0.0
7220,174324,210,2929,210,3349,420,211,13.948,1.0
7222,16983,31,278,31,340,62,32,8.968,0.0
7224,631306,500,12488,500,13488,1000,501,24.976,0.0
7225,934093,0,16000,0,16500,500,501,32.0,0.0
7227,210869,0,2991,0,3140,149,150,20.074,0.0
7228,411310,500,5000,500,6000,1000,501,10.0,0.0
7229,333975,0,4848,0,5348,500,501,9.696,0.0
7230,2135422,0,23112,0,23612,500,501,46.224,0.0
7231,553286,0,10477,0,10977,500,501,20.954,0.0
7233,617622,0,14000,0,14500,500,501,28.0,0.0
7234,300465,0,3682,0,4188,506,331,14.553,0.5
7236,111172,210,1470,210,1890,420,211,7.0,0.0
7237,140161,0,1779,0,1863,84,85,21.179,0.0
7238,423975,0,6000,0,6500,500,501,12.0,0.0
7239,1985,0,12,0,16,4,5,3.0,0.0
7240,27469,27,324,27,378,54,28,12.0,0.0
7241,36851,19,564,19,602,38,20,29.684,0.0
7242,457849,0,10000,0,10500,500,501,20.0,0.0
7243,431020,0,8500,0,9000,500,501,17.0,0.0
7244,278822,0,3069,0,3135,66,67,46.5,0.0
7245,452109,0,8500,0,9000,500,501,17.0,0.0
7246,583827,0,13237,0,13737,500,501,26.474,0.0
7247,112789,140,1975,140,2255,280,141,14.107,0.5
7248,59629,0,476,0,544,68,69,7.0,0.5
7250,237766,285,2863,285,3433,570,286,10.046,0.0
7251,24527,34,305,34,373,68,35,8.971,0.0
7252,8365,0,111,0,119,8,9,13.875,0.0
7253,1927387,0,53708,0,54208,500,501,107.416,0.0
7254,409287,0,6188,0,6394,206,207,30.039,0.0
7255,17671,0,336,0,357,21,22,16.0,0.0
7256,499176,0,6000,0,6500,500,501,12.0,0.0
7257,612301,500,9000,500,10000,1000,501,18.0,0.0
7258,424700,0,4000,0,4500,500,501,8.0,0.0
7259,49128,22,748,22,792,44,23,34.0,0.0
7260,18291,0,384,0,414,30,31,12.8,0.0
7261,403373,0,7120,0,7550,430,431,16.558,0.5
72614,110464,398,398,398,1194,796,400,1.0,0.0
72620,456261,801,7144,801,8746,1602,802,8.919,0.0
72626,429062,1000,3992,1000,5992,2000,1001,3.992,0.6666666666666666
72629,1524420,7,11150,7,11164,14,8,1592.857,0.0
72632,1501956,5,9484,5,9494,10,6,1896.8,0.5
72633,279616,1000,1000,1000,3000,2000,1001,1.0,0.0
72634,1266658,1000,24531,1000,26531,2000,1001,24.531,0.0
72635,3509,8,24,8,40,16,9,3.0,0.0
72637,40214,106,318,106,530,212,107,3.0,0.0
72639,275615,1000,1000,1000,3000,2000,1001,1.0,0.0
7264,178016,0,2065,0,2360,295,296,7.0,0.0
72640,1516565,8,10537,8,10553,16,9,1317.125,0.0
72641,407048,1000,4000,1000,6000,2000,1001,4.0,0.0
72645,275615,1000,1000,1000,3000,2000,1001,1.0,0.0
72646,275615,1000,1000,1000,3000,2000,1001,1.0,0.0
72648,275615,1000,1000,1000,3000,2000,1001,1.0,0.0
7265,67438,55,1064,55,1174,110,56,19.345,0.0
72653,50522,1,524,1,526,2,2,524.0,0.0
72654,275615,1000,1000,1000,3000,2000,1001,1.0,0.0
72656,1314283,0,27278,0,28278,1000,1001,27.278,0.0
72658,42587,114,456,114,684,228,115,4.0,0.0
72659,51376,141,423,141,705,282,142,3.0,0.0
7266,511264,500,6500,500,7500,1000,501,13.0,0.0
72660,12990,45,45,45,135,90,46,1.0,0.0
72661,279616,1000,1000,1000,3000,2000,1001,1.0,0.0
72663,275615,1000,1000,1000,3000,2000,1001,1.0,0.0
72666,1648944,9,10696,9,10714,18,10,1188.444,0.0
72668,407050,1000,4000,1000,6000,2000,1001,4.0,0.0
7267,470092,0,7835,0,8335,500,501,15.67,0.0
72670,15837,41,164,41,246,82,42,4.0,0.0
72671,275615,1000,1000,1000,3000,2000,1001,1.0,0.0
72672,39262,105,420,105,630,210,106,4.0,0.0
72674,275615,1000,1000,1000,3000,2000,1001,1.0,0.0
72676,1354512,1000,27735,1000,29735,2000,1001,27.735,0.0
72679,1282000,1000,27263,1000,29263,2000,1001,27.263,0.0
7268,509687,0,7690,0,8190,500,501,15.38,0.0
72681,1330564,1000,27336,1000,29336,2000,1001,27.336,0.0
72682,105024,1,918,1,920,2,2,918.0,0.0
72683,18240,48,192,48,288,96,49,4.0,0.0
72686,36291,97,388,97,582,194,98,4.0,0.0
72688,1715,4,4,4,12,8,5,1.0,0.0
7269,452889,0,8437,0,8937,500,501,16.874,0.0
72692,21914,58,232,58,348,116,59,4.0,0.0
72694,210209,9,1614,9,1632,18,10,179.333,0.0
72695,32932,88,352,88,528,176,89,4.0,0.0
72697,1293274,1000,26981,1000,28981,2000,1001,26.981,0.0
72698,1280349,1000,26864,1000,28864,2000,1001,26.864,0.0
72699,25954,69,276,69,414,138,70,4.0,0.0
7270,88092,0,1568,0,1666,98,99,16.0,0.0
72701,40059,106,424,106,636,212,107,4.0,0.0
72702,1288151,1000,27475,1000,29475,2000,1001,27.475,0.0
72704,34398,91,364,91,546,182,92,4.0,0.0
72706,1453,3,3,3,9,6,4,1.0,0.0
72708,1278369,1000,26768,1000,28768,2000,1001,26.768,0.0
72709,275615,1000,1000,1000,3000,2000,1001,1.0,0.0
7271,106090,0,1150,0,1380,230,231,5.0,0.0
72710,32932,88,352,88,528,176,89,4.0,0.0
72712,34775,92,368,92,552,184,93,4.0,0.0
72714,42942,115,460,115,690,230,116,4.0,0.0
72715,40737,109,436,109,654,218,110,4.0,0.0
72716,438326,754,7043,754,8551,1508,755,9.341,0.0
72717,39266,105,420,105,630,210,106,4.0,0.0
72718,58513,1,573,1,575,2,2,573.0,0.0
72719,25954,69,276,69,414,138,70,4.0,0.0
72721,275615,1000,1000,1000,3000,2000,1001,1.0,0.0
72722,39634,106,424,106,636,212,107,4.0,0.0
72723,35545,95,380,95,570,190,96,4.0,0.0
72724,37798,101,404,101,606,202,102,4.0,0.0
72725,23017,61,244,61,366,122,62,4.0,0.0
72726,275615,1000,1000,1000,3000,2000,1001,1.0,0.0
72727,41101,110,440,110,660,220,111,4.0,0.0
72729,37074,98,392,98,588,196,99,4.0,0.0
7273,143567,251,1757,251,2259,502,252,7.0,0.0
72730,1642012,9,10525,9,10543,18,10,1169.444,0.0
72731,1282186,1000,27260,1000,29260,2000,1001,27.26,0.0
72732,1618980,43,15690,43,15776,86,44,364.884,0.0
72734,39266,105,420,105,630,210,106,4.0,0.0
72735,275615,1000,1000,1000,3000,2000,1001,1.0,0.0
72736,35902,96,384,96,576,192,97,4.0,0.0
72737,37080,98,392,98,588,196,99,4.0,0.0
72738,1643788,44,11162,44,11250,88,45,253.682,0.0
72739,10532,27,108,27,162,54,28,4.0,0.0
72740,39316,104,416,104,624,208,105,4.0,0.0
72741,228927,1,1994,1,1996,2,2,1994.0,0.0
72747,1644883,1,9465,1,9467,2,2,9465.0,0.0
72749,38897,104,416,104,624,208,105,4.0,0.0
72750,28158,75,300,75,450,150,76,4.0,0.0
72756,29262,78,312,78,468,156,79,4.0,0.0
7276,182501,0,2530,0,2640,110,111,23.0,0.0
72763,1647775,0,9892,0,9893,1,2,9892.0,0.0
72769,34406,92,368,92,552,184,93,4.0,0.0
72777,1408862,43,10416,43,10502,86,44,242.233,0.0
7278,1797583,0,22997,0,23497,500,501,45.994,0.0
7279,3548857,0,35140,0,35640,500,501,70.28,0.0
72791,1658508,36,10414,36,10486,72,37,289.278,0.0
72797,9796,25,100,25,150,50,26,4.0,0.0
7280,394178,0,5500,0,6000,500,501,11.0,0.5
72800,25543,92,92,92,276,184,93,1.0,0.0
72802,271611,1000,1000,1000,3000,2000,1001,1.0,0.0
72803,1703617,1000,26176,1000,28176,2000,1001,26.176,0.0
72809,423477,508,5588,508,6604,1016,509,11.0,0.0
7281,191808,500,2000,500,3000,1000,501,4.0,0.0
72810,15753,8,156,8,172,16,9,19.5,0.0
72812,106615,111,1978,111,2200,222,112,17.82,0.0
72815,560391,1000,7000,1000,9000,2000,1001,7.0,0.0
7282,867316,500,12133,500,13133,1000,501,24.266,0.5
72820,2554752,1000,50000,1000,53000,3000,2002,25.0,0.0
72823,1072753,1000,19000,1000,21000,2000,1001,19.0,0.0
72826,1192810,1000,14975,1000,16975,2000,1001,14.975,0.0
72827,858916,2000,13973,2000,17973,4000,2002,6.987,0.0
7283,382783,0,3570,0,4070,500,501,7.14,0.0
72831,2533060,2000,51000,2000,55000,4000,2002,25.5,0.0
72834,25543,92,92,92,276,184,93,1.0,0.0
72835,106615,111,1978,111,2200,222,112,17.82,0.0
72836,454825,1000,6000,1000,8000,2000,1001,6.0,0.0
72837,271611,1000,1000,1000,3000,2000,1001,1.0,0.0
72839,447597,956,3824,956,5736,1912,957,4.0,0.0
7284,19579,0,306,0,324,18,19,17.0,0.0
72841,271611,1000,1000,1000,3000,2000,1001,1.0,0.0
72842,30710,78,234,78,390,156,79,3.0,0.0
72845,31137,111,111,111,333,222,112,1.0,0.0
7286,357587,0,4500,0,5000,500,501,9.0,0.0
7287,20226,0,203,0,246,43,44,4.721,0.0
729,7434,10,70,10,100,30,21,7.0,0.0
7290,297509,0,4000,0,4500,500,501,8.0,0.0
7291,303807,500,4425,500,5425,1000,501,8.85,0.0
7292,785010,0,6500,0,7000,500,501,13.0,0.0
7293,198738,0,1492,0,1724,232,233,6.431,0.0
7294,560694,0,10472,0,10972,500,501,20.944,0.0
72942,678484,1000,7998,1000,9998,2000,1001,7.998,0.0
72949,734812,1000,10034,1000,12034,2000,1001,10.034,0.0
7296,383224,0,7598,0,8098,500,501,15.196,0.0
7297,2666967,1498,29290,1498,32786,3496,2000,14.66,0.0
7298,377702,0,7000,0,7500,500,501,14.0,0.0
72983,5090,8,54,8,70,16,9,6.75,0.0
7299,415736,500,6500,500,7500,1000,501,13.0,0.0
73,18463,72,179,72,305,126,76,3.315,0.0
7300,101103,0,1320,0,1452,132,133,10.0,0.0
73005,25894,73,219,73,365,146,74,3.0,0.0
73010,40985,5,30,5,40,10,6,6.0,0.0
73011,48994,4,24,4,32,8,5,6.0,0.0
73012,29203,1,6,1,8,2,2,6.0,0.0
7302,550183,0,8557,0,9057,500,501,17.114,0.5
7303,1083588,0,14933,0,15128,195,196,76.579,0.0
7304,34927,0,288,0,348,60,61,4.8,0.5
7305,33303,0,320,0,400,80,81,4.0,0.0
7306,80910,121,1321,121,1563,242,122,10.917,0.0
7307,54882,74,657,74,805,148,75,8.878,0.0
7308,2153824,0,28352,0,28826,474,475,59.814,0.5
7309,75071,0,680,0,820,140,141,4.857,0.0
731,47017,49,325,49,456,131,82,6.633,0.0
7310,473129,0,6496,0,6996,500,501,12.992,0.0
7311,340953,500,4500,500,5500,1000,501,9.0,0.0
7312,556867,0,3497,0,3997,500,501,6.994,0.5
7313,456921,0,8945,0,9445,500,501,17.89,1.0
7314,496938,500,5000,500,6000,1000,501,10.0,0.0
7316,190520,500,2000,500,3000,1000,501,4.0,0.0
7318,19867,24,312,24,360,48,25,13.0,0.0
7320,1255353,0,44389,0,44889,500,501,88.778,0.0
73203,7853,11,86,11,108,22,12,7.818,0.0
73208,402700,33,489,33,555,66,34,14.818,0.0
73209,2768374,279,41850,279,42408,558,280,150.0,0.0
7321,382331,0,7031,0,7474,443,444,15.871,0.0
7322,315931,0,5000,0,5500,500,501,10.0,0.0
73223,3990,8,32,8,48,16,9,4.0,0.0
7323,311820,75,4333,75,4483,150,76,57.773,0.0
7324,297499,0,4000,0,4500,500,501,8.0,0.0
7325,218031,0,2000,0,2500,500,501,4.0,0.0
73254,271611,1000,1000,1000,3000,2000,1001,1.0,0.0
7326,1645172,0,11500,0,12000,500,501,23.0,0.0
73262,689045,1000,9595,1000,11595,2000,1001,9.595,0.0
73263,422274,0,4698,0,5105,407,408,11.543,0.0
73266,267607,1000,1000,1000,3000,2000,1001,1.0,0.0
73267,267607,1000,1000,1000,3000,2000,1001,1.0,0.0
73268,267607,1000,1000,1000,3000,2000,1001,1.0,0.0
73269,267607,1000,1000,1000,3000,2000,1001,1.0,0.0
73270,271608,1000,1000,1000,3000,2000,1001,1.0,0.0
73271,947466,1000,14660,1000,16660,2000,1001,14.66,0.75
73274,1451324,1000,14135,1000,16135,2000,1001,14.135,0.0
73277,271608,1000,1000,1000,3000,2000,1001,1.0,0.0
73278,271608,1000,1000,1000,3000,2000,1001,1.0,0.0
73279,267607,1000,1000,1000,3000,2000,1001,1.0,0.0
7328,410630,500,6499,500,7499,1000,501,12.998,0.0
73280,271608,1000,1000,1000,3000,2000,1001,1.0,0.0
73281,267607,1000,1000,1000,3000,2000,1001,1.0,0.0
73283,267607,1000,1000,1000,3000,2000,1001,1.0,0.0
73288,271608,1000,1000,1000,3000,2000,1001,1.0,0.0
73289,267607,1000,1000,1000,3000,2000,1001,1.0,0.0
7329,110349,0,1296,0,1458,162,163,8.0,0.0
73290,267607,1000,1000,1000,3000,2000,1001,1.0,0.0
73291,267607,1000,1000,1000,3000,2000,1001,1.0,0.0
73293,267607,1000,1000,1000,3000,2000,1001,1.0,0.0
73296,267607,1000,1000,1000,3000,2000,1001,1.0,0.0
73297,271608,1000,1000,1000,3000,2000,1001,1.0,0.0
73298,267607,1000,1000,1000,3000,2000,1001,1.0,0.0
7330,12625,0,144,0,162,18,19,8.0,0.0
73301,271608,1000,1000,1000,3000,2000,1001,1.0,0.0
73303,271608,1000,1000,1000,3000,2000,1001,1.0,0.0
73304,267607,1000,1000,1000,3000,2000,1001,1.0,0.0
73306,267607,1000,1000,1000,3000,2000,1001,1.0,0.0
73307,271608,1000,1000,1000,3000,2000,1001,1.0,0.0
7331,49956,0,614,0,655,41,42,14.976,0.0
73310,271608,1000,1000,1000,3000,2000,1001,1.0,0.0
73313,267607,1000,1000,1000,3000,2000,1001,1.0,0.0
73317,267607,1000,1000,1000,3000,2000,1001,1.0,0.0
7332,1875606,0,25922,0,26422,500,501,51.844,0.0
73321,267607,1000,1000,1000,3000,2000,1001,1.0,0.0
73323,267607,1000,1000,1000,3000,2000,1001,1.0,0.0
73327,267607,1000,1000,1000,3000,2000,1001,1.0,0.0
7333,617207,0,12131,0,12631,500,501,24.262,0.0
73332,271608,1000,1000,1000,3000,2000,1001,1.0,0.0
73335,271608,1000,1000,1000,3000,2000,1001,1.0,0.0
73336,267607,1000,1000,1000,3000,2000,1001,1.0,0.0
73338,267607,1000,1000,1000,3000,2000,1001,1.0,0.0
7334,70364,0,1344,0,1428,84,85,16.0,0.0
7335,624910,0,10500,0,11000,500,501,21.0,0.0
73352,255595,1000,1000,1000,3000,2000,1001,1.0,0.0
7336,108929,0,2344,0,2407,63,64,37.206,0.0
73377,591800,14,196,14,224,28,15,14.0,0.0
73378,300815,3,48,3,54,6,4,16.0,0.0
73379,249423,27,108,27,162,54,28,4.0,0.0
7338,491490,500,6000,500,7000,1000,501,12.0,0.0
73380,612515,41,564,41,646,82,42,13.756,0.0
73381,1335032,61,854,61,976,122,62,14.0,0.0
73382,5687,8,48,8,64,16,9,6.0,0.0
73383,3939,4,20,4,32,12,9,5.0,0.0
73384,1518,1,3,1,6,3,3,3.0,0.0
7340,24089,43,215,43,301,86,44,5.0,0.0
7341,9309,10,140,10,160,20,11,14.0,0.0
7342,347605,0,5000,0,5500,500,501,10.0,0.0
7343,6717,8,64,8,88,24,18,4.0,0.0
7344,126736,0,1391,0,1649,258,259,5.391,0.0
73445,536744,309,6032,309,7251,1219,834,19.521,0.0
7345,1095159,0,13767,0,14267,500,501,27.534,0.0
7347,696004,0,12641,0,13141,500,501,25.282,0.0
7348,349527,0,5164,0,5664,500,501,10.328,0.5
7349,113284,0,1794,0,1932,138,139,13.0,0.0
7351,42610,0,620,0,653,33,34,18.788,0.0
7352,2561207,1466,27182,1466,30614,3432,1968,13.826,0.0
7353,161674,0,1715,0,1960,245,246,7.0,0.75
7354,60279,0,800,0,900,100,101,8.0,0.0
7356,283930,0,4568,0,5068,500,501,9.136,0.0
7357,204996,0,2500,0,3000,500,501,5.0,0.5
7358,334966,0,4452,0,4952,500,501,8.904,0.5
73582,584788,0,10000,0,11000,1000,1001,10.0,1.0
7359,321429,0,4000,0,4500,500,501,8.0,0.0
73595,2850,0,25,0,30,5,6,5.0,0.0
73597,7013,0,49,0,63,14,15,3.5,0.0
73599,2206,0,15,0,20,5,6,3.0,0.0
73600,6438,0,76,0,87,11,12,6.909,0.5
73601,1479,0,10,0,12,2,3,5.0,0.0
73602,1554,0,12,0,14,2,3,6.0,0.0
73603,1544,0,12,0,14,2,3,6.0,0.0
73604,1562,0,12,0,14,2,3,6.0,0.0
73605,2038,0,18,0,21,3,4,6.0,0.0
73606,22517,23,207,23,288,81,59,9.0,0.0
73607,1552,0,12,0,14,2,3,6.0,0.0
73608,1718,0,14,0,16,2,3,7.0,0.0
73609,3536,0,27,0,36,9,10,3.0,0.0
73610,1462,0,10,0,12,2,3,5.0,0.0
73612,2044,0,18,0,21,3,4,6.0,0.0
73613,1564,0,12,0,14,2,3,6.0,0.0
73614,2053,0,18,0,21,3,4,6.0,0.0
73615,2042,0,18,0,21,3,4,6.0,0.0
73618,1557,0,12,0,14,2,3,6.0,0.0
73620,2206,0,15,0,20,5,6,3.0,0.0
73621,1560,0,12,0,14,2,3,6.0,0.0
73623,2039,0,18,0,21,3,4,6.0,0.0
73624,2040,0,18,0,21,3,4,6.0,0.0
73625,2032,0,18,0,21,3,4,6.0,0.0
73626,1547,0,12,0,14,2,3,6.0,0.0
73627,2055,0,18,0,21,3,4,6.0,0.0
73628,2038,0,18,0,21,3,4,6.0,0.0
73629,1552,0,12,0,14,2,3,6.0,0.0
7363,3098146,0,58808,0,59308,500,501,117.616,0.0
73630,1552,0,12,0,14,2,3,6.0,0.0
73631,1552,0,12,0,14,2,3,6.0,0.0
73632,1549,0,12,0,14,2,3,6.0,0.0
73633,1547,0,12,0,14,2,3,6.0,0.0
73634,1550,0,12,0,14,2,3,6.0,0.0
73635,1563,0,12,0,14,2,3,6.0,0.0
73636,1552,0,12,0,14,2,3,6.0,0.0
73637,640136,1000,10000,1000,12000,2000,1001,10.0,0.0
73638,2024,0,18,0,21,3,4,6.0,0.0
73639,2035,0,18,0,21,3,4,6.0,0.0
73640,1554,0,12,0,14,2,3,6.0,0.0
73641,1551,0,12,0,14,2,3,6.0,0.0
73642,1554,0,12,0,14,2,3,6.0,0.0
73643,1552,0,12,0,14,2,3,6.0,0.0
73644,592270,0,10000,0,11000,1000,1001,10.0,1.0
73645,2036,0,18,0,21,3,4,6.0,0.0
73646,2029,0,18,0,21,3,4,6.0,0.0
73647,1549,0,12,0,14,2,3,6.0,0.0
73648,2052,0,18,0,21,3,4,6.0,0.0
73649,1543,0,12,0,14,2,3,6.0,0.0
7365,290812,0,3600,0,3960,360,361,10.0,0.0
73651,1532,0,12,0,14,2,3,6.0,0.0
73652,592887,0,10000,0,11000,1000,1001,10.0,0.0
73653,2037,0,18,0,21,3,4,6.0,0.0
73654,1563,0,12,0,14,2,3,6.0,0.0
73655,1546,0,12,0,14,2,3,6.0,0.0
73657,2054,0,18,0,21,3,4,6.0,0.0
73658,661012,0,10000,0,11000,1000,1001,10.0,0.0
73659,594038,0,10000,0,11000,1000,1001,10.0,0.0
7366,145523,0,2008,0,2259,251,252,8.0,0.0
73662,2034,0,18,0,21,3,4,6.0,0.0
73663,1552,0,12,0,14,2,3,6.0,0.0
73664,1550,0,12,0,14,2,3,6.0,0.0
73665,1547,0,12,0,14,2,3,6.0,0.0
73666,477187,1000,6000,1000,8000,2000,1001,6.0,0.0
73668,413396,472,5663,472,6607,944,473,11.998,0.0
73675,538398,0,7420,0,8420,1000,1001,7.42,0.0
73676,1612,0,12,0,14,2,3,6.0,0.0
73678,6707,0,72,0,84,12,13,6.0,0.0
73679,7042,0,49,0,63,14,15,3.5,0.0
7368,817996,500,6000,500,7000,1000,501,12.0,0.0
73681,579992,1000,9553,1000,11553,2000,1001,9.553,1.0
73683,1702,0,12,0,14,2,3,6.0,0.0
73684,590177,1000,9724,1000,11724,2000,1001,9.724,0.0
73685,589071,1000,10000,1000,12000,2000,1001,10.0,0.0
73686,1616,0,12,0,14,2,3,6.0,0.0
73688,1623,0,12,0,14,2,3,6.0,0.0
73689,74515,0,942,0,1099,157,158,6.0,0.0
73690,1562,0,12,0,14,2,3,6.0,0.0
73692,1625,0,12,0,14,2,3,6.0,0.0
73695,1618,0,12,0,14,2,3,6.0,0.0
73696,10150,13,132,13,158,26,14,10.154,0.0
73697,138170,300,1793,300,2393,600,301,5.977,0.0
7370,4494,4,60,4,68,8,5,15.0,0.0
73702,590446,1000,10000,1000,12000,2000,1001,10.0,1.0
73703,45481,56,336,56,493,157,93,6.0,0.0
73706,637481,1000,8982,1000,10982,2000,1001,8.982,0.75
7371,74270,0,796,0,913,117,118,6.803,0.0
73713,594834,1000,10000,1000,12000,2000,1001,10.0,0.0
73718,2573,4,10,4,18,8,5,2.5,0.0
7372,397056,0,5500,0,6000,500,501,11.0,0.0
73723,186459,136,2746,136,3018,272,137,20.191,0.0
73729,15928,24,192,24,240,48,25,8.0,0.0
7373,347181,0,6825,0,7000,175,176,39.0,0.75
73730,6416838,664,8412,664,9740,1328,665,12.669,0.0
73732,618017,1000,10000,1000,12000,2000,1001,10.0,0.0
73733,32768,79,350,79,508,158,80,4.43,0.0
73734,1047488,1000,19588,1000,21588,2000,1001,19.588,1.0
73737,618089,1000,10000,1000,12000,2000,1001,10.0,0.0
73738,45022,142,316,142,600,284,143,2.225,0.0
7374,801675,0,13000,0,13500,500,501,26.0,0.0
73740,39027,84,497,84,665,168,85,5.917,0.0
73741,5751,12,60,12,84,24,13,5.0,0.0
73743,5578,12,60,12,84,24,13,5.0,0.0
73745,5859,12,60,12,84,24,13,5.0,0.0
73747,5578,12,60,12,84,24,13,5.0,0.0
73748,4623,0,48,0,60,12,13,4.0,0.0
73749,5595,12,60,12,84,24,13,5.0,0.0
7375,448836,500,9000,500,10000,1000,501,18.0,0.0
73751,5578,12,60,12,84,24,13,5.0,0.0
73752,5571,12,60,12,84,24,13,5.0,0.0
73754,5571,12,60,12,84,24,13,5.0,0.0
73757,5116,12,48,12,72,24,13,4.0,0.0
73758,5571,12,60,12,84,24,13,5.0,0.0
7376,1252625,719,14848,719,16537,1689,972,15.307,0.0
73761,893303,1000,15009,1000,17009,2000,1001,15.009,1.0
73762,622485,862,8621,862,10345,1724,863,10.001,0.0
73763,5067,12,48,12,72,24,13,4.0,0.0
73765,5908,12,60,12,84,24,13,5.0,0.0
73768,5595,12,60,12,84,24,13,5.0,0.0
73770,5703,12,60,12,84,24,13,5.0,0.0
73771,5908,12,60,12,84,24,13,5.0,0.0
73774,5644,12,60,12,84,24,13,5.0,0.0
73775,1067952,1000,16492,1000,18662,2170,1163,16.492,0.5
73777,5859,12,60,12,84,24,13,5.0,0.0
73778,255592,1000,1000,1000,3000,2000,1001,1.0,0.0
73779,5751,12,60,12,84,24,13,5.0,0.0
7378,610931,0,8392,0,8892,500,501,16.784,0.0
73780,5595,12,60,12,84,24,13,5.0,0.0
73781,4635,0,48,0,60,12,13,4.0,0.0
73782,5699,12,60,12,84,24,13,5.0,0.0
73783,5752,12,60,12,84,24,13,5.0,0.0
73790,17646277,1000,8000,1000,10000,2000,1001,8.0,0.0
73793,588387,1000,9553,1000,11553,2000,1001,9.553,0.0
73794,38145,29,574,29,632,58,30,19.793,0.0
73798,50782,41,749,41,831,82,42,18.268,0.0
73799,264033,180,5145,180,5505,360,182,28.583,0.0
7380,818549,0,15241,0,15741,500,501,30.482,0.0
73800,59107,51,849,51,951,102,52,16.647,0.5
73804,251591,1000,1000,1000,3000,2000,1001,1.0,0.0
73805,18841,16,288,16,320,32,17,18.0,0.0
73807,392791,244,7193,244,7681,488,246,29.48,0.5
73811,3603,12,12,12,36,24,13,1.0,0.0
73815,3603,12,12,12,36,24,13,1.0,0.0
73816,57819,40,849,40,929,80,41,21.225,0.0
73818,3652,12,12,12,36,24,13,1.0,0.0
7382,818549,0,15241,0,15741,500,501,30.482,0.0
73820,317374,196,5810,196,6202,392,198,29.643,0.5
73821,3603,12,12,12,36,24,13,1.0,0.0
73823,3603,12,12,12,36,24,13,1.0,0.0
73824,86742,61,1314,61,1436,122,62,21.541,0.0
73825,78552,60,1156,60,1276,120,61,19.267,0.0
73827,3603,12,12,12,36,24,13,1.0,0.0
73829,75891,300,300,300,900,600,301,1.0,0.0
73830,251591,1000,1000,1000,3000,2000,1001,1.0,0.0
73832,75891,300,300,300,900,600,301,1.0,0.0
73833,75891,300,300,300,900,600,301,1.0,0.0
73834,28636,16,471,16,503,32,18,29.438,0.0
73836,3603,12,12,12,36,24,13,1.0,0.0
73837,106011,420,420,420,1260,840,421,1.0,0.0
73838,498604,1000,8000,1000,10000,2000,1001,8.0,0.0
7384,828329,500,14165,500,15665,1500,1002,14.165,0.6666666666666666
73840,3603,12,12,12,36,24,13,1.0,0.0
73842,77092,300,300,300,900,600,301,1.0,0.0
73843,3603,12,12,12,36,24,13,1.0,0.0
73844,563913,1000,9500,1000,11500,2000,1001,9.5,0.0
73846,75891,300,300,300,900,600,301,1.0,0.0
73847,3603,12,12,12,36,24,13,1.0,0.0
73849,3603,12,12,12,36,24,13,1.0,0.0
7385,446339,500,9985,500,10985,1000,501,19.97,0.0
73853,3603,12,12,12,36,24,13,1.0,0.0
7386,388586,500,6500,500,7500,1000,501,13.0,0.0
7387,729856,500,12503,500,14003,1500,1002,12.503,1.0
7388,541846,500,7678,500,8678,1000,501,15.356,0.0
7390,12975,21,147,21,189,42,22,7.0,0.0
7391,215451,0,2999,0,3499,500,501,5.998,0.0
7392,6208,0,60,0,75,15,16,4.0,0.0
7393,172568,0,1904,0,2380,476,477,4.0,0.0
7394,192950,0,2000,0,2500,500,501,4.0,1.0
7395,272448,0,3500,0,4000,500,501,7.0,0.0
7396,31437,69,414,69,552,138,71,6.0,0.0
7397,88289,93,1209,93,1395,186,95,13.0,0.5
7398,6280314,58,348,58,464,116,60,6.0,0.0
7399,3840,8,32,8,48,16,10,4.0,0.0
74,1568805,4947,12823,4947,24709,11886,5333,3.239,0.5
7400,23628,48,240,48,336,96,50,5.0,0.0
7401,4144,8,32,8,48,16,10,4.0,0.0
7404,640181,0,9586,0,10086,500,501,19.172,0.0
7405,10204,0,119,0,136,17,18,7.0,0.0
7406,10792,0,170,0,186,16,17,10.625,0.0
7407,243248,0,2875,0,3375,500,501,5.75,0.0
7408,800710,0,13637,0,14137,500,501,27.274,0.0
7410,4717,0,90,0,97,7,8,12.857,0.5
7412,3584,0,35,0,40,5,6,7.0,0.0
7413,243435,0,3000,0,3500,500,501,6.0,0.0
7414,51518,0,301,0,501,200,201,3.01,0.0
7415,191395,217,2682,217,3365,683,468,5.755,0.0
7416,5602,0,52,0,65,13,14,4.0,0.0
7417,97722,157,780,157,1249,469,313,4.968,0.0
7418,112613,0,977,0,1140,163,164,5.994,0.0
7419,234189,0,2920,0,3420,500,501,5.84,0.0
74192,3350,8,24,8,40,16,9,3.0,1.0
7420,39693,0,413,0,472,59,60,7.0,0.0
7421,169363,0,2232,0,2418,186,187,12.0,0.0
7422,11106,0,172,0,189,17,18,10.118,0.0
74220,860265,0,16000,0,17000,1000,1001,16.0,0.75
7423,10759,0,170,0,186,16,17,10.625,0.0
74231,267607,1000,1000,1000,3000,2000,1001,1.0,0.0
7424,8453,0,60,0,80,20,21,3.0,0.0
7425,20670,0,136,0,204,68,69,4.0,0.0
7426,934186,0,13467,0,13967,500,501,26.934,0.0
74261,807600,1000,10290,1000,12290,2000,1001,10.29,0.0
74262,913618,1000,15144,1000,17144,2000,1001,15.144,0.0
74264,31189,51,459,51,561,102,52,9.0,0.0
7427,10492,0,169,0,184,15,16,11.267,0.0
74270,780895,1000,13334,1000,15334,2000,1001,13.334,0.5
74271,79185,191,955,191,1337,382,192,5.0,0.0
74275,841117,1000,15000,1000,17000,2000,1001,15.0,0.0
74278,71226,188,752,188,1128,376,189,4.0,0.0
7428,8828,0,160,0,173,13,14,12.308,0.0
74289,812843,1000,14000,1000,16000,2000,1001,14.0,0.75
7429,10198,20,40,20,100,60,41,2.0,0.0
74292,774890,1000,13209,1000,15209,2000,1001,13.209,0.75
74293,5840477,1000,105855,1000,108855,3000,2002,52.928,0.0
74296,771927,1000,13170,1000,15170,2000,1001,13.17,0.75
74298,776551,1000,13219,1000,15219,2000,1001,13.219,0.0
7430,197363,0,3660,0,3965,305,306,12.0,0.0
74301,161354,225,2271,225,2721,450,226,10.093,0.0
74308,175645,223,2719,223,3165,446,224,12.193,0.0
7431,21357,0,240,0,288,48,49,5.0,0.0
74310,18774,54,162,54,270,108,55,3.0,0.0
74312,117503,143,1687,143,1973,286,144,11.797,0.0
74318,880363,1000,15427,1000,17427,2000,1001,15.427,0.0
74319,581141,1000,7113,1000,9113,2000,1001,7.113,0.0
7432,90059,0,1054,0,1265,211,212,4.995,0.0
74322,844785,1000,15000,1000,17000,2000,1001,15.0,0.0
74326,819283,1000,11714,1000,13714,2000,1001,11.714,0.0
74329,876742,814,13917,814,15545,1628,815,17.097,0.0
7433,8901,0,159,0,172,13,14,12.231,0.0
74330,17246,50,150,50,250,100,51,3.0,0.0
74331,118017,256,1276,256,1788,512,257,4.984,0.0
74337,374760,0,5877,0,6530,653,654,9.0,0.0
7434,141716,0,1358,0,1552,194,195,7.0,0.0
74345,358108,264,5611,264,6139,528,265,21.254,0.5
7435,9659,0,172,0,187,15,16,11.467,0.0
74375,4582,12,36,12,60,24,13,3.0,0.75
74377,1118,1,4,1,7,3,3,4.0,0.0
7438,1523,1,19,1,21,2,2,19.0,0.0
74385,912232,0,13000,0,14000,1000,1001,13.0,0.5
74389,956262,1000,14585,1000,16585,2000,1001,14.585,0.0
7439,257394,0,3498,0,3998,500,501,6.996,0.0
74391,3781,1,3,1,5,2,2,3.0,0.0
74392,72269,41,1287,41,1369,82,42,31.39,0.0
74394,21589,59,177,59,295,118,60,3.0,0.0
74396,193140,118,1578,118,1814,236,119,13.373,1.0
74397,22076,65,195,65,325,130,66,3.0,0.0
74398,268525,176,1976,176,2503,527,278,11.227,0.75
7440,666912,0,10709,0,11209,500,501,21.418,0.0
74400,721129,263,9910,263,10436,526,264,37.681,0.0
74403,963378,1000,14569,1000,16569,2000,1001,14.569,0.0
74404,85104,144,1296,144,1584,288,145,9.0,1.0
74406,961219,1000,14604,1000,16604,2000,1001,14.604,0.0
74407,845398,1000,15000,1000,17000,2000,1001,15.0,0.0
74408,3613,9,27,9,45,18,10,3.0,0.0
74409,1854,4,12,4,20,8,5,3.0,0.0
74410,953239,1000,14497,1000,16497,2000,1001,14.497,0.0
74411,310025,448,4928,448,5824,896,449,11.0,0.0
74412,11536,0,116,0,145,29,30,4.0,0.0
74413,957250,1000,14537,1000,16537,2000,1001,14.537,0.0
74414,72261,102,1122,102,1326,204,103,11.0,0.0
74415,121821,171,1881,171,2223,342,172,11.0,0.0
74416,31721,56,448,56,560,112,57,8.0,0.0
74417,241796,502,3754,502,4758,1004,503,7.478,0.0
74419,1957,0,12,0,16,4,5,3.0,0.0
7442,288737,0,4000,0,4500,500,501,8.0,0.0
74420,28465,50,400,50,500,100,51,8.0,0.0
74421,14117,24,192,24,240,48,25,8.0,0.0
74426,835547,1000,15000,1000,17000,2000,1001,15.0,0.0
74428,107042,151,1660,151,1962,302,152,10.993,0.0
7443,51304,141,423,141,705,282,142,3.0,0.0
74441,214101,227,2043,227,2497,454,228,9.0,0.0
74445,158528,184,2760,184,3128,368,185,15.0,0.0
74446,64732,91,1001,91,1183,182,92,11.0,0.0
74447,21451,12,331,12,355,24,13,27.583,0.0
74452,245585,1000,1000,1000,3000,2000,1001,1.0,0.0
74453,13080,51,51,51,153,102,52,1.0,0.0
74454,10285,6,136,6,148,12,7,22.667,0.0
74459,9663,11,165,11,187,22,12,15.0,0.0
7446,286538,0,3000,0,3500,500,501,6.0,0.0
74460,9038,10,147,10,167,20,11,14.7,0.0
74463,1292,1,11,1,13,2,2,11.0,0.0
74465,6277,3,80,3,86,6,4,26.667,0.0
74467,929627,1000,17501,1000,19501,2000,1001,17.501,0.0
74470,1233865,1000,24937,1000,26937,2000,1001,24.937,0.0
74472,798785,518,14378,518,15414,1036,519,27.757,0.0
74473,863166,1000,11999,1000,13999,2000,1001,11.999,0.0
74475,679774,1000,8317,1000,10317,2000,1001,8.317,0.0
74478,289326,378,3832,378,4588,756,379,10.138,0.0
7448,36035,0,342,0,429,87,88,3.931,0.0
74483,720196,1000,10000,1000,12000,2000,1001,10.0,0.0
74487,777458,1000,13323,1000,15323,2000,1001,13.323,0.0
74488,703929,1000,9000,1000,11000,2000,1001,9.0,0.0
7449,207109,0,2500,0,3000,500,501,5.0,0.0
74493,761112,1000,9758,1000,11758,2000,1001,9.758,0.0
74494,169705,299,2870,299,3468,598,300,9.599,0.0
74495,32862,14,568,14,596,28,15,40.571,0.0
745,233134,483,2898,483,3864,966,484,6.0,0.0
7450,7129,0,96,0,108,12,13,8.0,0.5
74501,825070,1000,10979,1000,12979,2000,1001,10.979,0.0
74506,942372,1000,12958,1000,14958,2000,1001,12.958,0.0
74508,600503,769,7935,769,9473,1538,770,10.319,0.0
7451,387472,0,5000,0,5500,500,501,10.0,0.0
74510,634650,1000,8920,1000,10920,2000,1001,8.92,0.0
74511,709511,1000,9169,1000,11169,2000,1001,9.169,0.0
74513,199108,86,3579,86,3751,172,87,41.616,0.0
74514,794621,1000,10507,1000,12507,2000,1001,10.507,0.0
7452,63591,0,1243,0,1356,113,114,11.0,0.0
74527,639756,1000,8000,1000,10000,2000,1001,8.0,0.0
7453,265602,0,5000,0,5500,500,501,10.0,0.0
74530,958554,1000,14028,1000,16028,2000,1001,14.028,0.0
74539,7350068,0,27776,0,28776,1000,1001,27.776,0.0
74541,1883235,0,27554,0,28554,1000,1001,27.554,0.0
74544,172421,0,2847,0,3066,219,220,13.0,0.0
74547,921390,0,14999,0,15999,1000,1001,14.999,0.0
74548,293132,0,3346,0,3824,478,479,7.0,0.0
7455,3558,0,23,0,29,6,7,3.833,0.0
74551,24089,43,215,43,301,86,44,5.0,0.0
74556,255595,1000,1000,1000,3000,2000,1001,1.0,0.0
74557,1469676,0,15024,0,16024,1000,1001,15.024,0.0
74559,255596,0,1000,0,2000,1000,1001,1.0,0.0
7456,265441,0,5000,0,5500,500,501,10.0,0.0
74563,438224,0,7000,0,8000,1000,1001,7.0,0.5
74564,253595,0,1000,0,2000,1000,1001,1.0,0.0
74565,1981868,0,35657,0,36657,1000,1001,35.657,0.0
74566,972788,1000,14292,1000,16292,2000,1001,14.292,0.0
74567,687521,0,9194,0,10194,1000,1001,9.194,0.0
74568,1222294,0,20071,0,21071,1000,1001,20.071,0.0
74570,2159535,0,37627,0,38627,1000,1001,37.627,0.0
74571,1036551,1000,18000,1000,20000,2000,1001,18.0,0.0
74573,253595,0,1000,0,2000,1000,1001,1.0,0.0
74577,955525,1000,15022,1000,17022,2000,1001,15.022,0.0
74578,255595,1000,1000,1000,3000,2000,1001,1.0,0.0
7458,10296,0,112,0,126,14,15,8.0,0.0
74581,745507,542,12659,542,13743,1084,543,23.356,0.0
74583,246347,460,2924,460,3844,920,461,6.357,0.0
74584,1013578,0,12000,0,13000,1000,1001,12.0,0.0
74585,3591889,0,58060,0,59060,1000,1001,58.06,0.0
74586,1259803,1000,21483,1000,23483,2000,1001,21.483,0.5
74587,253595,0,1000,0,2000,1000,1001,1.0,0.0
74589,2164344,0,30954,0,31954,1000,1001,30.954,0.0
7459,6310,0,96,0,108,12,13,8.0,0.0
74591,253595,0,1000,0,2000,1000,1001,1.0,0.0
74592,255595,1000,1000,1000,3000,2000,1001,1.0,0.0
74593,1970539,0,45749,0,46749,1000,1001,45.749,0.0
74594,2228490,1000,27380,1000,29380,2000,1001,27.38,0.5
74598,2796993,0,66245,0,67245,1000,1001,66.245,0.0
7460,231255,0,2777,0,3277,500,501,5.554,0.0
74600,2257896,0,29469,0,30469,1000,1001,29.469,0.0
74606,38925,0,531,0,590,59,60,9.0,0.0
74607,694287,0,12967,0,13967,1000,1001,12.967,0.0
74608,15178,0,140,0,175,35,36,4.0,0.0
7461,241734,0,2881,0,3381,500,501,5.762,0.0
74617,8236,0,106,0,115,9,10,11.778,0.0
74618,668339,0,10581,0,11581,1000,1001,10.581,0.0
74619,1051306,0,11000,0,12000,1000,1001,11.0,0.0
74620,1829842,0,26000,0,27000,1000,1001,26.0,0.0
74622,3218031,0,37396,0,37823,427,428,87.578,0.5
74624,253595,0,1000,0,2000,1000,1001,1.0,0.0
74626,2017344,0,30300,0,31300,1000,1001,30.3,0.0
74629,87103,0,1398,0,1478,80,81,17.475,0.0
74631,1960239,0,40000,0,41000,1000,1001,40.0,1.0
74632,3101747,0,36772,0,37207,435,436,84.533,0.6666666666666666
74634,738529,1000,10855,1000,12855,2000,1001,10.855,0.0
74635,5973,0,20,0,25,5,6,4.0,0.0
74636,1249048,0,21000,0,22000,1000,1001,21.0,0.0
74639,888303,1000,12039,1000,14039,2000,1001,12.039,0.0
7464,1661,2,6,2,12,6,5,3.0,0.0
74641,549260,0,7906,0,8906,1000,1001,7.906,0.0
74642,2658531,0,47630,0,48630,1000,1001,47.63,0.0
74643,2966151,0,36406,0,36846,440,441,82.741,0.5
74644,645677,0,9000,0,10000,1000,1001,9.0,0.0
74646,1932097,0,34098,0,35098,1000,1001,34.098,0.0
74647,1453518,0,22716,0,23716,1000,1001,22.716,0.0
7465,204109,0,2500,0,3000,500,501,5.0,0.0
74650,259596,1000,1000,1000,3000,2000,1001,1.0,0.0
74653,857647,0,13000,0,14000,1000,1001,13.0,0.0
74655,749825,0,11922,0,12467,545,546,21.875,0.0
74656,126736,0,1391,0,1649,258,259,5.391,0.0
74657,6103,0,48,0,64,16,17,6.0,0.0
7466,6854,0,46,0,62,16,17,2.875,0.0
74669,948889,1000,16939,1000,18939,2000,1001,16.939,0.0
7467,322607,0,4945,0,5445,500,501,9.89,0.0
74674,1442581,0,27025,0,28025,1000,1001,27.025,0.0
74677,1285810,0,19433,0,20433,1000,1001,19.433,0.0
74679,723946,1000,8644,1000,10644,2000,1001,8.644,0.0
7468,22592,0,216,0,270,54,55,4.0,0.5
74684,1127652,1000,21049,1000,23049,2000,1001,21.049,0.0
74689,11003,0,144,0,168,24,25,6.0,0.0
7469,6357,0,97,0,109,12,13,8.083,0.0
74690,3119999,0,1068,0,1246,178,179,6.0,0.0
74698,1020285,1000,17156,1000,19156,2000,1001,17.156,0.5
74699,1336348,0,25090,0,26842,1752,1644,25.09,0.0
7470,217109,0,2500,0,3000,500,501,5.0,0.0
74702,1211488,1000,22048,1000,24048,2000,1001,22.048,0.0
74703,15995,0,66,0,88,22,23,3.0,0.0
74704,564739,1000,9261,1000,11261,2000,1001,9.261,1.0
74705,88233,0,1568,0,1666,98,99,16.0,0.0
74706,1243161,1000,22261,1000,24261,2000,1001,22.261,0.0
74707,534386,1000,6000,1000,8000,2000,1001,6.0,0.0
74709,255595,1000,1000,1000,3000,2000,1001,1.0,0.0
7471,248028,0,2960,0,3460,500,501,5.92,0.0
74711,1851389,1000,31647,1000,33647,2000,1001,31.647,0.0
74712,2199,0,10,0,15,5,6,2.0,0.0
74713,1958055,0,34479,0,35479,1000,1001,34.479,0.0
74714,403373,0,7120,0,7550,430,431,16.558,0.0
74715,57648,0,870,0,933,63,64,13.81,0.0
74716,773176,0,10136,0,11136,1000,1001,10.136,0.0
74717,19984,48,192,48,288,96,49,4.0,0.0
7472,76058,0,773,0,859,86,87,8.988,0.0
74723,3533934,1000,60927,1000,62927,2000,1001,60.927,0.0
74725,1200089,0,18997,0,19997,1000,1001,18.997,0.0
74726,925674,0,15048,0,16048,1000,1001,15.048,0.0
74728,1217653,0,19439,0,20439,1000,1001,19.439,0.0
74729,1141884,1000,21322,1000,23322,2000,1001,21.322,0.0
7473,69810,0,688,0,774,86,87,8.0,0.0
74730,28890,0,461,0,489,28,29,16.464,0.0
74732,73966,124,865,124,1113,248,125,6.976,0.0
74735,1247041,0,21000,0,22000,1000,1001,21.0,0.0
74739,824073,0,14500,0,15500,1000,1001,14.5,0.0
7474,3419,0,23,0,29,6,7,3.833,0.0
74740,1121603,0,17825,0,18825,1000,1001,17.825,0.0
74745,1984525,0,35646,0,36646,1000,1001,35.646,0.0
74748,255595,1000,1000,1000,3000,2000,1001,1.0,0.0
74749,1150580,0,26159,0,27159,1000,1001,26.159,0.0
7475,10759,0,170,0,186,16,17,10.625,0.0
74750,154534,0,1542,0,1754,212,213,7.274,0.0
74751,1036074,0,16045,0,17045,1000,1001,16.045,0.0
74760,890417,0,15040,0,16040,1000,1001,15.04,0.0
74762,617038,0,5709,0,6709,1000,1001,5.709,0.0
74763,54882,74,657,74,805,148,75,8.878,0.0
74765,140974,542,542,542,1626,1084,543,1.0,0.0
74766,25608,0,342,0,360,18,19,19.0,0.0
74767,458524,0,7000,0,8000,1000,1001,7.0,0.0
74768,1045903,1000,18720,1000,20720,2000,1001,18.72,0.0
74770,255596,0,1000,0,2000,1000,1001,1.0,0.0
74772,58872,0,480,0,640,160,161,3.0,0.0
74774,1009850,0,18282,0,19282,1000,1001,18.282,0.0
74777,101103,0,1320,0,1452,132,133,10.0,0.0
74778,1026062,0,14996,0,15996,1000,1001,14.996,0.0
74780,1984499,0,35900,0,36900,1000,1001,35.9,0.0
74781,675172,0,11044,0,12044,1000,1001,11.044,0.0
74782,2000414,0,17329,0,19357,2028,2025,17.329,0.0
74785,78447,0,1455,0,1548,93,94,15.645,0.0
74786,680946,0,9000,0,10000,1000,1001,9.0,0.0
74787,52539,0,789,0,830,41,42,19.244,0.0
74789,464055,492,9079,492,10063,984,493,18.453,0.0
7479,42060,0,819,0,854,35,36,23.4,0.0
74790,824031,0,12000,0,13000,1000,1001,12.0,0.5
74792,868318,1000,5846,1000,7846,2000,1001,5.846,0.0
74793,143026,0,2021,0,2064,43,44,47.0,0.5
74794,21978996,0,454966,0,455966,1000,1001,454.966,0.0
74795,6370281,1000,25263,1000,27263,2000,1001,25.263,1.0
74796,255595,1000,1000,1000,3000,2000,1001,1.0,0.0
7480,557672,0,7886,0,8386,500,501,15.772,0.0
74800,580525,0,10885,0,11885,1000,1001,10.885,0.0
74801,431710,1000,4000,1000,6000,2000,1001,4.0,0.5
74807,13921,0,165,0,180,15,16,11.0,0.0
74808,1093090,0,19000,0,20000,1000,1001,19.0,0.0
74809,135916,266,1572,266,2104,532,267,5.91,0.0
7481,11167,0,181,0,195,14,15,12.929,0.0
74810,464255,0,6112,0,6435,323,324,18.923,0.0
74811,1372855,0,19909,0,20909,1000,1001,19.909,0.0
74818,6806,0,70,0,85,15,16,4.667,0.0
74819,1325459,0,14709,0,15709,1000,1001,14.709,0.0
7482,128745,0,1676,0,1903,227,228,7.383,0.0
74820,189521,0,2714,0,2773,59,60,46.0,0.0
74822,1408564,0,25128,0,26128,1000,1001,25.128,0.0
74825,721328,0,8871,0,9871,1000,1001,8.871,0.0
74827,1821820,0,21339,0,22339,1000,1001,21.339,0.5
74828,255596,0,1000,0,2000,1000,1001,1.0,0.0
74829,5354,0,45,0,54,9,10,5.0,0.0
7483,2043,0,9,0,15,6,7,3.0,0.0
74830,691243,0,9830,0,10260,430,431,22.86,0.0
74831,1070971,0,19000,0,20000,1000,1001,19.0,0.0
74834,957360,1000,15812,1000,17812,2000,1001,15.812,0.5
74835,286902,0,2355,0,2679,324,294,14.537,0.5
74836,1131936,0,18999,0,19999,1000,1001,18.999,0.0
74837,4171271,0,74945,0,75945,1000,1001,74.945,0.0
74838,17585,0,135,0,162,27,28,5.0,0.0
74839,4572502,0,55999,0,56999,1000,1001,55.999,0.0
7484,54105,116,580,116,812,232,117,5.0,0.0
74840,681423,1000,10450,1000,12450,2000,1001,10.45,0.0
74841,14396,0,234,0,248,14,15,16.714,0.0
74843,440880,1000,4000,1000,6000,2000,1001,4.0,0.0
74844,1074792,0,14614,0,15614,1000,1001,14.614,0.0
74846,255596,0,1000,0,2000,1000,1001,1.0,0.0
74848,2019150,0,31865,0,32865,1000,1001,31.865,0.0
7485,109084,235,1175,235,1645,470,236,5.0,0.0
74850,4502,0,40,0,45,5,6,8.0,0.0
74852,318934,368,5686,368,6422,736,369,15.451,0.0
74853,4296539,0,46381,0,47381,1000,1001,46.381,0.0
74855,837178,0,7013,0,8013,1000,1001,7.013,0.0
74856,151663,0,1358,0,1552,194,195,7.0,0.0
74857,677983,0,10887,0,11310,423,424,25.738,0.0
7486,274967,520,4112,520,5152,1040,522,7.908,0.0
74861,50499,0,724,0,761,37,38,19.568,0.0
74867,1012779,0,13592,0,14592,1000,1001,13.592,1.0
74868,1102636,0,19815,0,20815,1000,1001,19.815,0.0
74869,1054458,0,20366,0,21366,1000,1001,20.366,0.0
7487,2864,5,20,5,30,10,6,4.0,0.0
74871,1092985,0,16995,0,17995,1000,1001,16.995,0.0
74872,583967,0,7000,0,8000,1000,1001,7.0,0.5
74873,21844,0,255,0,306,51,52,5.0,0.0
74874,1182973,0,19899,0,20899,1000,1001,19.899,0.0
74875,935007,0,14740,0,15740,1000,1001,14.74,1.0
74876,125287,197,1143,197,1537,394,198,5.802,0.0
74877,1399397,0,25173,0,26173,1000,1001,25.173,0.0
74878,705392,0,2000,0,3000,1000,1001,2.0,0.0
74879,716980,1000,10000,1000,12000,2000,1001,10.0,0.0
7488,233180,0,2500,0,3000,500,501,5.0,0.0
74881,1196202,0,22991,0,23991,1000,1001,22.991,0.0
74883,23368,0,344,0,364,20,21,17.2,0.0
74887,2668224,0,49243,0,50243,1000,1001,49.243,0.0
74888,475831,0,4662,0,5662,1000,1001,4.662,0.0
74889,1431376,571,14881,571,16023,1142,572,26.061,0.0
74895,517123,0,6358,0,7358,1000,1001,6.358,0.0
74897,438993,1000,4991,1000,6991,2000,1001,4.991,0.0
7490,10792,0,170,0,186,16,17,10.625,0.0
74901,674480,0,9704,0,10704,1000,1001,9.704,0.0
74902,251808,0,3048,0,3556,508,509,6.0,1.0
74905,1040595,913,14194,913,16020,1826,914,15.547,0.0
74908,1644039,0,23988,0,24988,1000,1001,23.988,0.0
74909,47014,101,416,101,618,202,102,4.119,0.0
7491,3606,0,23,0,29,6,7,3.833,0.0
74912,174065,0,2485,0,2594,109,110,22.798,0.0
74922,596985,1000,8000,1000,10000,2000,1001,8.0,0.0
74924,123510,0,993,0,1192,199,200,4.99,0.0
74925,1075434,0,18811,0,19811,1000,1001,18.811,0.0
74927,1608299,0,34541,0,35541,1000,1001,34.541,0.0
74930,1303654,0,19000,0,20000,1000,1001,19.0,0.0
74935,7118244,0,70364,0,71364,1000,1001,70.364,0.0
74937,1454115,0,9411,0,10411,1000,1001,9.411,0.0
7494,4756,5,60,5,75,15,12,6.0,0.0
74943,1985,0,12,0,16,4,5,3.0,0.0
74946,599278,1000,11000,1000,13000,2000,1001,11.0,0.0
74949,6157,0,60,0,75,15,16,4.0,0.0
7495,42542,60,480,60,660,180,67,8.0,0.0
74950,1149057,0,19030,0,20030,1000,1001,19.03,0.0
74951,372595,0,3000,0,4000,1000,1001,3.0,0.0
74955,319922,0,3219,0,4024,805,806,3.999,0.0
74958,1547861,0,28343,0,29343,1000,1001,28.343,0.0
74962,120188,0,924,0,1232,308,309,3.0,0.0
74965,23484,0,238,0,287,49,50,4.857,0.0
74971,647752,0,9000,0,10000,1000,1001,9.0,0.0
74979,619543,1000,8672,1000,10672,2000,1001,8.672,0.0
7498,207930,0,2500,0,3000,500,501,5.0,0.0
74980,635971,1000,10000,1000,12000,2000,1001,10.0,0.0
74981,18681,0,162,0,204,42,43,3.857,0.0
74986,721014,0,8362,0,8938,576,577,14.517,1.0
74991,549316,0,5723,0,6723,1000,1001,5.723,0.0
74992,689743,0,9057,0,10057,1000,1001,9.057,0.0
74993,164631,0,2529,0,2810,281,282,9.0,1.0
74994,253595,0,1000,0,2000,1000,1001,1.0,0.0
74995,381997,0,4000,0,5000,1000,1001,4.0,0.0
74997,59009,0,940,0,995,55,56,17.091,0.0
74998,5455,0,84,0,89,5,6,16.8,0.0
7500,3816,0,60,0,65,5,6,12.0,0.0
75000,3900,0,36,0,45,9,10,4.0,0.0
75007,28212,0,252,0,327,75,76,3.36,0.0
75009,700397,0,14443,0,15367,924,925,15.631,0.0
7501,256583,421,1684,421,2947,1263,843,4.0,0.5
75010,168737,0,2397,0,2448,51,52,47.0,0.0
75013,592747,0,6000,0,7000,1000,1001,6.0,0.0
75017,486086,0,6000,0,7000,1000,1001,6.0,0.0
75018,1387910,1000,29939,1000,31939,2000,1001,29.939,0.0
7502,77404,0,475,0,551,76,77,6.25,0.0
7503,396381,0,4971,0,5471,500,501,9.942,0.0
75030,1731437,0,36538,0,37538,1000,1001,36.538,0.0
75034,820027,1000,7516,1000,9516,2000,1001,7.516,0.0
75035,1793365,1000,15599,1000,17599,2000,1001,15.599,0.0
7504,158420,27,1016,27,1570,554,529,1.928,0.5
75040,67863,0,748,0,823,75,76,9.973,0.0
75041,547398,1000,7085,1000,9085,2000,1001,7.085,0.5
75042,34822,0,583,0,613,30,31,19.433,0.0
75044,46698,178,178,178,534,356,179,1.0,0.0
75046,45313,0,460,0,552,92,93,5.0,0.0
75047,1040509,0,14000,0,15000,1000,1001,14.0,0.0
75048,945899,0,6960,0,7960,1000,1001,6.96,0.0
75049,1366044,0,24788,0,25788,1000,1001,24.788,0.0
7505,8900,0,159,0,172,13,14,12.231,0.0
75051,932487,928,9271,928,11127,1856,929,9.99,0.0
75054,1280882,0,23123,0,24123,1000,1001,23.123,0.0
75057,1250271,0,17195,0,17793,598,599,28.754,0.0
75058,75071,0,680,0,820,140,141,4.857,0.0
75059,445151,0,5000,0,6000,1000,1001,5.0,0.0
7506,8828,0,159,0,172,13,14,12.231,0.0
75062,612355,0,11000,0,12000,1000,1001,11.0,0.0
75067,864829,0,14337,0,15228,891,892,16.091,0.0
75068,255595,1000,1000,1000,3000,2000,1001,1.0,0.0
75069,1721359,0,13864,0,14864,1000,1001,13.864,0.0
7507,5994,9,36,9,63,27,19,4.0,0.0
75070,3750507,0,51792,0,52792,1000,1001,51.792,0.0
75071,21289,54,216,54,324,108,55,4.0,0.0
75073,1265758,0,17003,0,18003,1000,1001,17.003,0.0
75075,9759,0,114,0,134,20,21,5.7,0.0
75077,838948,0,16704,0,17704,1000,1001,16.704,0.0
75081,563443,1000,8204,1000,10204,2000,1001,8.204,0.0
75082,1727188,0,22000,0,23000,1000,1001,22.0,0.0
75083,12985,0,146,0,165,19,20,7.684,0.0
75084,51000,45,859,45,949,90,46,19.089,1.0
75085,2723614,0,41961,0,42961,1000,1001,41.961,0.0
75086,432868,93,5486,93,5672,186,94,58.989,0.0
75087,511785,0,6000,0,7000,1000,1001,6.0,0.0
75088,1115762,0,11717,0,12717,1000,1001,11.717,0.0
75089,778676,1000,8664,1000,10664,2000,1001,8.664,0.0
75090,253565,0,2723,0,3216,493,494,5.523,0.0
75091,688954,1000,9000,1000,11000,2000,1001,9.0,0.0
75092,174324,210,2929,210,3349,420,211,13.948,1.0
75095,5955,0,55,0,66,11,12,5.0,0.0
75096,796163,0,13976,0,14976,1000,1001,13.976,0.0
75097,5417361,0,85818,0,86818,1000,1001,85.818,0.0
75098,145413,0,1661,0,1940,279,280,5.953,0.5
75100,3570901,0,99412,0,100412,1000,1001,99.412,0.0
75101,9309,10,140,10,160,20,11,14.0,0.0
75105,467065,0,6043,0,7043,1000,1001,6.043,0.0
75106,759384,0,10026,0,11026,1000,1001,10.026,0.0
75107,3851237,1000,35166,1000,37166,2000,1001,35.166,0.0
75109,598528,0,7247,0,8247,1000,1001,7.247,0.0
7511,472249,0,7412,0,7912,500,501,14.824,0.0
75110,20794,0,198,0,241,43,44,4.605,0.0
75111,1071815,0,20000,0,21000,1000,1001,20.0,0.0
75113,466591,0,6000,0,7000,1000,1001,6.0,0.0
75116,852782,1000,9367,1000,11367,2000,1001,9.367,0.0
75118,1124406,1000,19589,1000,21589,2000,1001,19.589,0.0
75119,1572270,0,24934,0,25934,1000,1001,24.934,0.0
7512,17176,46,138,46,230,92,47,3.0,0.0
75120,562811,0,9000,0,10000,1000,1001,9.0,0.0
75121,6055,0,36,0,60,24,25,3.0,0.0
75123,8868,0,119,0,131,12,13,9.917,0.0
75125,255595,1000,1000,1000,3000,2000,1001,1.0,0.0
7513,4927,11,33,11,55,22,12,3.0,0.0
75130,108221,0,1674,0,1860,186,187,9.0,0.0
75131,1873752,1000,40000,1000,42000,2000,1001,40.0,0.0
75133,375979,515,4924,515,5954,1030,516,9.561,0.0
75135,255596,0,1000,0,2000,1000,1001,1.0,0.0
7514,5871,12,60,12,84,24,13,5.0,0.0
7515,10711,24,96,24,144,48,25,4.0,0.0
7516,3320689,500,17500,500,18500,1000,501,35.0,0.0
7517,104485,0,1470,0,1680,210,211,7.0,0.0
7518,78775,0,695,0,869,174,175,3.994,0.0
7519,50699,0,414,0,552,138,139,3.0,0.0
752,10217,0,92,0,115,23,24,4.0,0.0
7521,6380,0,97,0,109,12,13,8.083,0.0
7522,6318,0,96,0,108,12,13,8.0,0.5
75221,496439,0,8000,0,9000,1000,1001,8.0,0.0
75223,1629445,0,30626,0,31626,1000,1001,30.626,0.0
75224,599768,809,5431,809,7049,1618,810,6.713,0.0
75229,756245,0,5000,0,6000,1000,1001,5.0,0.0
7523,75064,0,615,0,820,205,206,3.0,0.0
7525,702055,0,9441,0,9941,500,501,18.882,0.0
7526,71097,0,675,0,844,169,170,3.994,0.0
7527,6898,0,65,0,78,13,14,5.0,0.0
7528,1961045,0,39500,0,40000,500,501,79.0,0.0
7530,7103,0,96,0,108,12,13,8.0,0.0
75307,17096,0,260,0,280,20,21,13.0,0.0
7531,693260,0,10000,0,10500,500,501,20.0,0.0
7532,10759,0,170,0,186,16,17,10.625,0.0
75322,81754,0,744,0,852,108,109,6.889,0.0
75324,755161,0,9903,0,10903,1000,1001,9.903,0.0
75325,13302818,913,18235,913,20061,1826,914,19.973,0.0
75327,1726552,0,24996,0,25996,1000,1001,24.996,0.0
75328,768434,0,11000,0,12000,1000,1001,11.0,0.0
75330,43182,0,399,0,469,70,71,5.7,0.0
75331,142545,0,1863,0,2115,252,253,7.393,0.0
75332,1335927,0,21997,0,22997,1000,1001,21.997,0.0
75333,259596,1000,1000,1000,3000,2000,1001,1.0,0.0
75334,885971,0,18000,0,19000,1000,1001,18.0,0.0
75335,3271594,0,67334,0,68334,1000,1001,67.334,0.0
75336,903375,0,17000,0,18000,1000,1001,17.0,0.0
75337,604716,1000,8868,1000,10868,2000,1001,8.868,0.5
75338,49956,0,614,0,655,41,42,14.976,0.0
75339,2408867,0,24000,0,25000,1000,1001,24.0,0.0
7534,256485,0,3000,0,3500,500,501,6.0,0.0
75343,340595,1000,3000,1000,5000,2000,1001,3.0,0.0
75344,886070,0,18000,0,19000,1000,1001,18.0,0.0
75345,893460,0,16860,0,17860,1000,1001,16.86,0.0
75346,16967,0,192,0,216,24,25,8.0,0.0
75347,210869,0,2991,0,3140,149,150,20.074,0.0
75348,1363569,0,25902,0,26902,1000,1001,25.902,0.5
75349,736177,0,11783,0,12502,719,720,16.388,0.5
7535,3142,0,20,0,25,5,6,4.0,0.0
75351,182162,0,3087,0,3351,264,265,11.693,0.0
75352,34927,0,288,0,348,60,61,4.8,0.5
75353,892490,1000,14000,1000,16000,2000,1001,14.0,0.5
75354,1180780,1000,23260,1000,25260,2000,1001,23.26,0.0
75355,1684815,0,28568,0,29568,1000,1001,28.568,0.0
75356,1303089,0,30385,0,31385,1000,1001,30.385,0.0
75357,484116,0,4861,0,4930,69,70,70.449,0.0
75358,485798,0,7807,0,8253,446,447,17.504,1.0
75359,751839,0,14778,0,15778,1000,1001,14.778,0.0
7536,66451,0,1298,0,1416,118,119,11.0,0.5
75360,64461,0,378,0,441,63,64,6.0,1.0
75363,6717,8,64,8,88,24,18,4.0,0.0
75364,769100,1000,10878,1000,12878,2000,1001,10.878,0.0
75365,1476110,0,34363,0,35363,1000,1001,34.363,0.0
75366,255595,1000,1000,1000,3000,2000,1001,1.0,0.5
75367,479577,0,4973,0,5973,1000,1001,4.973,0.0
75368,447846,423,2944,423,4213,1269,847,6.96,0.5
75369,140781,0,2688,0,2856,168,169,16.0,0.0
7537,207109,0,2500,0,3000,500,501,5.0,0.0
75370,160908,315,1900,315,2530,630,316,6.032,0.0
75371,670460,0,8973,0,9973,1000,1001,8.973,0.0
75372,910512,0,17813,0,18813,1000,1001,17.813,0.75
75373,543449,0,8459,0,9459,1000,1001,8.459,0.0
75376,716232,1000,9771,1000,11771,2000,1001,9.771,0.0
75377,1079930,0,18000,0,19000,1000,1001,18.0,0.0
75378,329858,0,5304,0,5712,408,409,13.0,0.0
75379,16058505,0,322863,0,323863,1000,1001,322.863,0.0
7538,296252,167,4715,167,5049,334,168,28.234,0.0
75380,736024,0,5000,0,6000,1000,1001,5.0,0.0
75381,1706652,0,25000,0,26000,1000,1001,25.0,0.0
75382,829256,0,11000,0,12000,1000,1001,11.0,0.0
75383,1680184,0,24000,0,25000,1000,1001,24.0,0.0
75385,337413,0,3570,0,4165,595,596,6.0,0.0
75386,53046,0,415,0,498,83,84,5.0,0.0
75387,107384,235,1175,235,1645,470,236,5.0,0.0
75388,1093765,0,19000,0,20000,1000,1001,19.0,0.0
7539,590827,0,12500,0,13000,500,501,25.0,1.0
75391,1124042,0,14488,0,15488,1000,1001,14.488,1.0
75392,883171,0,15802,0,16802,1000,1001,15.802,0.0
75393,42610,0,620,0,653,33,34,18.788,0.0
75399,756483,0,14000,0,15000,1000,1001,14.0,0.0
75400,6732,8,64,8,88,24,18,4.0,0.0
75401,136758,0,1735,0,2026,291,292,5.962,0.0
75404,645973,1000,7972,1000,9972,2000,1001,7.972,0.0
75407,1147130,0,16000,0,17000,1000,1001,16.0,0.0
75408,696684,0,10229,0,11229,1000,1001,10.229,1.0
75409,432079,990,5929,990,7909,1980,991,5.989,0.0
7541,53051,113,561,113,787,226,114,4.965,0.0
75410,1181782,0,17511,0,18511,1000,1001,17.511,0.0
75412,822822,0,16496,0,17496,1000,1001,16.496,0.0
75414,1029415,0,18153,0,19115,962,963,18.87,0.0
75417,679653,0,9867,0,10867,1000,1001,9.867,0.5
75422,274509,0,3761,0,3835,74,75,50.824,0.0
75423,979477,0,19142,0,20052,910,911,21.035,0.0
75424,123793,286,1430,286,2002,572,287,5.0,0.0
75426,1650492,0,17921,0,18344,423,424,42.366,0.0
75428,421617,1000,4767,1000,6767,2000,1001,4.767,0.0
75429,8095,0,60,0,80,20,21,3.0,0.0
7543,571312,0,9273,0,9773,500,501,18.546,0.0
75430,108362,0,921,0,1228,307,308,3.0,1.0
75433,434491,0,4000,0,5000,1000,1001,4.0,0.5
75437,108929,0,2344,0,2407,63,64,37.206,0.0
7544,16755,10,451,10,471,20,11,45.1,0.0
75444,26272,0,367,0,383,16,17,22.938,0.0
75446,1236773,0,18570,0,19570,1000,1001,18.57,0.0
75447,560716,0,5867,0,6399,532,533,11.028,0.0
75448,566927,1000,7123,1000,9123,2000,1001,7.123,0.5
7545,1429,1,11,1,14,3,4,5.5,0.0
75451,930676,0,17000,0,18000,1000,1001,17.0,0.0
75453,45659,0,1036,0,1078,42,43,24.667,0.0
75454,796670,0,10925,0,11925,1000,1001,10.925,0.0
75455,2365048,987,25814,987,28117,2303,1318,19.616,0.0
75458,409287,0,6188,0,6394,206,207,30.039,0.0
75459,342571,0,3542,0,4136,594,595,5.963,0.0
7546,460751,500,6500,500,7500,1000,501,13.0,0.0
75460,171706,0,2848,0,2963,115,116,24.765,0.0
75461,100177,0,810,0,931,121,122,6.694,0.0
75463,72349,0,873,0,970,97,98,9.0,0.0
75464,1082621,0,6996,0,7996,1000,1001,6.996,0.0
75469,189353,375,2250,375,3000,750,376,6.0,0.0
7547,339136,500,5000,500,6000,1000,501,10.0,0.0
75470,23820,0,483,0,504,21,22,23.0,0.5
75472,32121,83,415,83,581,166,84,5.0,0.0
75475,512544,0,5497,0,6497,1000,1001,5.497,0.0
75476,1090940,0,17996,0,18996,1000,1001,17.996,0.5
75477,1374138,0,17820,0,18820,1000,1001,17.82,0.0
75479,65089,0,720,0,840,120,121,6.0,0.0
7548,262688,500,3500,500,4500,1000,501,7.0,0.0
75482,281682,161,4911,161,5394,483,324,15.252,0.0
75485,908439,0,16875,0,17875,1000,1001,16.875,0.0
75487,281327,0,4536,0,4860,324,325,14.0,0.0
75489,720144,1000,14198,1000,16198,2000,1001,14.198,0.0
7549,6710,0,98,0,111,13,14,7.538,0.0
75492,806415,0,12922,0,13922,1000,1001,12.922,0.0
75496,755694,0,14000,0,15000,1000,1001,14.0,0.0
75497,23545,0,126,0,189,63,64,2.0,0.0
75498,26838958,0,231000,0,232000,1000,1001,231.0,0.0
75499,984144,1000,12000,1000,14000,2000,1001,12.0,0.0
7550,274992,500,3000,500,4000,1000,501,6.0,0.0
75502,98759,0,388,0,776,388,389,1.0,0.0
75508,29262,0,327,0,381,54,55,6.056,0.0
75509,24670,0,252,0,278,26,27,9.692,0.5
7551,6372,0,96,0,108,12,13,8.0,0.0
75512,537411,1000,7201,1000,9201,2000,1001,7.201,0.0
75516,863245,0,9727,0,10241,514,515,18.924,0.5
75517,1049606,0,15937,0,16937,1000,1001,15.937,0.0
75518,849068,0,12000,0,13000,1000,1001,12.0,1.0
75520,97970,0,1202,0,1409,207,208,5.807,0.0
75522,1021938,0,16000,0,17000,1000,1001,16.0,0.0
75524,465131,0,1687,0,1775,88,89,19.17,0.0
75526,1025211,0,17475,0,18475,1000,1001,17.475,0.0
7553,227862,0,2419,0,2919,500,501,4.838,0.0
75530,347181,0,6825,0,7000,175,176,39.0,0.75
75532,1265805,0,13882,0,14188,306,307,45.366,0.0
75535,43951,0,611,0,624,13,14,47.0,0.0
75538,371804,0,3999,0,4999,1000,1001,3.999,0.0
7554,424650,0,7062,0,7562,500,501,14.124,0.0
75540,1744941,0,29713,0,30713,1000,1001,29.713,0.0
75543,4817,0,48,0,57,9,10,5.333,0.0
75545,38411,0,348,0,464,116,117,3.0,0.0
75546,2441707,0,26491,0,27086,595,596,44.523,0.0
75549,1182721,0,19278,0,20278,1000,1001,19.278,0.0
75552,498345,0,8000,0,9000,1000,1001,8.0,0.0
75554,1372884,0,3564,0,4158,594,595,6.0,0.0
75556,88576,0,1568,0,1666,98,99,16.0,0.0
75557,914973,0,17000,0,18000,1000,1001,17.0,0.0
75559,503709,1000,8000,1000,10000,2000,1001,8.0,0.0
75561,5298,6,48,6,66,18,14,4.0,0.0
75562,54345,66,815,66,947,132,67,12.348,0.75
75563,3011197,0,41466,0,42466,1000,1001,41.466,0.0
75565,5128872,2938,54378,2938,61254,6876,3940,13.809,0.0
75566,834796,0,9725,0,10725,1000,1001,9.725,0.0
75568,1188995,1000,19570,1000,21570,2000,1001,19.57,0.0
7557,346682,0,3500,0,4500,1000,1001,7.0,0.0
75570,2153824,0,28352,0,28826,474,475,59.814,0.5
75572,624327,0,9983,0,10983,1000,1001,9.983,0.0
75575,276441,532,3192,532,4256,1064,533,6.0,0.0
75576,105578,0,1240,0,1395,155,156,8.0,0.0
75577,2423527,0,36791,0,37791,1000,1001,36.791,0.0
75578,1733009,0,25000,0,26000,1000,1001,25.0,0.0
75579,960713,1000,15200,1000,17200,2000,1001,15.2,0.0
7558,245402,0,2916,0,3416,500,501,5.832,0.0
75580,1133238,0,20976,0,21976,1000,1001,20.976,0.0
75581,571210,0,10000,0,11000,1000,1001,10.0,0.0
75584,380757,1000,4000,1000,6000,2000,1001,4.0,0.0
75586,455763,0,8330,0,8820,490,491,17.0,0.0
75587,899106,1000,18000,1000,20000,2000,1001,18.0,0.0
75588,155703,0,1600,0,1920,320,321,5.0,0.0
75589,898826,1000,18000,1000,20000,2000,1001,18.0,0.0
7559,2169,0,12,0,16,4,5,3.0,0.0
75590,3024310,1000,41911,1000,43911,2000,1001,41.911,0.0
75591,518133,1000,8000,1000,10000,2000,1001,8.0,0.0
75592,1268438,0,16995,0,17995,1000,1001,16.995,0.0
75593,188968,0,2125,0,2550,425,426,5.0,0.0
75594,875932,0,18000,0,19000,1000,1001,18.0,0.0
75595,4620869,0,25309,0,26309,1000,1001,25.309,0.0
75596,3550151,0,74629,0,75629,1000,1001,74.629,0.0
75597,811698,0,13374,0,14374,1000,1001,13.374,0.0
7560,9160,0,84,0,101,17,18,4.941,0.0
75600,1739713,1000,24241,1000,26241,2000,1001,24.241,0.5
75601,5135665,2939,54593,2939,61471,6878,3941,13.86,0.0
75602,1507539,1000,24872,1000,26872,2000,1001,24.872,0.5
75603,4006,0,36,0,42,6,7,6.0,0.0
75604,867795,0,17000,0,18000,1000,1001,17.0,0.0
75605,544852,0,6000,0,7000,1000,1001,6.0,0.0
75606,32571,80,320,80,480,160,81,4.0,0.0
75607,39341,0,200,0,240,40,41,5.0,0.0
75609,323664,0,3000,0,4000,1000,1001,3.0,0.0
75610,478831,0,7000,0,8000,1000,1001,7.0,0.0
75611,32480,83,415,83,581,166,84,5.0,0.0
75612,542238,0,6948,0,7720,772,773,9.0,0.0
75613,1608616,0,26000,0,27000,1000,1001,26.0,0.0
75614,1598016,864,18642,864,20766,2124,1262,14.795,0.0
75615,852016,0,14455,0,15023,568,569,25.449,0.0
75616,255887,0,3370,0,3707,337,338,10.0,0.0
75617,908864,0,16660,0,17640,980,981,17.0,0.0
75618,140627,0,2688,0,2856,168,169,16.0,0.0
75619,5042994,2820,55385,2820,61983,6598,3780,14.66,0.0
7562,288357,0,2000,0,3000,1000,1000,4.0,0.0
75620,860608,0,9000,0,10000,1000,1001,9.0,0.0
75623,654207,0,8946,0,9585,639,640,14.0,0.0
75627,110349,0,1296,0,1458,162,163,8.0,0.0
7563,326608,0,4000,0,4500,500,501,8.0,0.0
75632,483165,0,4974,0,5974,1000,1001,4.974,0.0
75633,1110853,0,15198,0,16198,1000,1001,15.198,0.0
75635,44274,108,540,108,756,216,109,5.0,0.0
75636,182501,0,2530,0,2640,110,111,23.0,0.0
75637,526699,0,6000,0,7000,1000,1001,6.0,0.0
75638,868674,0,17000,0,18000,1000,1001,17.0,0.0
7564,1007560,0,17047,0,17547,500,501,34.094,0.0
75643,1498006,0,16408,0,16761,353,354,46.482,0.0
75644,1704120,0,21508,0,22508,1000,1001,21.508,0.0
75645,321691,0,4536,0,5292,756,757,6.0,0.0
75646,71433,0,800,0,960,160,161,5.0,0.0
75647,700669,0,10356,0,11356,1000,1001,10.356,0.0
75648,51595,0,433,0,521,88,89,4.92,0.0
75651,16650,0,207,0,230,23,24,9.0,0.0
75652,73844,0,1250,0,1314,64,65,19.531,0.0
75655,305903,0,4826,0,5391,565,566,8.542,0.0
75657,536327,0,7808,0,8808,1000,1001,7.808,0.0
75658,44888,0,784,0,833,49,50,16.0,0.0
75659,1938323,1000,26169,1000,28169,2000,1001,26.169,0.0
7566,371102,0,5433,0,5933,500,501,10.866,0.0
75660,255595,1000,1000,1000,3000,2000,1001,1.0,0.0
75662,914332,0,17000,0,18000,1000,1001,17.0,0.0
75663,26100,0,240,0,294,54,55,4.444,0.0
75664,78472,160,910,160,1230,320,161,5.688,0.0
75666,227003,0,2500,0,2554,54,55,46.296,0.0
75668,1387270,0,19944,0,20944,1000,1001,19.944,0.0
75669,744004,0,10000,0,11000,1000,1001,10.0,0.0
7567,44115,0,472,0,531,59,60,8.0,0.0
75670,255595,1000,1000,1000,3000,2000,1001,1.0,0.0
75671,732656,0,13000,0,14000,1000,1001,13.0,0.0
75672,269912,525,3150,525,4200,1050,526,6.0,0.0
75673,4879,0,49,0,62,13,14,3.769,0.0
75675,698082,0,10000,0,11000,1000,1001,10.0,0.0
75676,930036,0,18000,0,19000,1000,1001,18.0,0.0
75677,125205,0,1905,0,2080,175,176,10.886,0.0
75680,6875,0,114,0,120,6,7,19.0,0.0
75682,243148,140,2890,140,3218,328,190,15.372,0.0
75683,305534,411,3731,411,4553,822,412,9.078,0.0
75684,859408,0,15912,0,16912,1000,1001,15.912,0.0
75685,2116591,1000,7000,1000,9000,2000,1001,7.0,0.0
75686,32140,0,320,0,400,80,81,4.0,0.0
75688,743699,0,10000,0,11000,1000,1001,10.0,0.0
7569,222932,1,4274,1,4703,429,430,9.986,0.0
75690,60481,0,800,0,900,100,101,8.0,0.0
75692,404953,0,4241,0,4443,202,203,20.995,0.0
75694,41100,83,332,83,498,166,84,4.0,0.0
75698,736395,0,10995,0,11995,1000,1001,10.995,0.0
75699,2242142,1992,35692,1992,39676,3984,1994,17.918,0.0
7570,585528,500,9388,500,11369,1981,1201,9.388,0.0
75700,656784,1000,7823,1000,9823,2000,1001,7.823,0.0
75701,1344247,0,37758,0,38758,1000,1001,37.758,0.0
75702,426416,0,3000,0,5000,2000,1655,3.0,0.0
75704,83482,0,1008,0,1120,112,113,9.0,0.0
75706,44790,0,462,0,527,65,66,7.108,1.0
75708,19579,0,306,0,324,18,19,17.0,0.0
75709,81151,0,952,0,1071,119,120,8.0,0.0
7571,254234,0,3499,0,3999,500,501,6.998,0.5
75710,1021764,0,14579,0,15579,1000,1001,14.579,0.0
75711,814271,0,14792,0,15792,1000,1001,14.792,0.0
75712,1472920,0,23000,0,24000,1000,1001,23.0,0.0
75713,2308115,0,41813,0,42813,1000,1001,41.813,0.0
75714,761797,0,10000,0,11000,1000,1001,10.0,0.0
75716,799820,0,15785,0,16785,1000,1001,15.785,0.0
75717,246255,278,2803,278,3359,556,279,10.083,0.0
75718,311820,75,4333,75,4483,150,76,57.773,0.0
75719,168885,85,1268,85,1438,170,86,14.918,0.0
75720,1369109,0,19838,0,20838,1000,1001,19.838,0.0
75721,11099,0,164,0,177,13,14,12.615,0.0
75722,1100560,0,17713,0,18713,1000,1001,17.713,0.0
75723,417830,0,7318,0,7737,419,420,17.465,0.0
75725,3115053,1000,80844,1000,82844,2000,1001,80.844,0.0
75726,1513723,0,24000,0,25000,1000,1001,24.0,0.0
75728,498803,0,6637,0,7637,1000,1001,6.637,0.0
7573,30589,0,370,0,444,74,75,5.0,0.0
75730,904488,0,16844,0,17844,1000,1001,16.844,0.0
75731,56007,0,504,0,567,63,64,8.0,1.0
75732,854503,0,11000,0,12000,1000,1001,11.0,0.0
75733,7889,0,44,0,66,22,22,4.0,0.0
75736,7510112,0,149603,0,150603,1000,1001,149.603,0.0
7574,365762,347,4264,347,4958,694,348,12.288,1.0
75740,184734,0,3570,0,3780,210,211,17.0,0.0
75742,14981,0,253,0,276,23,24,11.0,0.0
75743,1100528,0,16996,0,17996,1000,1001,16.996,0.0
75746,1128570,1000,20000,1000,22000,2000,1001,20.0,0.0
7575,42055,90,450,90,630,180,91,5.0,0.0
75750,64931,0,1133,0,1236,103,104,11.0,0.0
75752,13738,0,160,0,180,20,21,8.0,0.0
75753,1481100,719,24485,719,26923,2438,1721,14.244,0.0
75754,32143,83,415,83,581,166,84,5.0,0.0
75755,83398,0,810,0,945,135,136,6.0,0.0
75756,1742671,0,27654,0,28654,1000,1001,27.654,0.0
75757,27121,65,260,65,390,130,66,4.0,0.0
75758,3127,0,24,0,30,6,7,4.0,0.0
7576,80848,173,865,173,1211,346,174,5.0,0.0
75760,766554,0,13629,0,14629,1000,1001,13.629,0.0
75761,1723667,0,22000,0,23000,1000,1001,22.0,0.0
75762,70997,0,1344,0,1428,84,85,16.0,0.0
75763,475006,0,5000,0,6000,1000,1001,5.0,0.0
75764,48401,0,177,0,236,59,60,3.0,0.0
75765,255595,1000,1000,1000,3000,2000,1001,1.0,0.0
75767,889771,0,16843,0,17843,1000,1001,16.843,0.0
75768,122641,0,2139,0,2335,196,197,10.913,0.0
75769,888695,0,16850,0,17850,1000,1001,16.85,0.0
7577,61808,132,660,132,924,264,133,5.0,0.0
75770,9925,5,190,5,200,10,6,38.0,0.0
75771,917970,0,17000,0,18000,1000,1001,17.0,0.0
75774,1868349,1000,40000,1000,42000,2000,1001,40.0,0.0
75775,3063277,1000,41137,1000,43137,2000,1001,41.137,0.0
75776,7233,0,57,0,76,19,20,3.0,0.0
75777,736255,0,12664,0,13664,1000,1001,12.664,0.0
75778,39949,0,507,0,528,21,22,24.143,0.5
75779,854770,0,17000,0,18000,1000,1001,17.0,0.0
7578,103301,224,1120,224,1568,448,225,5.0,0.0
75781,2162554,0,33000,0,34000,1000,1001,33.0,0.0
75782,9894,5,190,5,200,10,6,38.0,1.0
75783,725390,1000,10478,1000,12478,2000,1001,10.478,1.0
75784,363481,0,7140,0,7560,420,421,17.0,0.0
75785,3324,0,40,0,45,5,6,8.0,0.0
75786,895132,0,16855,0,17855,1000,1001,16.855,0.0
7579,28812,61,305,61,427,122,62,5.0,0.0
75790,1252625,719,14848,719,16537,1689,972,15.307,0.0
7580,499373,0,6500,0,7000,500,501,13.0,0.0
75802,28882,0,575,0,600,25,26,23.0,0.5
75804,88919,0,936,0,960,24,25,39.0,0.0
75806,5969,0,55,0,66,11,12,5.0,0.0
75807,963049,0,17402,0,18402,1000,1001,17.402,0.0
75809,34650,0,320,0,400,80,81,4.0,0.0
7581,240287,0,2919,0,3419,500,501,5.838,0.0
75810,714229,0,10000,0,11000,1000,1001,10.0,0.0
75811,70629,0,1344,0,1428,84,85,16.0,0.0
75813,2068685,1303,23890,1303,26936,3046,1745,13.706,0.0
75814,11191,21,150,21,192,42,22,7.143,0.0
75815,855118,0,17000,0,18000,1000,1001,17.0,0.0
75816,70364,0,1344,0,1428,84,85,16.0,0.0
75818,2225798,1254,24747,1254,27688,2941,1689,14.669,0.0
7582,6042,0,120,0,128,8,9,15.0,0.0
75820,215093,0,2907,0,3230,323,324,9.0,0.5
75822,118156,0,1200,0,1440,240,241,5.0,0.0
75823,5078334,2878,56315,2878,63031,6716,3840,14.673,0.0
75825,835026,0,15000,0,16000,1000,1001,15.0,0.5
75826,566832,0,9123,0,10123,1000,1001,9.123,0.0
75828,77797,0,1058,0,1104,46,47,23.0,0.0
7583,15151,0,131,0,170,39,40,3.359,0.0
75836,1185064,0,27167,0,28167,1000,1001,27.167,0.0
75838,890815,0,16860,0,17860,1000,1001,16.86,0.0
7584,879032,0,16228,0,16728,500,501,32.456,0.0
75841,278822,0,3069,0,3135,66,67,46.5,0.0
75842,161658,269,2152,269,2690,538,270,8.0,0.0
75843,1257718,0,20544,0,21544,1000,1001,20.544,0.0
75844,21616,48,288,48,384,96,49,6.0,0.0
75845,3072261,20,160,20,200,40,21,8.0,0.0
75846,642726,0,8000,0,9000,1000,1001,8.0,0.0
7585,376801,0,5048,0,5548,500,501,10.096,0.0
75857,117378,61,1267,61,1412,145,86,15.083,0.0
75859,343198,0,3564,0,4158,594,595,6.0,0.0
7586,195623,0,1500,0,2000,500,501,3.0,0.0
75861,463475,0,6044,0,7044,1000,1001,6.044,0.0
75863,1261210,1000,24968,1000,26968,2000,1001,24.968,1.0
75864,1070353,1000,17916,1000,19916,2000,1001,17.916,0.0
75866,876216,0,11000,0,12000,1000,1001,11.0,0.0
75867,248034,0,2516,0,3229,713,714,3.529,0.0
7587,431088,0,6500,0,7000,500,501,13.0,0.0
75871,568089,0,10000,0,11000,1000,1001,10.0,0.0
75873,692697,0,11979,0,12979,1000,1001,11.979,0.0
75875,466160,1000,6000,1000,8000,2000,1001,6.0,0.0
75876,147038,320,1600,320,2240,640,321,5.0,0.0
75877,362553,0,7140,0,7560,420,421,17.0,0.0
7588,268555,0,3500,0,4000,500,501,7.0,0.0
75882,714085,0,10779,0,11779,1000,1001,10.779,0.0
75885,678592,0,10686,0,11686,1000,1001,10.686,0.0
75886,125355,0,1200,0,1440,240,241,5.0,0.0
75887,920030,0,17000,0,18000,1000,1001,17.0,0.0
75888,130564,0,1172,0,1465,293,294,4.0,0.0
7589,6273,0,60,0,70,10,11,6.0,0.0
75893,75579,147,1029,147,1323,294,148,7.0,0.0
75894,926327,0,13000,0,14000,1000,1001,13.0,0.5
7590,500387,0,7206,0,7706,500,501,14.412,0.0
75901,176174,0,1423,0,1643,220,221,6.468,0.0
75903,24683,93,93,93,279,186,94,1.0,0.0
75904,1756852,0,30561,0,31561,1000,1001,30.561,0.0
75905,376141,0,5280,0,5500,220,221,24.0,0.0
7591,3230,0,28,0,35,7,8,4.0,0.0
75911,30697,0,560,0,588,28,29,20.0,0.0
7592,10480,0,60,0,100,40,41,3.0,0.0
75922,454416,0,8330,0,8820,490,491,17.0,0.0
7593,76738,0,774,0,860,86,87,9.0,0.0
75931,1073259,0,17000,0,18000,1000,1001,17.0,0.0
75932,748580,0,14724,0,15724,1000,1001,14.724,0.0
75934,10434,0,57,0,95,38,39,3.0,0.0
75936,31540,80,320,80,480,160,81,4.0,0.0
75938,494606,0,8000,0,9000,1000,1001,8.0,0.0
75939,81604,160,1120,160,1440,320,161,7.0,0.0
7594,15072,0,131,0,170,39,40,3.359,0.0
7595,8562,0,165,0,176,11,12,15.0,0.0
7596,5061,0,84,0,91,7,8,12.0,0.0
75960,17281,0,294,0,308,14,15,21.0,0.0
75964,11431,23,138,23,184,46,24,6.0,0.0
75967,916322,0,17000,0,18000,1000,1001,17.0,0.0
75969,163277,0,2270,0,2472,202,203,11.238,0.0
7597,47814,0,420,0,560,140,141,6.0,0.0
75972,721626,0,12000,0,13000,1000,1001,12.0,0.0
75974,700091,0,10000,0,11000,1000,1001,10.0,0.0
75975,875322,0,18000,0,19000,1000,1001,18.0,0.0
7598,8828,0,159,0,172,13,14,12.231,0.0
75983,6203,0,52,0,65,13,14,4.0,0.0
75985,421434,0,4000,0,5000,1000,1001,4.0,0.0
75992,70868,0,1344,0,1428,84,85,16.0,0.0
75996,812700,1000,11946,1000,13946,2000,1001,11.946,0.0
75997,3007,3,42,3,48,6,4,14.0,0.0
75999,708414,0,10484,0,11484,1000,1001,10.484,0.0
7600,10378,23,47,23,116,69,47,2.043,0.0
76000,720918,0,12000,0,13000,1000,1001,12.0,0.0
76001,1001983,0,20000,0,21000,1000,1001,20.0,0.0
76002,864956,0,18000,0,19000,1000,1001,18.0,0.0
76005,255595,1000,1000,1000,3000,2000,1001,1.0,0.0
76008,1357372,0,13000,0,14000,1000,1001,13.0,0.0
7601,408103,0,6385,0,6885,500,501,12.77,0.0
76010,32189,0,300,0,375,75,76,4.0,0.0
76012,137982,0,1726,0,1899,173,174,9.977,0.0
76015,614438,0,11000,0,12000,1000,1001,11.0,0.0
7602,312879,0,4999,0,5499,500,501,9.998,0.0
76020,649517,0,8000,0,9000,1000,1001,8.0,0.0
76025,33722,80,320,80,480,160,81,4.0,0.0
7603,107884,0,1476,0,1687,211,212,6.995,0.0
76031,3208669,0,71000,0,72000,1000,1001,71.0,0.0
7604,371366,500,6238,500,7238,1000,501,12.476,0.0
76041,639574,0,9000,0,10000,1000,1001,9.0,0.0
76043,31064,0,320,0,400,80,81,4.0,0.0
76044,546922,0,7995,0,8995,1000,1001,7.995,0.0
76045,982143,1000,12000,1000,14000,2000,1001,12.0,0.0
76046,625362,0,8000,0,9000,1000,1001,8.0,0.0
76047,1020393,1000,17652,1000,19652,2000,1001,17.652,0.0
76048,1538023,0,13000,0,14000,1000,1001,13.0,0.0
76049,8795,0,63,0,84,21,22,3.0,0.0
76050,393239,0,4000,0,5000,1000,1001,4.0,0.0
76051,908111,0,16660,0,17640,980,981,17.0,0.0
76052,32133,0,300,0,375,75,76,4.0,0.0
76053,6269,0,48,0,60,12,13,4.0,0.0
76054,809141,0,10139,0,10749,610,611,16.621,0.0
76055,255595,1000,1000,1000,3000,2000,1001,1.0,0.0
76056,366064,0,7140,0,7560,420,421,17.0,0.0
76057,492613,0,6000,0,7000,1000,1001,6.0,0.0
76058,977911,0,12000,0,13000,1000,1001,12.0,0.0
76059,1287028,0,9942,0,10402,460,461,21.613,0.0
7606,41222,0,339,0,452,113,114,3.0,0.0
76060,571002,0,6000,0,7000,1000,1001,6.0,0.0
76061,242398,585,2925,585,4095,1170,586,5.0,0.0
76062,1761851,0,13000,0,14000,1000,1001,13.0,0.0
76063,852595,1000,10747,1000,12747,2000,1001,10.747,0.0
76064,5145008,2919,57016,2919,63829,6813,3896,14.642,0.0
76065,383736,318,4768,318,5404,636,319,14.994,0.0
76068,32417,31,403,31,465,62,32,13.0,0.0
76069,4244,0,32,0,40,8,9,4.0,0.0
76074,641664,0,9000,0,10000,1000,1001,9.0,0.0
76077,335093,0,3068,0,3835,767,768,4.0,0.0
76078,1543378,0,24000,0,25000,1000,1001,24.0,0.0
7608,118442,0,1333,0,1558,225,226,5.924,0.0
76080,1380762,1000,19800,1000,21800,2000,1001,19.8,0.0
76081,804437,0,14047,0,14341,294,295,47.779,0.5
76083,143897,0,1625,0,1950,325,326,5.0,0.0
76084,2133809,0,26551,0,27499,948,949,56.015,0.5
76085,57052,48,705,48,801,96,49,14.688,0.0
76086,927060,0,14996,0,15996,1000,1001,14.996,0.0
76087,799046,0,15778,0,16778,1000,1001,15.778,0.0
7609,183786,0,1632,0,2132,500,501,3.264,0.0
76091,137018,0,1890,0,2205,315,316,6.0,0.0
76092,112789,140,1975,140,2255,280,141,14.107,0.5
76095,28152,29,348,29,406,58,30,12.0,0.0
76097,730723,1000,13999,1000,15999,2000,1001,13.999,0.0
76098,454844,0,8330,0,8820,490,491,17.0,0.0
761,275880,500,4545,500,5545,1000,501,9.09,0.0
7610,256838,0,3000,0,3500,500,501,6.0,0.0
76100,62669,0,590,0,627,37,38,15.946,0.0
76101,883279,0,18000,0,19000,1000,1001,18.0,0.0
76102,163811,0,2270,0,2472,202,203,11.238,0.0
76103,37675,0,468,0,494,26,27,18.0,0.0
76108,12685,0,100,0,125,25,26,4.0,0.5
7611,6641,0,78,0,90,12,13,6.5,0.0
76119,704463,1000,10000,1000,12000,2000,1001,10.0,0.0
7612,23954,39,156,39,273,117,79,4.0,0.0
76122,478541,0,6000,0,7000,1000,1001,6.0,0.0
76123,47740,0,975,0,1000,25,26,39.0,0.0
76125,960030,0,20000,0,21000,1000,1001,20.0,0.0
76126,455157,0,8330,0,8820,490,491,17.0,0.0
76127,645629,0,10001,0,11001,1000,1001,10.001,0.0
76128,13352460,0,135982,0,136982,1000,1001,135.982,0.0
7613,724433,0,9785,0,10285,500,501,19.57,0.0
76130,22942,0,210,0,240,30,31,7.0,0.0
76131,1060329,650,7780,650,9080,1300,651,11.969,0.0
76132,411220,0,6000,0,7000,1000,1001,6.0,0.0
76134,62939,33,792,33,858,66,34,24.0,0.0
76135,3971957,0,114194,0,115194,1000,1001,114.194,0.0
76136,70153,0,1344,0,1428,84,85,16.0,0.0
76137,21181,0,280,0,290,10,11,28.0,0.0
76138,79007,0,1085,0,1240,155,156,7.0,0.0
76139,1749139,1000,24522,1000,26522,2000,1001,24.522,0.5
7614,1889,0,30,0,32,2,3,15.0,0.0
76140,54941,0,508,0,594,86,87,5.907,0.0
76142,441077,0,6000,0,7000,1000,1001,6.0,0.0
76143,72597,0,918,0,969,51,52,18.0,0.0
76144,698478,0,10000,0,11000,1000,1001,10.0,0.0
76146,26678,30,270,30,330,60,31,9.0,0.0
76148,422722,0,4000,0,5000,1000,1001,4.0,0.0
76149,568901,0,6000,0,7000,1000,1001,6.0,0.0
7615,275329,1,5504,1,6006,502,503,10.986,0.0
76151,12430452,0,346610,0,347610,1000,1001,346.61,0.5
76154,1198268,0,6000,0,7000,1000,1001,6.0,0.0
76155,453303,0,4000,0,5000,1000,1001,4.0,0.0
76156,744225,0,10996,0,11996,1000,1001,10.996,0.5
76159,529805,0,8125,0,9125,1000,1001,8.125,0.0
76161,1782141,1000,25524,1000,27524,2000,1001,25.524,0.5
76163,47754,0,570,0,627,57,58,10.0,0.0
76164,419898,0,4000,0,5000,1000,1001,4.0,0.0
76166,46437,0,237,0,285,48,49,4.938,0.0
76168,1124097,1000,13996,1000,15996,2000,1001,13.996,0.0
76169,237766,285,2863,285,3433,570,286,10.046,0.0
7617,433582,375,5219,375,6344,1125,752,6.959,0.75
76177,954073,0,14000,0,15000,1000,1001,14.0,0.0
76178,6715,24,24,24,72,48,25,1.0,0.0
762,143512,289,1803,289,2381,578,291,6.239,0.0
7620,416527,0,6000,0,6500,500,501,12.0,0.0
76200,586568,445,9790,445,10680,890,446,22.0,0.0
76216,10966711,1000,10000,1000,12000,2000,1001,10.0,0.0
7622,35961,77,385,77,539,154,78,5.0,0.0
76222,37812,47,638,47,732,94,48,13.574,0.0
76226,900493,0,18000,0,19000,1000,1001,18.0,0.0
76228,36766,0,255,0,306,51,52,5.0,0.5
76229,146943,148,2960,148,3256,296,149,20.0,0.0
7623,98728,212,1060,212,1484,424,213,5.0,0.5
76234,3110862,0,66000,0,67000,1000,1001,66.0,0.0
76235,1590498,0,12000,0,13000,1000,1001,12.0,0.0
76238,6037,0,72,0,80,8,9,9.0,0.0
76239,161674,0,1715,0,1960,245,246,7.0,0.5
7624,34423,0,86,0,258,172,173,1.0,0.0
76241,1114400,0,20951,0,21951,1000,1001,20.951,0.0
76242,1178321,0,15000,0,16000,1000,1001,15.0,0.0
76244,1564713,0,25000,0,26000,1000,1001,25.0,0.0
76246,1771608,0,29000,0,30000,1000,1001,29.0,0.0
76248,346735,0,4464,0,4712,248,249,18.0,0.0
76250,778335,0,11000,0,12000,1000,1001,11.0,0.0
76255,296606,0,5950,0,6300,350,351,17.0,0.0
76256,1302654,1000,7566,1000,10566,3000,1926,7.566,0.625
76257,762797,0,12378,0,13378,1000,1001,12.378,0.0
7626,264680,0,3252,0,3752,500,501,6.504,0.0
76261,446584,0,5817,0,6648,831,832,7.0,0.0
76264,875634,0,18000,0,19000,1000,1001,18.0,0.0
76266,178016,0,2065,0,2360,295,296,7.0,0.0
76270,3070463,0,42513,0,43513,1000,1001,42.513,0.0
76271,858029,0,10000,0,11000,1000,1001,10.0,0.0
76279,847138,1000,13000,1000,15000,2000,1001,13.0,0.5
7628,10792,0,170,0,186,16,17,10.625,0.0
76282,257183,266,3190,266,3722,532,267,11.992,0.625
76283,420799,0,4000,0,5000,1000,1001,4.0,0.0
76286,63041,0,946,0,989,43,44,22.0,0.0
76288,914365,0,20000,0,21000,1000,1001,20.0,0.0
7629,2427,0,16,0,20,4,5,4.0,0.0
76298,440021,0,4970,0,5970,1000,1001,4.97,0.0
76299,7346,0,90,0,100,10,11,9.0,0.0
7630,616467,0,7918,0,8418,500,501,15.836,0.0
76302,145157,0,1984,0,2108,124,125,16.0,0.0
76303,834933,0,17000,0,18000,1000,1001,17.0,0.0
76304,8756,0,78,0,91,13,14,6.0,0.0
76305,10245966,75,599,75,749,150,76,7.987,0.0
76308,3596427,0,18312,0,19312,1000,1001,18.312,0.0
76309,7480,27,27,27,81,54,28,1.0,0.0
7631,37996,0,408,0,442,34,35,12.0,0.0
76310,876994,0,13000,0,14000,1000,1001,13.0,0.0
7632,54297,0,513,0,570,57,58,9.0,0.0
76320,9981524,45,359,45,449,90,46,7.978,0.0
76321,832595,1000,13000,1000,15000,2000,1001,13.0,0.0
76328,3168953,0,72000,0,73000,1000,1001,72.0,0.0
76329,795350,1000,11000,1000,13000,2000,1001,11.0,0.0
7633,62877,0,602,0,754,152,153,3.961,0.5
76330,148827,0,2975,0,3150,175,176,17.0,0.0
76331,1572645,0,25000,0,26000,1000,1001,25.0,0.0
76332,19797,0,156,0,182,26,27,6.0,0.0
76333,8348,20,80,20,120,40,21,4.0,0.0
76334,19720,75,75,75,225,150,76,1.0,0.0
76336,805801,1000,12000,1000,14000,2000,1001,12.0,0.5
76338,820872,1000,12999,1000,14999,2000,1001,12.999,0.5
76339,738589,0,13214,0,13758,544,545,24.29,0.0
7634,476550,0,7941,0,8441,500,501,15.882,0.0
76340,3783,0,40,0,45,5,6,8.0,0.0
76341,2150023,0,19000,0,20000,1000,1001,19.0,0.0
76342,1989,0,18,0,20,2,3,9.0,0.0
76343,12466,0,62,0,73,11,12,5.636,0.0
76344,245694,0,2308,0,2885,577,578,4.0,0.0
76345,11528,0,144,0,160,16,17,9.0,0.0
76346,327561,0,5670,0,6237,567,568,10.0,0.0
76347,149926,0,1446,0,1687,241,242,6.0,0.875
76348,817606,1000,12161,1000,14161,2000,1001,12.161,0.0
76349,755310,1000,14695,1000,16695,2000,1001,14.695,0.0
7635,356865,0,4751,0,5251,500,501,9.502,0.5
76351,19231,0,234,0,247,13,14,18.0,0.5
76352,696168,0,11000,0,12000,1000,1001,11.0,0.0
76353,579915,0,6000,0,7000,1000,1001,6.0,0.0
76354,12251,45,45,45,135,90,46,1.0,0.0
7636,6360,0,97,0,109,12,13,8.083,0.0
76369,700359,0,10000,0,11000,1000,1001,10.0,0.0
7637,655825,0,9500,0,10000,500,501,19.0,0.0
76372,26298,0,270,0,324,54,55,5.0,0.0
76376,55908,0,540,0,675,135,136,4.0,0.0
76377,916031,0,20000,0,21000,1000,1001,20.0,0.0
76379,932830,0,8000,0,9000,1000,1001,8.0,0.0
7638,362844,0,4500,0,5000,500,501,9.0,0.0
76380,693964,0,10000,0,11000,1000,1001,10.0,0.0
76382,8770,0,55,0,66,11,12,5.0,0.0
76383,3589650,0,45967,0,46967,1000,1001,45.967,0.0
76385,758042,0,13000,0,14000,1000,1001,13.0,0.5
76387,559942,0,8919,0,9378,459,460,19.431,0.0
76388,457652,0,9280,0,9472,192,193,48.333,0.0
7639,3195,0,20,0,25,5,6,4.0,0.0
76396,391778,0,5070,0,5265,195,196,26.0,0.0
7640,43412,0,357,0,476,119,120,3.0,0.0
76405,82705,0,1008,0,1120,112,113,9.0,0.0
76406,806465,0,12000,0,13000,1000,1001,12.0,0.0
76407,56936,0,1120,0,1190,70,71,16.0,0.0
76408,176072,0,2791,0,2991,200,201,13.955,0.0
76411,15130,57,57,57,171,114,58,1.0,0.0
76413,3432703,0,42999,0,43999,1000,1001,42.999,0.0
76414,29141,0,560,0,595,35,36,16.0,0.0
76415,872296,0,18000,0,19000,1000,1001,18.0,0.0
76416,576858,0,12465,0,12657,192,193,64.922,0.0
76417,113043,0,2240,0,2380,140,141,16.0,0.0
76419,653071,0,9000,0,10000,1000,1001,9.0,0.5
76420,99170,0,1541,0,1649,108,109,14.269,0.0
76421,765447,672,8501,672,9845,1344,673,12.65,0.0
76422,3716949,0,77000,0,78000,1000,1001,77.0,0.0
76423,1567900,0,25000,0,26000,1000,1001,25.0,0.0
76424,5339,5,85,5,95,10,6,17.0,0.0
76425,3986,0,44,0,48,4,5,11.0,0.0
76426,873241,0,18000,0,19000,1000,1001,18.0,0.0
76428,756795,0,18222,0,19222,1000,1001,18.222,0.0
7643,33514,0,234,0,328,94,95,2.489,0.0
76430,2967831,7,56,7,70,14,8,8.0,0.0
76432,294720,0,5950,0,6300,350,351,17.0,0.0
76433,853462,0,16181,0,17181,1000,1001,16.181,0.0
76434,58558,150,750,150,1050,300,151,5.0,0.0
76435,178296,59,2388,59,2506,118,60,40.475,0.0
76436,104187,105,1336,105,1546,210,106,12.724,0.0
76439,777834,0,11000,0,12000,1000,1001,11.0,0.0
7644,274179,0,6541,0,6983,442,443,14.799,0.0
76442,1074794,0,16960,0,17960,1000,1001,16.96,0.0
76444,557711,0,12480,0,12672,192,193,65.0,0.0
76445,92876,0,1170,0,1235,65,66,18.0,0.0
76447,463752,566,9056,566,10188,1132,567,16.0,0.0
76448,624337,896,6387,896,8179,1792,897,7.128,0.0
76449,2711539,0,62656,0,63656,1000,1001,62.656,0.0
7645,68968,0,605,0,757,152,153,3.98,0.5
76450,771783,0,11000,0,12000,1000,1001,11.0,0.0
76451,1572430,0,13000,0,14000,1000,1001,13.0,0.0
76453,872160,0,18000,0,19000,1000,1001,18.0,0.0
76454,836963,0,17000,0,18000,1000,1001,17.0,0.0
76455,241014,364,4004,364,4732,728,365,11.0,0.0
76456,824037,0,17000,0,18000,1000,1001,17.0,0.0
76458,937649,1000,20000,1000,22000,2000,1001,20.0,0.0
76459,57605,0,1120,0,1190,70,71,16.0,0.0
7646,126797,0,1668,0,1807,139,140,12.0,0.0
76460,3238,0,36,0,40,4,5,9.0,0.5
76461,2588366,59,898,59,1016,118,60,15.22,0.0
76462,414262,0,8464,0,8993,529,530,16.0,0.0
76463,4300,4,48,4,56,8,5,12.0,0.5
76464,296529,0,5950,0,6300,350,351,17.0,0.0
76465,961808,0,14000,0,15000,1000,1001,14.0,0.0
76466,991198,1000,20000,1000,22000,2000,1001,20.0,0.0
76468,1512180,0,23114,0,23891,777,778,29.748,0.0
76469,3598390,0,46000,0,47000,1000,1001,46.0,0.0
7647,3531,0,23,0,29,6,7,3.833,0.0
76470,13120,0,198,0,202,4,5,49.5,1.0
76471,848934,0,8000,0,9000,1000,1001,8.0,0.0
76472,148872,0,1464,0,1708,244,245,6.0,0.8333333333333334
76473,238656,290,2927,290,3507,580,291,10.093,0.0
76474,2847003,0,57000,0,58000,1000,1001,57.0,0.0
76475,1397158,0,24013,0,25013,1000,1001,24.013,0.0
76476,1766975,0,31000,0,32000,1000,1001,31.0,0.0
76477,568895,0,6000,0,7000,1000,1001,6.0,0.0
76479,1132832,696,18664,696,20056,1392,697,26.816,0.0
7648,6442,0,96,0,108,12,13,8.0,0.0
76480,6868,10,80,10,100,20,11,8.0,1.0
76481,87487,0,1200,0,1320,120,121,10.0,0.0
76482,23109,27,270,27,324,54,28,10.0,0.0
76483,910943,0,18000,0,19000,1000,1001,18.0,0.0
76485,882768,0,18000,0,19000,1000,1001,18.0,0.0
76486,751255,0,18090,0,18693,603,604,30.0,0.0
76487,232432,208,2912,208,3328,416,209,14.0,0.0
76488,308610,0,6288,0,6681,393,394,16.0,0.0
76489,22461,39,195,39,273,78,40,5.0,0.0
7649,6288,0,70,0,77,7,8,10.0,0.0
76490,4729,0,55,0,60,5,6,11.0,0.0
76491,202179,0,4080,0,4128,48,49,85.0,0.0
76492,253595,0,1000,0,2000,1000,1001,1.0,0.0
76494,502878,0,10178,0,10370,192,193,53.01,0.0
76496,829519,0,17000,0,18000,1000,1001,17.0,0.0
76498,1475710,494,20025,494,21013,988,495,40.536,1.0
76499,1222683,0,24024,0,25024,1000,1001,24.024,0.0
76502,196313,0,2804,0,3024,220,221,12.745,0.0
76503,36453,43,731,43,817,86,44,17.0,0.0
76504,49522,0,414,0,552,138,139,3.0,1.0
76505,219351,277,2006,277,2560,554,278,7.242,0.0
76507,12630694,232,2088,232,2552,464,233,9.0,0.0
76511,921495,0,18000,0,19000,1000,1001,18.0,0.0
76512,467917,0,9648,0,10251,603,604,16.0,0.0
76513,36851,19,564,19,602,38,20,29.684,0.0
76514,294607,0,5950,0,6300,350,351,17.0,0.0
76516,438773,0,5951,0,6626,675,676,8.816,0.0
76521,828003,0,17000,0,18000,1000,1001,17.0,0.0
76522,878494,0,13000,0,14000,1000,1001,13.0,0.0
76523,1579631,489,21192,489,22170,978,490,43.337,1.0
76524,876478,0,13000,0,14000,1000,1001,13.0,0.0
76525,12454,30,120,30,180,60,31,4.0,0.0
76526,490186,0,8006,0,8822,816,817,9.811,0.0
76527,878497,0,10778,0,11778,1000,1001,10.778,0.0
76528,585944,0,11900,0,12600,700,701,17.0,0.0
76529,296773,0,4212,0,4680,468,469,9.0,0.0
76530,350004,0,6037,0,6641,604,605,9.995,0.0
76531,85788,0,1099,0,1256,157,158,7.0,0.0
76532,57474,0,1120,0,1190,70,71,16.0,0.0
76533,743348,0,10000,0,11000,1000,1001,10.0,0.0
76534,10943,0,87,0,116,29,30,3.0,0.0
76538,707849,0,10395,0,11395,1000,1001,10.395,0.0
76539,493501,0,11790,0,12183,393,394,30.0,0.0
7654,241130,0,3000,0,3500,500,501,6.0,0.0
76540,308331,0,5290,0,5819,529,530,10.0,0.0
76541,821189,1000,10000,1000,12000,2000,1001,10.0,0.0
76542,65750,34,816,34,884,68,35,24.0,0.0
76543,1981415,0,45604,0,46604,1000,1001,45.604,0.0
76544,56911,0,1120,0,1190,70,71,16.0,0.0
76547,3008183,1000,42160,1000,44160,2000,1001,42.16,0.0
76549,656567,0,14812,0,15341,529,530,28.0,0.0
7655,10508,0,179,0,191,12,13,14.917,0.0
76552,683126,0,8996,0,9996,1000,1001,8.996,0.0
76554,907278,0,18000,0,19000,1000,1001,18.0,0.0
76555,644799,1000,8000,1000,10000,2000,1001,8.0,0.0
76557,292409,301,3607,301,4209,602,302,11.983,0.5
76558,585889,0,11900,0,12600,700,701,17.0,0.0
76559,67438,55,1064,55,1174,110,56,19.345,0.0
7656,436319,0,6508,0,7008,500,501,13.016,0.0
76560,61479,101,808,101,1010,202,102,8.0,0.0
76561,352780,0,7140,0,7560,420,421,17.0,0.0
76563,68394,0,1344,0,1428,84,85,16.0,0.0
76564,348179,0,6030,0,6633,603,604,10.0,0.0
76565,93522,32,713,32,777,64,33,22.281,0.0
76569,599522,0,8000,0,9000,1000,1001,8.0,0.0
7657,10162,19,76,19,133,57,39,4.0,0.0
76570,102197,0,1185,0,1430,245,246,4.837,0.0
76571,630748,1000,8319,1000,10319,2000,1001,8.319,0.0
76573,19867,24,312,24,360,48,25,13.0,0.0
76576,17671,0,336,0,357,21,22,16.0,0.0
7658,31506,73,292,73,438,146,74,4.0,0.0
76587,830667,0,17000,0,18000,1000,1001,17.0,0.0
7659,61349,131,655,131,917,262,132,5.0,0.0
76590,253595,0,1000,0,2000,1000,1001,1.0,0.0
76591,180388,0,2184,0,2548,364,365,6.0,0.0
76592,66107,106,1134,106,1346,212,107,10.698,0.0
76594,36207,36,504,36,576,72,37,14.0,0.0
76596,20021,75,75,75,225,150,76,1.0,0.0
76597,542280,1000,7266,1000,9266,2000,1001,7.266,0.0
76598,531041,0,5997,0,6997,1000,1001,5.997,0.0
76599,497298,1000,8000,1000,10000,2000,1001,8.0,0.0
766,1218058,500,31500,500,32500,1000,501,63.0,0.0
7660,12971,0,74,0,107,33,34,2.242,0.0
76600,255595,1000,1000,1000,3000,2000,1001,1.0,0.0
76601,8755,32,32,32,96,64,33,1.0,0.0
76602,826261,0,17000,0,18000,1000,1001,17.0,0.0
76603,10295,0,110,0,126,16,17,6.875,0.0
76604,1101,0,2,0,4,2,3,1.0,0.0
76605,3802132,0,78000,0,79000,1000,1001,78.0,0.0
76606,184800,0,2125,0,2550,425,426,5.0,0.0
76607,870326,0,11000,0,12000,1000,1001,11.0,0.0
76608,204246,496,1984,496,2976,992,497,4.0,0.0
76609,261432,0,3600,0,3960,360,361,10.0,0.0
7661,499559,500,8386,500,9886,1500,1002,8.386,0.0
76610,653141,0,8000,0,9000,1000,1001,8.0,0.0
76617,391012,0,5300,0,5830,530,531,10.0,0.0
76618,52831,23,725,23,771,46,24,31.522,0.0
76619,111172,210,1470,210,1890,420,211,7.0,0.0
7662,14701,40,120,40,200,80,41,3.0,0.0
76621,594330,0,8000,0,9000,1000,1001,8.0,0.0
76622,88234,0,1134,0,1296,162,163,7.0,0.0
76623,115881,0,1932,0,1955,23,24,84.0,0.0
76626,4759,0,55,0,60,5,6,11.0,0.0
7663,25539,0,310,0,341,31,32,10.0,0.875
76630,80910,121,1321,121,1563,242,122,10.917,0.0
76631,540666,0,7350,0,8085,735,736,10.0,0.0
76633,3718949,1000,77000,1000,79000,2000,1001,77.0,0.0
76634,1003761,0,17985,0,18985,1000,1001,17.985,0.0
76637,21577,0,264,0,297,33,34,8.0,0.0
7664,358899,0,5500,0,6000,500,501,11.0,0.0
76641,128321,0,1589,0,1816,227,228,7.0,0.0
76644,999604,0,15430,0,16430,1000,1001,15.43,0.0
76645,562596,1000,9000,1000,11000,2000,1001,9.0,0.0
76646,601237,0,7000,0,8000,1000,1001,7.0,0.0
76647,56938,0,1120,0,1190,70,71,16.0,0.0
76648,613322,0,8000,0,9000,1000,1001,8.0,0.0
76649,11521,18,126,18,162,36,19,7.0,0.0
76650,435328,549,6039,549,7137,1098,550,11.0,0.0
76651,74270,0,796,0,913,117,118,6.803,0.0
76652,160071,59,2148,59,2266,118,60,36.407,0.0
76659,738904,0,10000,0,11000,1000,1001,10.0,0.0
7666,48172,0,585,0,702,117,118,5.0,0.0
76660,163182,200,2249,200,2649,400,201,11.245,0.0
76663,704520,1000,10000,1000,12000,2000,1001,10.0,0.0
76665,308182,0,5290,0,5819,529,530,10.0,0.0
76666,36976,52,467,52,571,104,53,8.981,0.0
76669,3245186,0,36995,0,38319,1324,1325,83.699,0.5
7667,8483,0,79,0,99,20,21,3.95,0.0
76671,31342,0,495,0,519,24,25,20.625,0.0
76674,683505,0,9000,0,10000,1000,1001,9.0,0.0
76676,358057,0,4491,0,4990,499,500,9.0,0.0
76679,22301,0,210,0,242,32,33,6.562,0.0
7668,668167,0,9706,0,10206,500,501,19.412,0.0
76681,354012,0,4656,0,5238,582,583,8.0,0.0
76682,647096,0,9000,0,9900,900,901,10.0,0.0
76683,730066,0,10000,0,11000,1000,1001,10.0,0.0
76684,551159,1000,9000,1000,11000,2000,1001,9.0,0.0
76685,639654,0,9000,0,10000,1000,1001,9.0,0.0
76689,672967,1000,8000,1000,10000,2000,1001,8.0,0.0
76690,853173,1000,17000,1000,19000,2000,1001,17.0,0.0
76693,1093570,0,19978,0,20978,1000,1001,19.978,0.0
76694,630115,0,9000,0,10000,1000,1001,9.0,0.0
76696,53028,0,583,0,673,90,91,6.478,0.0
76699,999979,0,15390,0,16390,1000,1001,15.39,0.0
7670,1403,0,8,0,10,2,3,4.0,0.0
76700,43935,108,432,108,648,216,109,4.0,0.0
76706,298664,0,4239,0,4710,471,472,9.0,0.0
76707,175531,0,2065,0,2360,295,296,7.0,0.0
7671,482036,500,6676,500,8654,1978,1250,6.676,0.0
76710,189507,0,2415,0,2760,345,346,7.0,0.0
76712,2329501,1000,36018,1000,38018,2000,1001,36.018,0.0
76713,602817,0,7088,0,7974,886,887,8.0,0.0
76714,2731657,0,38096,0,39096,1000,1001,38.096,0.0
76716,7881,6,132,6,144,12,7,22.0,0.0
76717,32433,0,408,0,459,51,52,8.0,0.0
76718,8968,0,110,0,120,10,11,11.0,0.0
76719,435023,562,5620,562,6744,1124,563,10.0,0.0
76720,197584,0,5917,0,5973,56,57,105.661,0.0
76722,753032,1000,10000,1000,12000,2000,1001,10.0,0.0
76723,5505,0,64,0,72,8,9,8.0,0.0
76725,7695,0,77,0,92,15,16,5.133,0.0
76727,51401,0,736,0,828,92,93,8.0,0.0
76729,753006,1000,10000,1000,12000,2000,1001,10.0,0.0
7673,11736,0,112,0,140,28,29,4.0,0.0
76731,422509,0,5500,0,6050,550,551,10.0,0.0
76733,671893,1000,10003,1000,12003,2000,1001,10.003,0.0
76737,935893,0,17000,0,18000,1000,1001,17.0,0.0
7674,158205,0,5124,0,5137,13,14,394.154,0.0
76741,643701,0,9000,0,10000,1000,1001,9.0,0.0
76742,84759,40,1177,40,1257,80,41,29.425,1.0
76744,600424,0,8000,0,9000,1000,1001,8.0,0.0
76745,863029,1000,11000,1000,13000,2000,1001,11.0,0.0
76746,29874,0,474,0,497,23,24,20.609,0.0
76747,695122,0,9000,0,10000,1000,1001,9.0,0.0
76748,139471,163,1630,163,1956,326,164,10.0,0.0
76749,854640,1000,17000,1000,19000,2000,1001,17.0,0.0
7675,14572,29,58,29,145,87,59,2.0,0.5
76750,512533,0,6722,0,7722,1000,1001,6.722,0.0
76751,792908,1000,11000,1000,13000,2000,1001,11.0,0.0
76752,180758,77,2456,77,2610,154,78,31.896,1.0
76753,157149,0,2160,0,2216,56,57,38.571,0.0
76755,56695,220,220,220,660,440,221,1.0,0.0
76756,612906,1000,7000,1000,9000,2000,1001,7.0,0.0
76757,22453,0,264,0,297,33,34,8.0,0.0
76758,302006,0,3815,0,4360,545,546,7.0,0.0
76760,13787,33,99,33,165,66,34,3.0,0.0
76763,1090017,0,19926,0,20926,1000,1001,19.926,0.0
76771,602403,0,8000,0,9000,1000,1001,8.0,0.0
76772,306582,0,3766,0,4304,538,539,7.0,0.0
76773,88341,0,1062,0,1180,118,119,9.0,0.0
76774,678778,0,9000,0,10000,1000,1001,9.0,0.0
76775,371028,0,4451,0,5451,1000,1001,4.451,0.0
76777,699405,1000,9000,1000,11000,2000,1001,9.0,0.0
76778,594704,0,13440,0,13632,192,193,70.0,0.0
76779,52598,23,723,23,769,46,24,31.435,0.0
7678,299965,0,3000,0,3500,500,501,6.0,0.0
76780,23642,34,305,34,373,68,35,8.971,0.0
76781,300465,0,3682,0,4188,506,331,14.553,0.5
76785,1001821,0,15370,0,16370,1000,1001,15.37,0.0
76786,499938,0,6900,0,7590,690,691,10.0,0.0
76787,755068,0,11000,0,12000,1000,1001,11.0,0.0
76788,33832,0,408,0,459,51,52,8.0,0.0
76789,693023,0,9000,0,10000,1000,1001,9.0,0.0
7679,206533,0,2500,0,3000,500,501,5.0,0.0
76790,849212,0,15271,0,16271,1000,1001,15.271,0.0
76792,139286,58,1912,58,2028,116,59,32.966,0.0
76794,255595,1000,1000,1000,3000,2000,1001,1.0,0.0
76795,707036,0,11000,0,12000,1000,1001,11.0,0.0
76797,309435,0,3801,0,4344,543,544,7.0,0.0
768,2640,3,18,3,27,9,7,6.0,0.0
7680,671526,0,11518,0,12018,500,501,23.036,0.0
76806,602273,0,8000,0,9000,1000,1001,8.0,0.0
7681,267283,0,3196,0,3696,500,501,6.392,0.5
76816,43758,0,600,0,660,60,61,10.0,0.5
76817,155803,251,1506,251,2008,502,252,6.0,1.0
76818,1088016,0,19926,0,20926,1000,1001,19.926,0.0
76819,678862,0,9000,0,10000,1000,1001,9.0,0.0
7682,693037,0,9296,0,9796,500,501,18.592,0.0
76824,970899,1000,18000,1000,20000,2000,1001,18.0,0.0
76826,788210,0,11000,0,12000,1000,1001,11.0,0.0
76827,447844,0,6215,0,6780,565,566,11.0,0.0
76828,684273,0,9000,0,10000,1000,1001,9.0,0.0
7683,13794,0,40,0,75,35,36,4.0,0.0
76830,464300,567,9072,567,10206,1134,568,16.0,0.0
7684,53909,0,570,0,627,57,58,10.0,0.0
76841,666966,0,8000,0,9000,1000,1001,8.0,0.0
76842,113284,0,1794,0,1932,138,139,13.0,0.0
76844,2146225,1000,34000,1000,36000,2000,1001,34.0,0.0
76847,608870,1000,7000,1000,9000,2000,1001,7.0,0.5
76849,106879,0,1323,0,1470,147,148,9.0,0.0
7685,7137,0,96,0,108,12,13,8.0,0.0
76851,159619,60,2143,60,2263,120,61,35.717,0.0
76852,2008,2,8,2,14,6,5,4.0,0.5
76854,35560,52,467,52,571,104,53,8.981,0.0
76855,298381,469,4221,469,5159,938,470,9.0,0.0
76856,1470089,1000,19000,1000,21000,2000,1001,19.0,0.0
76857,796655,0,11000,0,12000,1000,1001,11.0,0.0
76858,874301,0,14588,0,15588,1000,1001,14.588,0.0
76860,692358,1000,10000,1000,12000,2000,1001,10.0,0.0
76861,685971,1000,9000,1000,11000,2000,1001,9.0,0.0
76862,768332,0,11000,0,12000,1000,1001,11.0,0.0
76864,359523,0,4712,0,5301,589,590,8.0,0.0
76867,648255,0,9000,0,9900,900,901,10.0,0.0
7687,206221,0,2500,0,3000,500,501,5.0,0.0
76875,20226,0,203,0,246,43,44,4.721,0.0
76878,436347,0,5690,0,6259,569,570,10.0,0.0
7688,175823,0,3370,0,3707,337,338,10.0,0.0
76880,604194,0,8000,0,9000,1000,1001,8.0,0.0
76881,583974,2,10,2,14,4,3,5.0,0.0
76882,1042435,0,18688,0,19688,1000,1001,18.688,0.0
76883,110383,0,1066,0,1236,170,171,6.271,0.0
76890,53882,0,520,0,608,88,89,5.909,0.0
76893,63208,0,828,0,966,138,139,6.0,0.0
76901,1978817,1000,45535,1000,47535,2000,1001,45.535,0.0
76905,649468,1000,9000,1000,11000,2000,1001,9.0,0.0
7691,49930,0,722,0,734,12,13,60.167,0.0
76912,187410,0,295,0,354,59,60,5.0,0.0
76915,286189,0,110,0,120,10,11,11.0,0.0
76916,31506,78,390,78,546,156,79,5.0,0.0
76918,84224,0,918,0,1071,153,154,6.0,0.0
76919,20890,0,320,0,360,40,41,8.0,0.0
76921,400258,0,92,0,115,23,24,4.0,0.0
76923,860362,1000,7007,1000,9007,2000,1001,7.007,1.0
76924,15640,59,59,59,177,118,60,1.0,0.0
76925,35224,35,490,35,560,70,36,14.0,0.0
76927,593874,1000,10000,1000,12000,2000,1001,10.0,0.0
76928,1279320,0,24869,0,25869,1000,1001,24.869,0.0
76929,41172,0,450,0,525,75,76,6.0,0.5
7693,58140,0,1182,0,1233,51,52,23.176,0.0
76931,51739,0,285,0,570,285,286,3.0,0.0
76939,78273,53,1006,53,1112,106,54,18.981,0.0
7694,489263,500,7000,500,8000,1000,501,14.0,0.0
76944,248827,0,89,0,102,13,14,6.846,0.0
76946,15605993,1000,224000,1000,226000,2000,1001,224.0,0.0
76947,692358,1000,10000,1000,12000,2000,1001,10.0,0.0
76948,1479824,1000,19000,1000,21000,2000,1001,19.0,0.0
76949,382839,1000,5000,1000,7000,2000,1001,5.0,0.0
76953,365638,0,72,0,81,9,10,8.0,0.0
76957,574465,0,9764,0,10519,755,756,12.932,0.0
7696,24678,67,201,67,335,134,68,3.0,0.0
76961,60499,0,64,0,80,16,17,4.0,0.0
76963,42459,77,457,77,611,154,78,5.935,0.0
76964,429931,542,5962,542,7046,1084,543,11.0,0.0
76965,409115,192,9280,192,9664,384,193,48.333,0.0
76966,3596182,1000,74000,1000,76000,2000,1001,74.0,0.0
76967,10123,0,6,0,7,1,2,6.0,0.0
76969,1134402,1000,17912,1000,19912,2000,1001,17.912,0.0
7697,114072,244,1220,244,1708,488,245,5.0,0.5
76970,972455,1000,19000,1000,21000,2000,1001,19.0,0.0
76971,802159,1000,10000,1000,12000,2000,1001,10.0,0.0
76972,687026,1000,8000,1000,10000,2000,1001,8.0,0.0
76973,685130,1000,8000,1000,10000,2000,1001,8.0,0.0
76974,1923234,1000,44223,1000,46223,2000,1001,44.223,0.5
76975,354809,310,8370,310,8990,620,311,27.0,0.0
76976,916365,1000,20000,1000,22000,2000,1001,20.0,0.0
76977,265008,625,2498,625,3748,1250,626,3.997,0.0
76978,1744060,1000,23000,1000,25000,2000,1001,23.0,0.0
76979,700331,1000,10000,1000,12000,2000,1001,10.0,0.0
7698,484780,0,6500,0,7000,500,501,13.0,0.0
76982,630123,1000,9000,1000,11000,2000,1001,9.0,0.0
76983,270262,278,3331,278,3887,556,279,11.982,0.75
76984,682838,1000,8000,1000,10000,2000,1001,8.0,0.0
76985,438548,373,10444,373,11190,746,374,28.0,0.0
76986,41083,49,784,49,882,98,50,16.0,0.0
76987,658840,1000,8000,1000,10000,2000,1001,8.0,0.0
76988,2150801,1000,49935,1000,51935,2000,1001,49.935,0.0
76989,18850,36,216,36,288,72,37,6.0,0.0
76992,652106,553,15484,553,16590,1106,554,28.0,0.0
76995,445343,192,10240,192,10624,384,193,53.333,0.0
76997,124805,228,1368,228,1824,456,229,6.0,0.0
76998,692358,1000,10000,1000,12000,2000,1001,10.0,0.0
77,1571539,4943,12849,4943,24734,11885,5332,3.25,0.5
770,277883,500,2000,500,3500,1500,999,4.0,0.0
7700,349825,0,5228,0,5728,500,501,10.456,0.0
77001,1258189,1000,17998,1000,19998,2000,1001,17.998,0.0
77006,16128,29,145,29,203,58,30,5.0,0.0
77007,1441,2,8,2,12,4,3,4.0,0.0
7701,2276,6,18,6,30,12,8,3.0,0.5
77024,17082,35,175,35,245,70,36,5.0,0.0
77029,5708,12,48,12,72,24,13,4.0,0.0
7703,29645,0,370,0,424,54,55,6.852,0.5
77030,16131,31,155,31,217,62,32,5.0,0.0
77031,12575,24,120,24,168,48,25,5.0,0.0
77032,14617,28,140,28,196,56,29,5.0,0.0
77033,20481,22,342,22,386,44,24,15.545,0.0
77034,2965,6,24,6,36,12,7,4.0,0.0
77035,73317,153,765,153,1071,306,154,5.0,0.0
77040,186210,323,2561,323,3207,646,325,7.929,0.5
77046,247584,1000,1000,1000,3000,2000,1001,1.0,0.0
7705,23067,43,172,43,258,86,44,4.0,0.0
7706,267499,0,6382,0,6809,427,428,14.946,0.0
7707,211722,329,1563,329,2550,987,659,4.751,0.0
7708,68577,0,680,0,765,85,86,8.0,0.0
77083,816881,0,16005,0,17005,1000,1001,16.005,0.0
77091,1599757,1000,24210,1000,26210,2000,1001,24.21,0.0
771,32339,0,192,0,320,128,129,3.0,0.5
7710,357097,0,4540,0,5040,500,501,9.08,0.0
7711,279298,0,3415,0,3915,500,501,6.83,0.0
7712,271686,0,3499,0,3999,500,501,6.998,0.0
77122,1359521,1000,20780,1000,22780,2000,1001,20.78,0.0
77123,928583,0,17009,0,18009,1000,1001,17.009,0.0
7713,238711,0,2928,0,3428,500,501,5.856,0.0
7714,230731,0,2451,0,2951,500,501,4.902,0.0
77144,1593832,1000,24369,1000,26369,2000,1001,24.369,0.0
7715,7448,0,51,0,77,26,27,3.923,0.0
7716,6271,0,77,0,84,7,8,11.0,0.0
7717,21254,44,132,44,264,132,89,3.0,0.0
77190,827832,0,15077,0,16077,1000,1001,15.077,0.0
7720,15541,0,141,0,179,38,39,3.711,0.0
77207,486184,0,7000,0,8000,1000,1001,7.0,0.0
7722,594974,0,8500,0,9000,500,501,17.0,0.0
77229,247584,1000,1000,1000,3000,2000,1001,1.0,0.0
7723,10759,0,170,0,186,16,17,10.625,0.0
77234,243583,1000,1000,1000,3000,2000,1001,1.0,0.0
77236,581969,0,7000,0,8000,1000,1001,7.0,0.5
77238,578422,1000,7538,1000,9538,2000,1001,7.538,0.0
7724,275113,0,5500,0,6000,500,501,11.0,0.0
77241,247584,1000,1000,1000,3000,2000,1001,1.0,0.0
77242,623079,1000,9725,1000,11725,2000,1001,9.725,0.5
7725,1684,0,20,0,22,2,3,10.0,0.0
77250,247584,1000,1000,1000,3000,2000,1001,1.0,0.0
77252,770610,1000,9656,1000,11656,2000,1001,9.656,0.0
7726,333250,500,4000,500,5000,1000,501,8.0,0.0
7727,36703,0,390,0,423,33,34,11.818,0.0
7728,53839,0,768,0,847,79,80,9.722,0.0
7729,207109,0,2500,0,3000,500,501,5.0,0.0
77291,240181,986,986,986,2958,1972,987,1.0,0.0
77292,599460,0,6093,0,8093,2000,1849,6.093,0.0
77295,20446,16,205,16,237,32,17,12.812,0.0
77297,650548,1000,7372,1000,9372,2000,1001,7.372,0.0
77298,381720,1000,5000,1000,7000,2000,1001,5.0,0.0
77299,479550,0,7000,0,8000,1000,1001,7.0,0.0
77302,776468,1000,15497,1000,17497,2000,1001,15.497,0.5
77304,69788,84,747,84,915,168,85,8.893,0.0
77305,1261925,0,21000,0,22000,1000,1001,21.0,0.0
77306,243583,1000,1000,1000,3000,2000,1001,1.0,0.0
77307,776515,1000,15497,1000,17497,2000,1001,15.497,0.5
77308,6220,0,70,0,76,6,7,11.667,0.0
7731,9635,0,172,0,187,15,16,11.467,0.0
77310,243583,1000,1000,1000,3000,2000,1001,1.0,0.0
77311,905300,0,11804,0,12804,1000,1001,11.804,0.0
77313,527042,0,5968,0,6968,1000,1001,5.968,0.0
77317,243583,1000,1000,1000,3000,2000,1001,1.0,0.0
77319,247584,1000,1000,1000,3000,2000,1001,1.0,0.0
7732,488501,0,7718,0,8218,500,501,15.436,0.0
77326,243583,1000,1000,1000,3000,2000,1001,1.0,0.0
77328,1792429,1000,35767,1000,38767,3000,2002,17.884,0.0
77330,11278,0,116,0,132,16,17,7.25,0.0
77331,1559260,0,26000,0,27000,1000,1001,26.0,0.0
77333,40192,163,163,163,489,326,164,1.0,0.0
77334,76065,101,1024,101,1226,202,102,10.139,0.0
77337,100699,412,412,412,1236,824,413,1.0,0.0
77339,22506,49,294,49,392,98,50,6.0,0.0
7734,6339,0,96,0,108,12,13,8.0,0.0
77347,5771,21,21,21,63,42,22,1.0,1.0
77348,243583,1000,1000,1000,3000,2000,1001,1.0,0.0
77350,489780,1000,7000,1000,9000,2000,1001,7.0,0.0
77356,585017,0,7000,0,8000,1000,1001,7.0,0.0
77369,58434,70,487,70,627,140,71,6.957,0.0
77370,751185,0,7483,0,9483,2000,1814,7.483,0.5
77373,507681,315,6380,315,7370,990,613,20.254,0.0
77384,592389,0,7000,0,8000,1000,1001,7.0,0.5
77387,69723,0,891,0,990,99,100,9.0,0.0
77388,617336,950,7788,950,10218,2430,1482,5.262,0.0
77389,570418,0,8118,0,8710,592,593,13.713,0.5
7739,266963,500,4000,500,5000,1000,501,8.0,0.0
77390,243583,1000,1000,1000,3000,2000,1001,1.0,0.0
774,39718,0,615,0,656,41,42,15.0,0.0
7740,12531,0,112,0,140,28,29,4.0,0.0
7742,356571,500,6090,500,7090,1000,501,12.18,0.0
77424,34419,101,303,101,505,202,102,3.0,0.5
7743,56685,139,533,139,811,278,140,3.835,0.0
77430,628402,0,8816,0,9816,1000,1001,8.816,0.0
77436,34419,101,303,101,505,202,102,3.0,0.0
77438,18488,0,172,0,194,22,23,7.818,0.0
77443,12675,0,96,0,128,32,33,3.0,0.0
77444,1949984,1000,24011,1000,27011,3000,2001,24.011,0.0
77449,823022,1000,12000,1000,14000,2000,1001,12.0,0.0
77450,1536334,1000,27705,1000,29705,2000,1001,27.705,0.5
77451,561232,0,7988,0,8988,1000,1001,7.988,0.8
7746,21844,63,189,63,315,126,65,3.0,0.0
77461,1524754,1000,13000,1000,15963,2963,1537,13.0,0.0
77462,3418,0,30,0,34,4,5,7.5,0.0
77463,9378,35,41,35,111,70,36,1.171,0.0
77465,7863,24,72,24,120,48,25,3.0,0.0
77469,676034,0,9000,0,10000,1000,1001,9.0,0.0
7747,348708,500,4500,500,5500,1000,502,9.0,0.0
77470,4555,12,36,12,60,24,13,3.0,0.0
77471,44791,0,375,0,500,125,126,3.0,0.0
77472,914381,1000,16225,1000,18225,2000,1001,16.225,0.0
77473,3207,0,36,0,40,4,5,9.0,0.0
77475,442018,1000,5000,1000,7000,2000,1001,5.0,0.0
77476,560107,0,7981,0,8981,1000,1001,7.981,0.8333333333333334
77477,2803,0,20,0,25,5,6,4.0,0.0
77478,9893,7,82,7,96,14,8,11.714,0.0
77479,524760,0,7000,0,8000,1000,1001,7.0,0.0
77480,33004,63,441,63,567,126,64,7.0,0.0
77481,544545,1000,7722,1000,9722,2000,1001,7.722,0.75
77482,17027,17,478,17,512,34,18,28.118,0.0
77485,20460,58,174,58,290,116,59,3.0,0.0
7749,238089,0,3500,0,4000,500,501,7.0,0.5
77490,19909,26,203,26,255,52,27,7.808,0.0
77494,5094,0,48,0,60,12,13,4.0,0.0
77496,9691,35,43,35,113,70,36,1.229,0.0
7751,24098,59,295,59,413,118,61,5.0,0.0
77512,42518,123,369,123,615,246,124,3.0,0.0
77514,2023,0,12,0,16,4,5,3.0,0.0
77515,30370,44,358,44,446,88,45,8.136,1.0
77518,2166,0,20,0,21,1,2,20.0,0.0
7752,254231,0,1969,0,2251,282,283,6.982,0.0
77520,16006,0,153,0,204,51,52,3.0,0.5
77526,2693658,1961,46827,1961,50749,3922,1963,23.879,0.0
77527,931758,1000,10000,1000,12000,2000,1001,10.0,0.0
77528,975061,0,17126,0,18126,1000,1001,17.126,0.0
7753,4294,0,75,0,80,5,6,15.0,1.0
77531,419500,0,5760,0,6480,720,721,8.0,0.8
77532,2856,0,18,0,24,6,7,3.0,0.0
77534,12941,37,74,37,148,74,38,2.0,0.0
77535,1526,1,10,1,12,2,2,10.0,0.0
77537,1167227,1000,17000,1000,19000,2000,1001,17.0,0.0
77538,932289,1000,10000,1000,12000,2000,1001,10.0,0.0
77539,42099,0,365,0,458,93,94,3.925,0.5
7754,9397,18,122,18,158,36,20,6.778,0.0
77540,402932,691,5528,691,6910,1382,692,8.0,0.9
77541,23095,4,20,4,28,8,5,5.0,0.0
77542,3310978,0,65031,0,66031,1000,1001,65.031,0.0
77543,42045,76,455,76,607,152,77,5.987,0.0
77545,29427,0,249,0,332,83,84,3.0,0.0
77546,16825,38,228,38,304,76,39,6.0,0.0
77547,38338,0,360,0,452,92,93,3.913,0.5
77552,228092,308,1180,308,1796,616,309,3.831,0.5
77553,15903,0,153,0,204,51,52,3.0,0.5
77554,6600760,1000,111650,1000,113650,2000,1001,111.65,0.0
77557,1335131,1000,20516,1000,22516,2000,1001,20.516,0.5
77559,15996,30,150,30,210,60,31,5.0,0.0
7756,19643,48,240,48,336,96,50,5.0,0.0
77560,82291,85,1020,85,1190,170,86,12.0,0.0
77563,3612,0,40,0,48,8,9,5.0,0.0
77564,4361,12,38,12,62,24,13,3.167,0.0
77565,247584,1000,1000,1000,3000,2000,1001,1.0,0.0
77566,241583,0,1000,0,2000,1000,1001,1.0,0.0
77567,4128,0,37,0,45,8,9,4.625,0.0
77568,96319,290,869,290,1449,580,291,2.997,0.0
7757,200433,132,2562,132,2826,264,134,19.409,0.0
77573,136177,558,558,558,1674,1116,559,1.0,0.0
77574,243583,1000,1000,1000,3000,2000,1001,1.0,0.0
77575,243583,1000,1000,1000,3000,2000,1001,1.0,0.0
77577,40393,0,440,0,495,55,56,8.0,0.0
77579,7577,0,84,0,98,14,15,6.0,0.0
7758,12432,20,120,20,160,40,22,6.0,0.0
77580,1555,4,4,4,12,8,5,1.0,0.0
77581,932208,1000,10000,1000,12000,2000,1001,10.0,0.0
77586,10017,13,104,13,130,26,14,8.0,0.0
77587,900332,1000,16212,1000,18212,2000,1001,16.212,0.0
77588,481067,278,6146,278,6980,834,557,22.108,0.0
77589,18733,0,202,0,228,26,27,7.769,0.0
7759,20778,0,294,0,343,49,50,6.0,0.0
77597,774865,1000,15211,1000,17211,2000,1001,15.211,0.0
7760,269986,480,3584,480,4544,960,482,7.467,0.0
77600,2121,0,19,0,20,1,2,19.0,0.0
77604,10070,13,104,13,130,26,14,8.0,0.0
77606,779887,1000,10987,1000,12987,2000,1001,10.987,0.0
77607,746805,1000,14724,1000,16724,2000,1001,14.724,0.0
7761,102735,55,814,55,924,110,57,14.8,0.0
77612,3595,0,40,0,48,8,9,5.0,0.0
77613,940507,1000,13649,1000,15649,2000,1001,13.649,0.0
77616,114607,101,1414,101,1616,202,102,14.0,0.0
77617,512581,1000,6000,1000,8000,2000,1001,6.0,0.0
7763,344782,0,4000,0,4500,500,501,8.0,0.0
77631,907183,1000,15988,1000,17988,2000,1001,15.988,0.0
77643,1438972,1000,26396,1000,28396,2000,1001,26.396,0.0
7765,820977,500,15804,500,16804,1000,502,31.608,0.0
77651,243583,1000,1000,1000,3000,2000,1001,1.0,0.0
77658,361053,184,5563,184,5931,368,185,30.234,0.0
77664,14032,14,194,14,222,28,15,13.857,0.0
77666,131610,0,1038,0,1303,265,266,3.917,0.0
77674,243583,1000,1000,1000,3000,2000,1001,1.0,0.0
77678,68851,70,803,70,943,140,71,11.471,0.0
77679,8602,33,33,33,99,66,34,1.0,0.0
77681,150672,0,1728,0,2016,288,289,6.0,0.5
77682,243583,1000,1000,1000,3000,2000,1001,1.0,0.0
77685,247584,1000,1000,1000,3000,2000,1001,1.0,0.0
7769,18903,20,200,20,240,40,22,10.0,0.0
77690,177267,245,735,245,1225,490,246,3.0,0.0
77691,1016707,1000,14962,1000,16962,2000,1001,14.962,0.0
77699,722355,1000,11775,1000,13775,2000,1001,11.775,0.0
777,2543,0,20,0,25,5,6,4.0,0.0
7770,4371,9,27,9,45,18,11,3.0,0.0
77700,247584,1000,1000,1000,3000,2000,1001,1.0,0.0
77702,903601,1000,16265,1000,18265,2000,1001,16.265,0.0
77706,4626,7,39,7,53,14,8,5.571,0.0
77707,243583,1000,1000,1000,3000,2000,1001,1.0,0.0
77709,8735,33,33,33,99,66,34,1.0,0.0
77711,2122,3,18,3,24,6,4,6.0,0.0
77712,247584,1000,1000,1000,3000,2000,1001,1.0,0.0
77716,938458,1000,16385,1000,18385,2000,1001,16.385,0.0
7772,3922,0,3,0,4,1,2,3.0,0.0
77728,1443681,1000,26558,1000,28558,2000,1001,26.558,0.5
77734,25531,101,101,101,303,202,102,1.0,0.0
77741,1174325,1978,16572,1978,20528,3956,1980,8.378,0.0
77745,247584,1000,1000,1000,3000,2000,1001,1.0,0.0
77750,9313,0,108,0,126,18,19,6.0,0.0
77754,8602,33,33,33,99,66,34,1.0,0.0
77755,4609,6,48,6,60,12,7,8.0,0.0
77758,8602,33,33,33,99,66,34,1.0,0.0
7776,300232,500,3991,500,4991,1000,502,7.982,0.0
77760,523672,0,7000,0,8000,1000,1001,7.0,0.0
77765,150768,0,1728,0,2016,288,289,6.0,0.0
7777,32835,87,261,87,435,174,89,3.0,0.0
77771,784342,1000,15654,1000,17654,2000,1001,15.654,0.0
77772,2585339,1915,43824,1915,47654,3830,1917,22.885,0.5
77779,150672,0,1728,0,2016,288,289,6.0,0.5
7778,297447,306,2754,306,3366,612,308,9.0,0.0
77782,2550301,1962,43295,1962,47219,3924,1964,22.067,0.0
77783,8735,33,33,33,99,66,34,1.0,0.0
77784,73747,94,1435,94,1623,188,95,15.266,0.0
77786,122899,0,1026,0,1291,265,266,3.872,0.0
77787,19963,25,381,25,431,50,26,15.24,0.0
77790,5309,7,56,7,70,14,8,8.0,0.0
77796,5125,7,53,7,67,14,8,7.571,0.0
7780,245645,0,1967,0,2248,281,282,7.0,0.0
77800,5300,7,56,7,70,14,8,8.0,0.0
77813,5293,7,56,7,70,14,8,8.0,0.0
7782,5278,0,45,0,54,9,10,5.0,0.0
77823,1712526,1000,26450,1000,28450,2000,1001,26.45,0.0
7783,16891,50,150,50,250,100,52,3.0,0.0
77832,243583,1000,1000,1000,3000,2000,1001,1.0,0.0
77833,1191468,1000,22236,1000,24236,2000,1001,22.236,0.0
77834,4228,15,15,15,45,30,16,1.0,0.0
7784,7363684,0,174298,0,174798,500,501,348.596,0.0
77844,115844,0,861,0,1148,287,288,3.0,0.5
77848,1569758,1000,23736,1000,25736,2000,1001,23.736,0.0
77849,851929,1000,10661,1000,12661,2000,1001,10.661,0.0
77850,2562053,1951,43654,1951,47556,3902,1953,22.375,0.0
77854,57278,117,762,117,996,234,118,6.513,0.75
77856,1309651,1000,21999,1000,23999,2000,1001,21.999,0.5
77858,122937,0,1026,0,1284,258,259,3.977,0.0
77859,243583,1000,1000,1000,3000,2000,1001,1.0,0.0
7786,84809,0,415,0,799,384,164,7.83,0.0
77861,1229667,1000,21920,1000,23920,2000,1001,21.92,0.0
77869,1329753,1000,20446,1000,22446,2000,1001,20.446,0.5
7787,68257,132,792,132,1056,264,134,6.0,0.5
77872,3969,5,40,5,50,10,6,8.0,0.0
77877,17635,15,180,15,210,30,16,12.0,0.0
7788,518724,355,3550,355,4260,710,357,10.0,0.0
77885,435638,0,6018,0,6827,809,810,7.439,1.0
77888,247584,1000,1000,1000,3000,2000,1001,1.0,0.0
7789,301522,0,4000,0,4500,500,501,8.0,0.5
77891,2550301,1962,43295,1962,47219,3924,1964,22.067,0.5
77892,76237,0,1048,0,1179,131,132,8.0,0.0
77899,243583,1000,1000,1000,3000,2000,1001,1.0,0.0
779,4165,12,36,12,60,24,13,3.0,0.0
7790,247748,0,1917,0,2191,274,275,6.996,0.0
77904,1144760,1000,21439,1000,23439,2000,1001,21.439,0.5
77906,851929,1000,10661,1000,12661,2000,1001,10.661,0.0
77916,1121750,1000,21188,1000,23188,2000,1001,21.188,0.0
77917,537508,0,7392,0,8316,924,925,8.0,0.0
77918,402933,0,5528,0,6219,691,692,8.0,0.5
7792,16897,41,205,41,287,82,43,5.0,0.0
77926,40678,165,165,165,495,330,166,1.0,0.0
77929,42183,123,369,123,615,246,124,3.0,0.0
7794,1985,2,30,2,34,4,4,15.0,0.0
77956,21746,76,76,76,228,152,78,1.0,0.0
77957,3676,11,11,11,33,22,13,1.0,0.0
77958,21746,76,76,76,228,152,78,1.0,0.0
77962,21746,76,76,76,228,152,78,1.0,0.0
77964,7701336,61,427,61,549,122,63,7.0,0.0
77965,3676,11,11,11,33,22,13,1.0,0.0
77969,17576,61,61,61,183,122,63,1.0,0.0
7797,136317,0,3325,0,3500,175,176,19.0,0.5
77975,1106039,40,680,40,760,80,42,17.0,0.0
7798,271560,0,1939,0,2216,277,278,7.0,0.5
7799,81719,44,614,44,702,88,46,13.955,0.0
78,620145,1098,3692,1098,5864,2172,1100,3.362,0.0
7800,347106,500,4500,500,5500,1000,502,9.0,0.0
7801,5957,11,73,11,95,22,13,6.636,0.0
7802,451224,500,6525,500,7525,1000,502,13.05,0.5
7803,757258,44,7146,44,7734,588,546,13.136,0.0
7805,37905,0,488,0,553,65,66,7.508,0.0
7811,346785,500,4500,500,5500,1000,502,9.0,0.0
7812,162969,278,2224,278,2780,556,280,8.0,0.0
7815,6367682,500,29968,500,30968,1000,502,59.936,0.0
7816,205007,0,2783,0,3131,348,349,7.997,0.0
7817,236762,500,3077,500,4077,1000,501,6.154,0.0
7818,1270485,500,28676,500,29676,1000,501,57.352,0.0
7819,295496,500,4000,500,5000,1000,501,8.0,1.0
7822,16308,0,255,0,272,17,18,15.0,0.0
7823,248792,500,3970,500,4970,1000,501,7.94,0.0
7824,239075,500,3368,500,4368,1000,501,6.736,1.0
7826,284047,0,5000,0,5500,500,501,10.0,1.0
7827,298576,0,5000,0,5500,500,501,10.0,0.0
7828,294800,500,5000,500,6000,1000,501,10.0,0.0
783,10495,34,85,34,170,85,53,2.5,0.5
7830,327602,336,2303,336,2975,672,337,6.854,0.0
7831,242747,500,3000,500,4000,1000,501,6.0,0.0
7832,8288866,500,4000,500,5000,1000,501,8.0,0.0
7835,7042,0,49,0,63,14,15,3.5,0.0
7836,299074,0,5000,0,5500,500,501,10.0,0.0
7840,17881,0,143,0,186,43,44,3.326,0.0
7841,299866,500,5000,500,6000,1000,501,10.0,0.5
7842,284408,0,5000,0,5500,500,501,10.0,1.0
7843,295069,0,5000,0,5500,500,501,10.0,1.0
7844,1563,0,12,0,14,2,3,6.0,0.0
7845,170543,0,2280,0,2565,285,286,8.0,0.0
7847,296934,500,5000,500,6000,1000,501,10.0,0.0
7848,138170,300,1793,300,2393,600,301,5.977,0.0
7849,319429,500,4500,500,5500,1000,501,9.0,0.5
7850,297786,500,5000,500,6000,1000,501,10.0,1.0
7851,303835,0,4497,0,4997,500,501,8.994,1.0
7852,280195,0,5000,0,5500,500,501,10.0,0.75
7853,295847,0,5000,0,5500,500,501,10.0,0.0
7854,302075,500,5000,500,6000,1000,501,10.0,0.0
7855,35073,104,311,104,519,208,105,2.99,0.0
7856,218695,500,2500,500,3500,1000,501,5.0,0.0
7859,310476,0,5000,0,5500,500,501,10.0,0.0
7861,284379,0,5000,0,5500,500,501,10.0,0.0
7862,406732,28,7463,28,8019,556,530,14.134,0.0
7863,319051,500,4492,500,5492,1000,501,8.984,0.5
7864,297258,0,5000,0,5500,500,501,10.0,0.0
7865,22517,23,207,23,288,81,59,9.0,0.0
7866,15928,24,192,24,240,48,25,8.0,0.0
7868,50934,173,346,173,692,346,174,2.0,0.0
7869,301796,0,4496,0,4996,500,501,8.992,0.5
787,5212,9,60,9,78,18,10,6.667,0.0
7870,319075,500,4492,500,5492,1000,501,8.984,0.75
7871,294515,500,4782,500,5782,1000,501,9.564,0.0
7872,45481,56,336,56,493,157,93,6.0,0.5
7873,287223,0,5000,0,5500,500,501,10.0,0.0
7874,330455,0,5000,0,5500,500,501,10.0,0.0
7876,20944,0,183,0,244,61,62,3.0,0.0
7878,295261,500,5000,500,6000,1000,501,10.0,1.0
7879,6438,0,76,0,87,11,12,6.909,0.5
788,389346,0,5500,0,6000,500,501,11.0,0.0
7880,295830,0,5000,0,5500,500,501,10.0,0.0
7881,292053,0,5000,0,5500,500,501,10.0,1.0
7882,297544,0,4982,0,5482,500,501,9.964,0.0
7883,12275,0,33,0,99,66,49,1.0,0.0
7884,291385,500,5000,500,6000,1000,501,10.0,0.0
7886,309803,500,5000,500,6000,1000,501,10.0,0.0
7887,297517,0,4000,0,4500,500,501,8.0,1.0
7888,289265,0,5000,0,5500,500,501,10.0,0.0
789,1589,3,9,3,15,6,4,3.0,0.0
7890,6707,0,72,0,84,12,13,6.0,0.0
7893,280711,0,5000,0,5500,500,501,10.0,1.0
7894,312093,0,4999,0,5499,500,501,9.998,1.0
7895,5975,10,70,10,90,20,11,7.0,0.5
7897,190347,0,2000,0,2500,500,501,4.0,0.0
7898,4244539,500,6368,500,7368,1000,501,12.736,0.0
7899,6757,6,96,6,108,12,7,16.0,0.5
79,621267,1101,3694,1101,5872,2178,1103,3.355,0.0
7900,1073,0,2,0,4,2,3,2.0,0.0
7901,285483,0,3500,0,4000,500,501,7.0,0.0
7903,50524,102,542,102,746,204,103,5.314,0.0
7905,85678,0,1057,0,1208,151,152,7.0,0.0
7906,176940,0,1926,0,2247,321,322,6.0,0.5
7907,132435,1,6,1,8,2,2,6.0,0.0
79088,81762,100,624,100,824,200,102,6.24,0.5
7909,485971,0,6357,0,6846,489,490,13.0,1.0
791,1262,0,6,0,8,2,3,3.0,0.0
79117,1252901,1838,23593,1838,27269,3676,1840,12.836,0.0
7912,4557,0,35,0,42,7,8,5.0,0.0
79151,253590,1000,1000,1000,3000,2000,1001,1.0,0.0
7916,4458,4,9,4,17,8,5,2.25,0.0
79161,249589,1000,1000,1000,3000,2000,1001,1.0,0.0
7917,264610,0,4004,0,4368,364,365,11.0,0.5
79173,249589,1000,1000,1000,3000,2000,1001,1.0,0.0
7918,229402,0,2500,0,3000,500,501,5.0,0.0
79187,253590,1000,1000,1000,3000,2000,1001,1.0,0.0
79188,2440,2,24,2,28,4,3,12.0,0.0
79189,1127801,0,13883,0,14883,1000,1001,13.883,0.0
79190,725621,822,9869,822,11513,1644,823,12.006,0.0
79191,823110,1000,12128,1000,14128,2000,1001,12.128,0.0
79192,210173,89,2848,89,3026,178,90,32.0,0.0
79196,59916,58,870,58,986,116,59,15.0,0.5
79197,72275,62,904,62,1028,124,63,14.581,0.5
79198,71284,96,1056,96,1248,192,97,11.0,0.0
792,296606,0,5950,0,6300,350,351,17.0,0.0
7920,63490,0,928,0,994,66,67,14.061,0.0
79202,10401,16,110,16,142,32,17,6.875,0.0
79204,860663,1000,11719,1000,13719,2000,1001,11.719,0.0
79209,24557,48,288,48,384,96,49,6.0,0.0
7921,311833,0,4000,0,4500,500,501,8.0,0.0
79210,17944,44,176,44,264,88,45,4.0,0.0
79211,9106,15,120,15,150,30,16,8.0,0.0
79212,5092,7,47,7,61,14,8,6.714,0.5
79213,14879,41,123,41,205,82,42,3.0,0.0
79214,2880,6,18,6,30,12,7,3.0,0.0
79215,43847,90,720,90,900,180,91,8.0,0.0
79217,8666,19,76,19,114,38,20,4.0,0.0
79218,9848,20,100,20,140,40,21,5.0,0.5
79222,4199,7,35,7,49,14,8,5.0,0.0
79225,21068,48,219,48,315,96,49,4.562,0.0
79226,157981,300,2400,300,3000,600,301,8.0,0.0
79227,6242,11,66,11,88,22,12,6.0,0.0
79228,9890,21,105,21,147,42,22,5.0,0.5
79229,9397,17,100,17,134,34,18,5.882,0.0
7923,230249,0,2500,0,3000,500,501,5.0,0.0
79230,19143,38,266,38,342,76,39,7.0,0.0
79232,88790,96,861,96,1053,192,97,8.969,0.75
79233,2375,5,15,5,25,10,6,3.0,0.0
79234,7115,13,91,13,117,26,14,7.0,0.0
79235,43656,90,720,90,900,180,91,8.0,0.0
79236,6770,17,51,17,85,34,18,3.0,0.0
7924,483462,0,6500,0,7000,500,501,13.0,0.0
79240,3656,6,30,6,42,12,7,5.0,0.0
79241,2384,5,15,5,25,10,6,3.0,0.0
79244,3616,6,30,6,42,12,7,5.0,0.0
79245,2540,7,7,7,21,14,8,1.0,0.0
79246,3591,6,30,6,42,12,7,5.0,0.0
79248,2111,4,15,4,23,8,5,3.75,0.0
79249,17356,60,60,60,180,120,61,1.0,0.0
79250,5840,19,19,19,57,38,20,1.0,0.0
79252,27015,96,96,96,288,192,97,1.0,0.0
79253,83115,300,300,300,900,600,301,1.0,0.0
79255,14008,48,48,48,144,96,49,1.0,0.0
79256,3685,11,11,11,33,22,12,1.0,0.0
79257,12912,28,106,28,162,56,29,3.786,0.0
79258,230571,60,5703,60,5823,120,61,95.05,0.0
79259,2171,4,12,4,20,8,5,3.0,0.0
7926,8141,4,112,4,124,12,10,14.0,0.0
79260,1444,2,8,2,12,4,3,4.0,0.0
79263,14739,30,240,30,300,60,31,8.0,0.5
79264,13815,48,48,48,144,96,49,1.0,0.0
79265,275615,1000,1000,1000,3000,2000,1001,1.0,0.0
79266,52927,98,588,98,784,196,99,6.0,0.0
79267,497424,839,6712,839,8390,1678,840,8.0,0.0
79270,53500,122,488,122,732,244,123,4.0,0.0
79272,56106,145,518,145,808,290,146,3.572,0.0
79275,276770,3,47,3,53,6,4,15.667,0.0
7928,553552,5,40,5,50,10,6,8.0,0.0
79280,1069848,1000,17889,1000,19889,2000,1001,17.889,0.0
79283,10639,19,114,19,152,38,20,6.0,0.0
79286,14610,22,166,22,210,44,23,7.545,0.0
79287,1343088,1000,19000,1000,21000,2000,1001,19.0,0.0
79288,8875,13,116,13,142,26,14,8.923,0.0
79291,4998,7,55,7,69,14,8,7.857,0.0
79296,35528,33,594,33,660,66,34,18.0,1.0
79297,4404,6,48,6,60,12,7,8.0,0.0
79298,4417,6,48,6,60,12,7,8.0,0.0
79299,12734,18,108,18,161,53,36,6.0,0.0
7930,16017,14,224,14,266,42,30,8.0,0.0
79300,5011,7,56,7,70,14,8,8.0,0.0
79302,5619,8,64,8,80,16,9,8.0,0.0
79305,18793,21,271,21,313,42,22,12.905,0.0
7931,245457,370,3330,370,4070,740,371,9.0,0.0
79311,3749,5,40,5,50,10,6,8.0,0.0
79312,135000,266,1580,266,2112,532,267,5.94,0.0
79315,5059,7,57,7,71,14,8,8.143,0.0
79316,4962,7,55,7,69,14,8,7.857,0.0
79317,4432,6,49,6,61,12,7,8.167,0.0
79318,10438,16,128,16,160,32,17,8.0,0.0
7932,447746,500,6441,500,7441,1000,501,12.882,0.0
79329,10946,12,157,12,181,24,13,13.083,0.0
79330,13679,15,198,15,228,30,16,13.2,0.0
79331,5629,8,62,8,78,16,9,7.75,0.0
79333,4424,6,48,6,60,12,7,8.0,0.0
79334,223167,226,3603,226,4055,452,227,15.942,0.0
79337,5580,8,62,8,78,16,9,7.75,0.0
79341,3780,5,40,5,50,10,6,8.0,0.0
79344,4418,6,49,6,61,12,7,8.167,0.0
79345,34013,33,585,33,651,66,34,17.727,0.0
79346,153883,241,1928,241,2410,482,242,8.0,0.0
79347,24104,43,172,43,301,129,87,4.0,0.0
79348,4946,7,54,7,68,14,8,7.714,0.0
7935,18257,0,255,0,272,17,18,15.0,0.0
79352,37127,33,594,33,660,66,34,18.0,0.0
79354,3752,5,40,5,50,10,6,8.0,0.0
79355,3770,5,40,5,50,10,6,8.0,0.0
79357,21242,30,297,30,357,60,31,9.9,0.0
7936,299667,0,3500,0,4000,500,501,7.0,0.0
7938,229808,346,3460,346,4152,692,348,10.0,0.0
7939,7956,20,90,20,130,40,22,4.5,0.0
7941,2395,3,21,3,30,9,8,3.5,0.0
7942,32421,0,405,0,450,45,46,9.0,0.0
7943,585685,430,12040,430,12900,860,432,28.0,0.0
7944,16366,0,229,0,246,17,18,13.471,0.0
7945,228638,0,2499,0,2999,500,501,4.998,0.0
7948,8931,17,102,17,136,34,18,6.0,0.0
79486,24277,43,172,43,301,129,87,4.0,0.0
7950,94392,192,1152,192,1536,384,193,6.0,0.0
79506,69310,241,241,241,723,482,242,1.0,0.0
79507,69310,241,241,241,723,482,242,1.0,0.0
79508,69310,241,241,241,723,482,242,1.0,0.0
79509,70275,241,241,241,723,482,242,1.0,0.0
7951,63686,70,782,70,992,210,142,6.627,1.0
79510,69310,241,241,241,723,482,242,1.0,0.0
79511,69310,241,241,241,723,482,242,1.0,0.0
79512,69310,241,241,241,723,482,242,1.0,0.0
79513,70275,241,241,241,723,482,242,1.0,0.0
79514,69310,241,241,241,723,482,242,1.0,0.0
79515,70275,241,241,241,723,482,242,1.0,0.0
79516,69310,241,241,241,723,482,242,1.0,0.0
79517,70275,241,241,241,723,482,242,1.0,0.0
79518,69310,241,241,241,723,482,242,1.0,0.0
79519,69310,241,241,241,723,482,242,1.0,0.0
7952,375071,500,4565,500,6065,1500,1002,4.785,0.0
79520,69310,241,241,241,723,482,242,1.0,0.0
79521,70275,241,241,241,723,482,242,1.0,0.0
79522,69310,241,241,241,723,482,242,1.0,0.0
79523,69310,241,241,241,723,482,242,1.0,0.0
79524,69310,241,241,241,723,482,242,1.0,0.0
79525,69310,241,241,241,723,482,242,1.0,0.0
79526,70275,241,241,241,723,482,242,1.0,0.0
79527,69310,241,241,241,723,482,242,1.0,0.0
79528,69310,241,241,241,723,482,242,1.0,0.0
79529,70275,241,241,241,723,482,242,1.0,0.0
7953,47157,0,368,0,460,92,93,4.0,0.0
79530,70275,241,241,241,723,482,242,1.0,0.0
79531,69310,241,241,241,723,482,242,1.0,0.0
79532,69310,241,241,241,723,482,242,1.0,0.0
79533,69310,241,241,241,723,482,242,1.0,0.0
79534,69310,241,241,241,723,482,242,1.0,0.0
79535,69310,241,241,241,723,482,242,1.0,0.0
79536,69310,241,241,241,723,482,242,1.0,0.0
79537,69310,241,241,241,723,482,242,1.0,0.0
79538,69310,241,241,241,723,482,242,1.0,0.0
79539,69310,241,241,241,723,482,242,1.0,0.0
7954,7542,20,80,20,120,40,22,4.0,0.0
79540,70275,241,241,241,723,482,242,1.0,0.0
79541,69310,241,241,241,723,482,242,1.0,0.0
79542,69310,241,241,241,723,482,242,1.0,0.0
79543,69310,241,241,241,723,482,242,1.0,0.0
79544,69310,241,241,241,723,482,242,1.0,0.0
79545,69310,241,241,241,723,482,242,1.0,0.0
79546,69310,241,241,241,723,482,242,1.0,0.0
79547,69310,241,241,241,723,482,242,1.0,0.0
79548,70275,241,241,241,723,482,242,1.0,0.0
79549,70275,241,241,241,723,482,242,1.0,0.0
7955,4530,3,72,3,78,6,4,24.0,0.0
79550,69310,241,241,241,723,482,242,1.0,0.0
79551,69310,241,241,241,723,482,242,1.0,0.0
79552,69310,241,241,241,723,482,242,1.0,0.0
79553,69310,241,241,241,723,482,242,1.0,0.0
79554,69310,241,241,241,723,482,242,1.0,0.0
79555,69310,241,241,241,723,482,242,1.0,0.0
7956,362761,0,5000,0,5500,500,501,10.0,0.0
796,5212,9,60,9,78,18,10,6.667,0.0
7960,495699,0,6500,0,7000,500,501,13.0,0.0
7961,46531,90,708,90,888,180,92,7.867,0.0
7962,181141,173,2734,173,3253,519,348,7.902,0.0
7964,326691,500,4500,500,5500,1000,502,9.0,0.0
7966,2415,5,15,5,25,10,7,3.0,0.0
7968,4189901,500,126266,500,127266,1000,502,252.532,0.0
7969,1985,2,30,2,34,4,4,15.0,0.0
7970,520930,500,7223,500,8223,1000,502,14.446,0.0
7971,222159,0,2500,0,3000,500,501,5.0,1.0
7972,4407,5,75,5,85,10,7,15.0,0.0
7973,1981,0,30,0,32,2,3,15.0,1.0
7974,340533,0,4230,0,4730,500,501,8.46,0.0
7975,19283,47,235,47,329,94,49,5.0,0.0
7976,5791,7,105,7,119,14,9,15.0,1.0
7977,13961,41,123,41,205,82,43,3.0,0.0
7979,206314,500,2500,500,3500,1000,502,5.0,0.0
798,480596,0,10000,0,10500,500,501,20.0,0.0
7980,24778,23,318,23,364,46,25,13.826,0.0
7981,54469,103,515,103,721,206,105,5.0,0.0
7982,256697,0,1962,0,2243,281,282,6.982,0.0
7985,5853,7,105,7,119,14,9,15.0,0.0
7986,52776,0,955,0,1029,74,75,12.905,0.0
7988,41305,0,811,0,863,52,53,15.596,0.0
799,576858,0,12465,0,12657,192,193,64.922,0.0
7990,132240,110,1097,110,1317,220,112,9.973,0.0
7991,38399,29,234,29,334,100,61,8.069,0.75
7992,278434,500,3515,500,4515,1000,502,7.03,0.0
7993,417597,156,3930,156,4242,312,158,25.192,0.0
7994,82807,131,1107,131,1369,262,133,8.45,0.0
7995,67855,140,830,140,1110,280,142,5.929,0.0
80,609919,1088,3675,1088,5827,2152,1090,3.378,0.0
8002,40197,100,500,100,700,200,102,5.0,0.0
8003,30586,23,431,23,477,46,25,18.739,0.0
8004,608769,0,5539,0,6039,500,501,11.078,0.5
8005,251168,0,1999,0,2286,287,288,6.965,0.0
8006,5790,7,105,7,119,14,9,15.0,1.0
8007,413940,500,5475,500,6475,1000,502,10.95,0.0
8008,355049,0,5000,0,5500,500,501,10.0,0.0
8009,1227541,500,19980,500,20980,1000,502,39.96,0.0
8010,345852,0,4984,0,5484,500,501,9.968,0.0
8012,6158253,0,173084,0,173584,500,501,346.168,0.0
8016,587291,0,4163,0,4663,500,501,8.326,0.0
8017,76183,81,967,81,1129,162,83,11.938,0.0
8018,265094,0,3500,0,4000,500,501,7.0,0.0
8020,90707,127,381,127,635,254,129,3.0,0.0
8024,162965,301,2095,301,2697,602,303,6.96,0.0
8027,694488,500,13012,500,14012,1000,502,26.024,0.0
8028,346712,0,4500,0,5000,500,501,9.0,0.0
8031,357478,0,5000,0,5500,500,501,10.0,0.0
8032,357551,0,5000,0,5500,500,501,10.0,0.0
8033,5002,9,59,9,77,18,11,6.556,0.0
8034,355927,0,5000,0,5500,500,501,10.0,0.0
8035,308069,500,5503,500,6503,1000,501,11.006,0.5
8037,356758,500,5000,500,6000,1000,501,10.0,0.0
8038,85152,39,905,39,1041,136,99,9.33,0.6666666666666666
8039,343738,0,6063,0,6563,500,501,12.126,1.0
8041,356442,0,5000,0,5500,500,501,10.0,0.0
8042,292869,500,4000,500,5000,1000,501,8.0,0.75
8044,290164,500,4782,500,5782,1000,501,9.564,0.75
8045,319931,500,5000,500,6000,1000,501,10.0,0.0
8046,252248,0,4000,0,4500,500,501,8.0,1.0
8047,301848,0,4000,0,4500,500,501,8.0,1.0
8048,78171,0,945,0,1080,135,136,7.0,0.0
8049,300055,500,5000,500,6000,1000,501,10.0,1.0
8050,267597,0,3976,0,4476,500,501,7.952,0.0
8051,299500,0,5000,0,5500,500,501,10.0,1.0
8053,357094,0,4500,0,5000,500,501,9.0,0.0
8054,252161,0,3997,0,4497,500,501,7.994,0.75
8055,303379,0,5000,0,5500,500,501,10.0,1.0
8056,299266,500,5000,500,6000,1000,501,10.0,0.0
8057,294811,500,5000,500,6000,1000,501,10.0,0.0
8059,245598,0,4000,0,4500,500,501,8.0,1.0
8061,283886,0,5000,0,5500,500,501,10.0,1.0
8062,255242,0,4000,0,4500,500,501,8.0,0.0
8063,453478,0,9406,0,9906,500,501,18.812,0.0
8064,23715,70,210,70,350,140,71,3.0,0.0
8065,295205,500,5000,500,6000,1000,501,10.0,0.0
8067,290267,500,5000,500,6000,1000,501,10.0,0.0
8068,296151,0,5000,0,5500,500,501,10.0,1.0
8069,280175,0,5000,0,5500,500,501,10.0,0.75
8070,32521,72,226,72,370,144,73,3.139,0.0
8071,314580,500,5000,500,6000,1000,501,10.0,0.0
8072,292296,0,5000,0,5500,500,501,10.0,0.0
8073,293524,0,5000,0,5500,500,501,10.0,0.0
8074,339285,0,4500,0,5000,500,501,9.0,1.0
8076,299234,500,5000,500,6000,1000,501,10.0,0.0
8077,2573,4,10,4,18,8,5,2.5,0.0
8078,290610,500,5000,500,6000,1000,501,10.0,1.0
8080,242660,0,4000,0,4500,500,501,8.0,0.0
8081,256794,0,4000,0,4500,500,501,8.0,0.0
8082,292138,0,5000,0,5500,500,501,10.0,1.0
80829,5400,19,19,19,57,38,20,1.0,0.0
8083,284112,0,5000,0,5500,500,501,10.0,0.0
80830,141944,550,550,550,1650,1100,551,1.0,0.0
80831,1055612,1000,19488,1000,21488,2000,1001,19.488,0.0
80833,6957,19,56,19,94,38,20,2.947,0.0
80835,249370,968,968,968,2904,1936,969,1.0,0.0
80836,139743,550,550,550,1650,1100,551,1.0,0.0
80837,672637,1000,10000,1000,12000,2000,1001,10.0,0.0
80838,257594,1000,1000,1000,3000,2000,1001,1.0,0.0
80839,139743,550,550,550,1650,1100,551,1.0,0.0
8084,1562,0,12,0,14,2,3,6.0,0.0
80840,311590,550,3824,550,4924,1100,551,6.953,0.0
80841,1161,1,6,1,8,2,2,6.0,0.0
80842,1203,1,7,1,9,2,2,7.0,0.0
80843,242021,566,2824,566,3956,1132,567,4.989,1.0
80847,765227,731,12427,731,13889,1462,732,17.0,0.0
8085,693578,1000,13553,1000,16053,2500,1502,9.035,0.0
80850,93618,151,1120,151,1422,302,152,7.417,0.0
80854,139743,550,550,550,1650,1100,551,1.0,0.0
80867,253593,1000,1000,1000,3000,2000,1001,1.0,0.0
8087,229811,500,2689,500,3689,1000,501,5.378,0.0
80871,253593,1000,1000,1000,3000,2000,1001,1.0,0.0
80878,11317,10,130,10,150,20,11,13.0,0.0
8088,291232,500,5000,500,6000,1000,501,10.0,0.8333333333333334
80882,7424,27,27,27,81,54,28,1.0,0.0
80885,143791,566,566,566,1698,1132,567,1.0,0.0
80893,4355,5,45,5,55,10,6,9.0,0.0
80897,126781,491,491,491,1473,982,492,1.0,0.0
80899,43350,169,169,169,507,338,170,1.0,0.0
8090,244014,500,2500,500,3500,1000,501,5.0,0.0
80911,253593,1000,1000,1000,3000,2000,1001,1.0,0.0
80915,26011,0,297,0,330,33,34,9.0,0.0
80923,2484,0,22,0,24,2,3,11.0,0.0
80925,70755,273,273,273,819,546,274,1.0,0.0
80927,257594,1000,1000,1000,3000,2000,1001,1.0,0.0
80928,143791,566,566,566,1698,1132,567,1.0,0.0
8093,74515,0,942,0,1099,157,158,6.0,0.0
80930,9589,35,35,35,105,70,36,1.0,0.0
80931,143791,566,566,566,1698,1132,567,1.0,0.0
80932,21339,82,82,82,246,164,83,1.0,0.0
80934,253593,1000,1000,1000,3000,2000,1001,1.0,0.0
80938,44027,169,169,169,507,338,170,1.0,0.0
80939,27158,105,105,105,315,210,106,1.0,0.0
8094,295862,0,5000,0,5500,500,501,10.0,1.0
80940,10300,22,88,22,132,44,23,4.0,0.0
80941,70755,273,273,273,819,546,274,1.0,0.0
80942,5673,5,60,5,70,10,6,12.0,0.0
80943,6248,22,22,22,66,44,23,1.0,0.0
80944,21339,82,82,82,246,164,83,1.0,0.0
80945,111618,432,432,432,1296,864,433,1.0,0.0
80946,231798,313,2817,313,3443,626,314,9.0,0.0
80949,143148,137,1507,137,1781,274,138,11.0,0.0
80958,37278,145,145,145,435,290,146,1.0,0.0
8096,275864,500,2000,500,3500,1500,998,4.0,0.0
80960,69662,273,273,273,819,546,274,1.0,0.0
80967,257594,1000,1000,1000,3000,2000,1001,1.0,0.0
80968,9955026,87,1554,87,1728,174,88,17.862,0.0
8097,297300,0,5000,0,5500,500,501,10.0,0.0
80971,6216348,282,7335,282,7899,564,283,26.011,0.0
8098,299679,500,5000,500,6000,1000,501,10.0,0.0
80989,65501,108,936,108,1152,216,109,8.667,0.0
80999,2172,0,18,0,20,2,3,9.0,0.0
81,664688,1086,4759,1086,6907,2148,1088,4.382,0.0
8100,140044,0,1710,0,1995,285,286,6.0,1.0
81006,25208,0,288,0,320,32,33,9.0,0.0
8101,23763,37,222,37,368,146,110,6.0,0.0
81010,28310,63,252,63,378,126,64,4.0,0.0
81011,16532,63,63,63,189,126,64,1.0,0.0
81017,425770,35,560,35,630,70,36,16.0,0.0
8102,302003,0,4500,0,5000,500,501,9.0,0.0
81020,1418,1,9,1,11,2,2,9.0,0.0
81021,253593,1000,1000,1000,3000,2000,1001,1.0,0.0
81022,126524,490,490,490,1470,980,491,1.0,0.0
81023,69662,273,273,273,819,546,274,1.0,0.0
81024,2211,0,20,0,22,2,3,10.0,0.0
81026,1329,0,8,0,9,1,2,8.0,0.0
81027,2352,0,20,0,22,2,3,10.0,0.0
8103,316887,0,5000,0,5500,500,501,10.0,0.0
81037,4542,8,56,8,72,16,9,7.0,0.0
8104,250469,0,3997,0,4497,500,501,7.994,1.0
81056,2152,0,20,0,22,2,3,10.0,0.0
81059,124563,490,490,490,1470,980,491,1.0,0.0
8106,72803,0,1140,0,1254,114,115,10.0,0.0
81061,2210,0,20,0,22,2,3,10.0,0.0
81062,124563,490,490,490,1470,980,491,1.0,0.0
81063,27917,108,108,108,324,216,109,1.0,0.0
81064,109889,432,432,432,1296,864,433,1.0,0.0
81065,27917,108,108,108,324,216,109,1.0,0.0
81067,27917,108,108,108,324,216,109,1.0,0.0
81069,2217,0,20,0,22,2,3,10.0,0.0
8107,446111,0,7872,0,8372,500,501,15.744,0.0
81070,1130245,1000,10950,1000,12950,2000,1001,10.95,0.0
81073,1346,0,9,0,10,1,2,9.0,0.0
81077,16532,63,63,63,189,126,64,1.0,0.0
81079,367820,19,295,19,333,38,20,15.526,0.0
8108,294939,500,5000,500,6000,1000,501,10.0,0.0
81080,253593,1000,1000,1000,3000,2000,1001,1.0,0.0
81083,124563,490,490,490,1470,980,491,1.0,0.0
81085,4706,16,16,16,48,32,17,1.0,0.0
81087,16785,63,63,63,189,126,64,1.0,0.0
81090,124563,490,490,490,1470,980,491,1.0,0.0
81091,16785,63,63,63,189,126,64,1.0,0.0
81097,367897,19,295,19,333,38,20,15.526,0.0
8110,313596,1000,4500,1000,6500,2000,1002,4.5,0.0
81107,660062,5,35,5,45,10,6,7.0,0.0
81110,22604,87,87,87,261,174,88,1.0,0.0
81111,614382,7,63,7,77,14,8,9.0,0.0
81112,76351,7,119,7,133,14,8,17.0,0.0
81113,634456,315,1886,315,2516,630,316,5.987,0.0
81114,5400,19,19,19,57,38,20,1.0,0.0
81116,3331811,378,1512,378,2268,756,379,4.0,0.0
81117,4570907,1000,5849,1000,7849,2000,1001,5.849,0.5
81118,1646371,1000,9410,1000,11410,2000,1001,9.41,0.0
81119,17038,65,65,65,195,130,66,1.0,0.0
81122,17299,65,65,65,195,130,66,1.0,0.0
81123,4894,17,17,17,51,34,18,1.0,0.0
81124,294691,231,4451,231,4913,462,232,19.268,0.0
81125,817921,103,412,103,618,206,104,4.0,0.0
81126,2364,7,7,7,21,14,8,1.0,0.0
81127,5477,19,19,19,57,38,20,1.0,0.0
81128,1222891,1000,19062,1000,21062,2000,1001,19.062,0.0
81145,2364,7,7,7,21,14,8,1.0,0.0
8117,13759,26,195,26,247,52,28,7.5,0.0
81177,1358359,1000,20997,1000,22997,2000,1001,20.997,0.0
81179,837041,1000,12000,1000,14000,2000,1001,12.0,0.0
8118,61539,79,817,79,975,158,80,10.342,0.0
81180,618303,1000,8000,1000,10000,2000,1001,8.0,0.0
81181,958945,1000,13780,1000,15780,2000,1001,13.78,0.0
81182,1371610,1000,21000,1000,23000,2000,1001,21.0,0.0
81185,1556423,1000,25998,1000,27998,2000,1001,25.998,0.0
81188,717956,537,10740,537,11814,1074,538,20.0,0.0
81189,1121638,1000,18108,1000,20108,2000,1001,18.108,0.0
8119,371540,500,5968,500,7468,1500,1002,6.065,0.0
81191,261598,1000,1000,1000,3000,2000,1001,1.0,0.0
81193,1306942,1000,19994,1000,21994,2000,1001,19.994,0.0
81195,1639285,1000,26000,1000,28000,2000,1001,26.0,0.0
81196,1203760,1000,17000,1000,19000,2000,1001,17.0,0.0
81197,1362038,1000,20996,1000,22996,2000,1001,20.996,0.0
81199,207750,156,3120,156,3432,312,157,20.0,0.0
8120,85193,88,1229,88,1493,264,178,6.983,0.0
81200,326918,234,4744,234,5212,468,235,20.274,0.5
81201,1410267,1000,20416,1000,22416,2000,1001,20.416,0.0
81202,257597,1000,1000,1000,3000,2000,1001,1.0,0.0
81203,544632,407,8140,407,8954,814,408,20.0,0.0
81204,809214,1000,11000,1000,13000,2000,1001,11.0,0.0
81206,9902,19,95,19,133,38,20,5.0,0.0
81210,1081372,1000,15985,1000,17985,2000,1001,15.985,0.0
81212,1303485,1000,21018,1000,23018,2000,1001,21.018,0.0
81213,2765769,1000,45497,1000,47497,2000,1001,45.497,0.0
81214,892934,1000,13387,1000,15387,2000,1001,13.387,0.0
81217,714511,1000,12000,1000,14000,2000,1001,12.0,0.0
81218,1353394,1000,19886,1000,21886,2000,1001,19.886,0.0
81222,10106,37,37,37,111,74,38,1.0,0.0
81223,909219,1000,12619,1000,14619,2000,1001,12.619,0.0
81224,1865951,1000,29001,1000,31001,2000,1001,29.001,0.0
81225,280645,525,3654,525,4704,1050,526,6.96,0.0
81226,1017471,1000,14970,1000,16970,2000,1001,14.97,0.0
81227,767390,1000,11000,1000,13000,2000,1001,11.0,0.0
81228,755639,628,11284,628,12540,1256,629,17.968,0.0
8123,668464,500,14001,500,15501,1500,1002,14.001,0.0
81230,1040621,1000,14985,1000,16985,2000,1001,14.985,0.0
81232,1056770,1000,15753,1000,17753,2000,1001,15.753,0.0
81233,257597,1000,1000,1000,3000,2000,1001,1.0,0.0
81234,1585415,1000,25999,1000,27999,2000,1001,25.999,0.0
81235,712694,1000,12000,1000,14000,2000,1001,12.0,0.0
81237,1353655,1000,19884,1000,21884,2000,1001,19.884,0.0
8124,234747,500,2990,500,3990,1000,501,5.98,0.0
81241,1582772,1000,25000,1000,27000,2000,1001,25.0,0.0
81242,2952235,1000,49556,1000,51556,2000,1001,49.556,0.0
81243,1086073,1000,16750,1000,18750,2000,1001,16.75,0.0
81244,15587,11,220,11,242,22,12,20.0,0.0
81245,1067206,1000,16373,1000,18373,2000,1001,16.373,0.0
81246,2028,1,22,1,24,2,2,22.0,0.0
81248,257597,1000,1000,1000,3000,2000,1001,1.0,0.0
81249,1586902,1000,24990,1000,26990,2000,1001,24.99,0.0
8125,6983,0,48,0,64,16,17,3.0,0.0
81250,638413,1000,10000,1000,12000,2000,1001,10.0,0.0
81251,3732972,1000,64627,1000,66627,2000,1001,64.627,0.0
81252,1071338,1000,16373,1000,18373,2000,1001,16.373,0.0
81253,261598,1000,1000,1000,3000,2000,1001,1.0,0.0
81257,1390372,1000,22000,1000,24000,2000,1001,22.0,0.0
8126,433773,500,4467,500,5967,1500,1002,4.53,0.0
81260,2951301,1000,49559,1000,51559,2000,1001,49.559,0.0
81261,257597,1000,1000,1000,3000,2000,1001,1.0,0.0
81262,864454,1000,12589,1000,14589,2000,1001,12.589,0.0
81263,57976,43,860,43,946,86,44,20.0,0.0
81264,853784,1000,12592,1000,14592,2000,1001,12.592,0.0
81266,1469742,1000,22994,1000,24994,2000,1001,22.994,0.0
81268,10811,10,150,10,170,20,11,15.0,0.0
81270,1320040,1000,19798,1000,21798,2000,1001,19.798,0.0
81272,1383876,1000,20993,1000,22993,2000,1001,20.993,0.0
81273,995584,0,14236,0,15236,1000,1001,14.236,0.0
81274,708181,1000,10444,1000,12444,2000,1001,10.444,0.0
81276,364573,1000,2999,1000,4999,2000,1001,2.999,0.0
81278,1304486,1000,21018,1000,23018,2000,1001,21.018,0.0
81279,3742216,1000,64623,1000,66623,2000,1001,64.623,0.0
8128,179043,290,2026,290,2896,870,582,3.505,0.0
81280,803418,647,11625,647,12919,1294,648,17.968,0.0
81288,257597,1000,1000,1000,3000,2000,1001,1.0,0.0
81289,4588,3,60,3,66,6,4,20.0,0.0
81290,540555,437,8045,437,8919,874,438,18.41,0.0
81291,1353105,1000,19884,1000,21884,2000,1001,19.884,0.0
81292,789984,1000,11617,1000,13617,2000,1001,11.617,0.0
81295,831156,1000,11000,1000,13000,2000,1001,11.0,0.5
81296,1256792,1000,18558,1000,20558,2000,1001,18.558,0.0
81297,840605,1000,11999,1000,13999,2000,1001,11.999,0.0
81298,1086541,1000,16671,1000,18671,2000,1001,16.671,0.0
81299,623396,1000,10000,1000,12000,2000,1001,10.0,0.0
81300,200357,250,2750,250,3250,500,251,11.0,0.0
81301,1335963,1000,20000,1000,22000,2000,1001,20.0,0.0
81302,1635446,1000,26000,1000,28000,2000,1001,26.0,0.0
81303,1285024,1000,20000,1000,22000,2000,1001,20.0,0.0
81305,257597,1000,1000,1000,3000,2000,1001,1.0,0.0
81307,958945,1000,13780,1000,15780,2000,1001,13.78,0.0
81308,1344637,1000,19999,1000,21999,2000,1001,19.999,0.0
81310,3643320,1000,62583,1000,64583,2000,1001,62.583,0.0
81311,1000742,1000,14377,1000,16377,2000,1001,14.377,0.0
81312,167382,200,2459,200,2859,400,201,12.295,0.0
81314,849924,1000,11998,1000,13998,2000,1001,11.998,0.0
81315,1472909,1000,21156,1000,23156,2000,1001,21.156,0.0
81317,3288,5,25,5,35,10,6,5.0,0.0
81320,578645,1000,9424,1000,11424,2000,1001,9.424,0.0
81321,257597,1000,1000,1000,3000,2000,1001,1.0,0.0
81322,1377241,1000,20964,1000,22964,2000,1001,20.964,0.0
81323,90704,150,900,150,1200,300,151,6.0,0.0
81324,3913,10,30,10,50,20,11,3.0,0.0
81328,1632535,1000,25988,1000,27988,2000,1001,25.988,0.0
8133,12834,20,160,20,200,40,21,8.0,0.0
81330,909291,727,13055,727,14509,1454,728,17.957,0.0
81332,840560,1000,11998,1000,13998,2000,1001,11.998,0.0
81336,192600,142,2840,142,3124,284,143,20.0,0.0
81337,3345101,1000,56958,1000,58958,2000,1001,56.958,0.0
81338,1270903,1000,18864,1000,20864,2000,1001,18.864,0.0
8134,31418,29,464,29,551,87,60,8.0,0.0
81340,837278,1000,12000,1000,14000,2000,1001,12.0,0.0
81343,178485,279,2790,279,3348,558,280,10.0,0.0
81344,1340646,1000,19999,1000,21999,2000,1001,19.999,0.0
81346,793985,1000,11617,1000,13617,2000,1001,11.617,0.0
81347,2578,2,33,2,37,4,4,16.5,0.0
81348,1383085,1000,20884,1000,22884,2000,1001,20.884,0.0
81353,2674104,1000,43366,1000,45366,2000,1001,43.366,0.0
81354,846027,1000,12000,1000,14000,2000,1001,12.0,0.0
81355,8143,5,125,5,135,10,6,25.0,0.0
81358,1140800,1000,16948,1000,18948,2000,1001,16.948,0.0
8136,6007,0,70,0,80,10,11,7.0,0.0
81365,1354141,1000,19896,1000,21896,2000,1001,19.896,0.0
81367,1374791,1000,20997,1000,22997,2000,1001,20.997,0.0
8137,3463,10,30,10,50,20,12,3.0,0.0
81370,1093014,1000,15480,1000,17480,2000,1001,15.48,0.0
81371,1332375,1000,21000,1000,23000,2000,1001,21.0,0.0
81372,1345536,1000,19970,1000,21970,2000,1001,19.97,0.0
81373,751950,628,11304,628,12560,1256,629,18.0,0.0
81374,123669,182,2119,182,2483,364,183,11.643,0.0
81375,650021,1000,7967,1000,9967,2000,1001,7.967,0.0
81376,1528316,1000,22012,1000,24012,2000,1001,22.012,0.0
81378,24802,30,347,30,407,60,31,11.567,0.0
81382,1336679,1000,20337,1000,22337,2000,1001,20.337,0.0
81383,834275,1000,11994,1000,13994,2000,1001,11.994,0.0
81384,1008018,770,15400,770,16940,1540,771,20.0,0.0
81385,1865676,1000,28999,1000,30999,2000,1001,28.999,0.0
81387,1335536,0,19917,0,20917,1000,1001,19.917,0.0
81389,1541251,1000,26000,1000,28000,2000,1001,26.0,0.0
81392,11476,8,160,8,176,16,9,20.0,0.0
81397,1168755,1000,17983,1000,19983,2000,1001,17.983,0.0
8140,51939,0,480,0,600,120,121,4.0,0.5
81400,1604467,1000,26000,1000,28000,2000,1001,26.0,0.0
81401,261598,1000,1000,1000,3000,2000,1001,1.0,0.0
81403,1364687,1000,21000,1000,23000,2000,1001,21.0,0.0
8141,228821,0,2500,0,3000,500,501,5.0,0.0
81413,1010050,1000,15705,1000,17705,2000,1001,15.705,0.0
81415,990116,1000,14527,1000,16527,2000,1001,14.527,0.0
81417,1067394,1000,16375,1000,18375,2000,1001,16.375,0.0
81418,1409003,0,21880,0,22880,1000,1001,21.88,0.0
8142,341741,1000,5000,1000,7000,2000,1002,5.0,0.0
81420,911950,1000,13707,1000,15707,2000,1001,13.707,0.0
81423,8143,5,125,5,135,10,6,25.0,0.0
8143,3723,0,28,0,35,7,8,4.0,0.0
81434,1332633,1000,19762,1000,21762,2000,1001,19.762,0.0
81437,917345,1000,13000,1000,15000,2000,1001,13.0,0.5
81438,1331196,1000,19985,1000,21985,2000,1001,19.985,0.0
8144,3813,7,28,7,42,14,8,4.0,0.5
81449,1389326,1000,20823,1000,22823,2000,1001,20.823,0.0
8145,343385,500,5000,500,6000,1000,501,10.0,0.0
8146,35128,62,372,62,496,124,63,6.0,0.0
81462,1340646,1000,19999,1000,21999,2000,1001,19.999,0.0
81466,1626618,1000,25997,1000,27997,2000,1001,25.997,0.0
8147,3338,5,30,5,45,15,12,3.0,0.0
81484,6572,6,90,6,102,12,7,15.0,0.0
8149,7025,6,96,6,114,18,14,8.0,0.0
8151,45139,124,491,124,739,248,126,3.96,0.0
8152,47628,0,662,0,712,50,51,13.24,0.0
8153,224761,0,2499,0,2999,500,501,4.998,0.0
81530,816922,1000,11916,1000,13916,2000,1001,11.916,0.0
8154,45982,46,666,46,758,92,47,14.478,0.0
81544,3913,10,30,10,50,20,11,3.0,0.0
81546,1359407,1000,21000,1000,23000,2000,1001,21.0,0.0
81552,1031362,970,14765,970,16705,1940,971,15.222,0.0
81558,1345209,1000,19999,1000,21999,2000,1001,19.999,0.0
81560,700225,523,10460,523,11506,1046,524,20.0,0.0
81561,1773851,1000,27000,1000,29000,2000,1001,27.0,0.0
81562,10106,37,37,37,111,74,38,1.0,0.0
81563,817085,1000,11916,1000,13916,2000,1001,11.916,0.0
81564,1421167,1000,20566,1000,22566,2000,1001,20.566,0.0
81565,3423,2,42,2,46,4,3,21.0,0.0
81566,257597,1000,1000,1000,3000,2000,1001,1.0,0.0
81567,1652048,1000,25880,1000,27880,2000,1001,25.88,0.0
81568,1385278,1000,20896,1000,22896,2000,1001,20.896,0.0
81569,4713,5,60,5,70,10,6,12.0,0.0
81570,1254400,1000,18939,1000,20939,2000,1001,18.939,0.0
81571,40369,45,653,45,743,90,46,14.511,0.0
81572,4366,7,42,7,56,14,8,6.0,0.0
81573,9346,17,85,17,119,34,18,5.0,0.0
81574,1127569,1000,16000,1000,18000,2000,1001,16.0,0.0
81575,1400673,1000,21090,1000,23090,2000,1001,21.09,0.0
81578,2315,5,15,5,25,10,6,3.0,0.0
81579,1655849,1000,26000,1000,28000,2000,1001,26.0,0.0
81583,1579895,1000,25995,1000,27995,2000,1001,25.995,0.0
81584,1093077,1000,16686,1000,18686,2000,1001,16.686,0.0
8159,828105,500,13446,500,14446,1000,501,26.892,0.0
81590,2744,6,18,6,30,12,7,3.0,0.0
81593,1012,1,3,1,5,2,2,3.0,0.0
81597,1041190,1000,15013,1000,17013,2000,1001,15.013,0.0
81598,40369,45,653,45,743,90,46,14.511,0.0
8160,436972,0,8426,0,8926,500,501,16.852,0.0
81600,7700,18,54,18,90,36,19,3.0,0.0
81602,1380189,1000,20886,1000,22886,2000,1001,20.886,0.0
81603,1371096,1000,21000,1000,23000,2000,1001,21.0,0.0
81605,1398969,1000,20991,1000,22991,2000,1001,20.991,0.0
81606,1147607,1000,16948,1000,18948,2000,1001,16.948,0.0
81608,257597,1000,1000,1000,3000,2000,1001,1.0,0.0
81609,1327361,1000,20000,1000,22000,2000,1001,20.0,0.0
8161,627022,500,8000,500,9000,1000,501,16.0,0.0
81611,1394555,1000,20979,1000,22979,2000,1001,20.979,0.0
81612,123669,182,2119,182,2483,364,183,11.643,0.0
81614,711814,535,10695,535,11765,1070,536,19.991,0.0
81618,703382,540,10800,540,11880,1080,541,20.0,0.0
81619,1084103,1000,15616,1000,17616,2000,1001,15.616,0.0
8162,8752,2,6,2,10,4,3,3.0,0.0
81620,1542207,1000,22978,1000,24978,2000,1001,22.978,0.0
81624,1389963,1000,20924,1000,22924,2000,1001,20.924,0.0
81625,1385929,1000,20924,1000,22924,2000,1001,20.924,0.0
81626,1310818,1000,19988,1000,21988,2000,1001,19.988,0.0
81629,1344647,1000,19999,1000,21999,2000,1001,19.999,0.0
8163,578463,0,6262,0,6762,500,501,12.524,0.5
81631,985560,1000,14000,1000,16000,2000,1001,14.0,0.0
81632,22644,34,306,34,374,68,35,9.0,0.0
81633,851108,1000,12000,1000,14000,2000,1001,12.0,0.0
81634,1220487,1000,17000,1000,19000,2000,1001,17.0,0.0
81635,1327451,1000,20000,1000,22000,2000,1001,20.0,0.0
81636,1626028,1000,25994,1000,27994,2000,1001,25.994,0.0
81638,6433,16,48,16,80,32,17,3.0,0.0
81639,1062460,1000,15193,1000,17193,2000,1001,15.193,0.0
81641,257597,1000,1000,1000,3000,2000,1001,1.0,0.0
81643,840119,1000,12000,1000,14000,2000,1001,12.0,0.0
81646,3606,7,28,7,42,14,8,4.0,0.0
81647,1375259,1000,20900,1000,22900,2000,1001,20.9,0.0
81648,1340436,1000,19996,1000,21996,2000,1001,19.996,0.0
8165,358943,500,5500,500,6500,1000,501,11.0,0.0
81650,1684404,1000,26950,1000,28950,2000,1001,26.95,0.0
81651,1071187,1000,15484,1000,17484,2000,1001,15.484,0.0
81653,1401922,1000,20988,1000,22988,2000,1001,20.988,0.0
81655,1060009,1000,15152,1000,17152,2000,1001,15.152,0.0
81657,37336,47,564,47,658,94,48,12.0,0.0
81658,686725,528,10557,528,11613,1056,529,19.994,0.0
81659,257597,1000,1000,1000,3000,2000,1001,1.0,0.0
8166,389120,0,4943,0,5443,500,501,9.886,0.0
81663,1034846,1000,16970,1000,18970,2000,1001,16.97,0.0
81665,1652249,1000,27000,1000,29000,2000,1001,27.0,0.0
81672,1385962,1000,20924,1000,22924,2000,1001,20.924,0.0
81674,10644,12,144,12,168,24,13,12.0,0.0
81677,1388423,1000,20888,1000,22888,2000,1001,20.888,0.0
81678,1036954,972,14797,972,16741,1944,973,15.223,0.0
81680,618736,1000,8000,1000,10000,2000,1001,8.0,0.0
81681,837837,1000,12000,1000,14000,2000,1001,12.0,0.0
81682,917,1,3,1,5,2,2,3.0,0.0
81683,3913,10,30,10,50,20,11,3.0,0.0
81685,1089784,1000,15684,1000,17684,2000,1001,15.684,0.0
8169,23144,56,280,56,392,112,58,5.0,0.0
81691,700009,550,10553,550,11653,1100,551,19.187,0.0
81692,1341695,1000,20000,1000,22000,2000,1001,20.0,0.0
81693,1388790,1000,20958,1000,22958,2000,1001,20.958,0.0
81694,1385455,1000,20832,1000,22832,2000,1001,20.832,0.0
81695,5335,14,42,14,70,28,15,3.0,0.0
81698,1324005,1000,18425,1000,20425,2000,1001,18.425,0.0
81699,598044,451,9020,451,9922,902,452,20.0,0.0
8170,8090,0,68,0,85,17,18,4.0,0.0
81701,3773,9,27,9,45,18,10,3.0,0.0
81705,763408,1000,11000,1000,13000,2000,1001,11.0,0.0
81708,9346,17,85,17,119,34,18,5.0,0.0
81709,1393512,1000,20942,1000,22942,2000,1001,20.942,0.0
81710,3767487,1000,64904,1000,66904,2000,1001,64.904,0.0
81717,257597,1000,1000,1000,3000,2000,1001,1.0,0.0
81719,1081884,1000,15576,1000,17576,2000,1001,15.576,0.0
8172,5888,0,54,0,60,6,7,9.0,0.0
81720,1389035,1000,20890,1000,22890,2000,1001,20.89,0.0
81722,592659,549,8449,549,9547,1098,550,15.39,0.0
81723,1328566,1000,20000,1000,22000,2000,1001,20.0,0.0
81725,967014,832,14419,832,16083,1664,833,17.331,0.0
81727,851108,1000,12000,1000,14000,2000,1001,12.0,0.0
81729,1033101,972,14797,972,16741,1944,973,15.223,0.0
8173,288029,250,3840,250,4340,500,251,15.36,0.0
81732,1399309,1000,20997,1000,22997,2000,1001,20.997,0.0
81735,257597,1000,1000,1000,3000,2000,1001,1.0,0.0
81737,996,1,3,1,5,2,2,3.0,0.0
81738,548585,442,8179,442,9063,884,443,18.505,0.0
81747,1327332,1000,20000,1000,22000,2000,1001,20.0,0.0
81749,2944378,1000,49329,1000,51329,2000,1001,49.329,0.0
81751,9335,34,34,34,102,68,35,1.0,0.0
81756,1394521,1000,21000,1000,23000,2000,1001,21.0,0.0
81758,387454,519,6803,519,7841,1038,520,13.108,0.0
8176,3931,5,40,5,55,15,12,4.0,0.0
81768,1542380,1000,22939,1000,24939,2000,1001,22.939,0.0
81769,1003377,1000,14000,1000,16000,2000,1001,14.0,0.0
81772,1086915,913,16226,913,18052,1826,914,17.772,0.0
81775,610277,1000,7000,1000,9000,2000,1001,7.0,0.0
8178,124904,143,1283,143,1712,429,288,4.518,0.0
81786,5510,6,66,6,78,12,7,11.0,0.0
8179,323657,500,4000,500,5000,1000,501,8.0,0.0
81793,961501,832,14419,832,16083,1664,833,17.331,0.0
81794,1056983,1000,15161,1000,17161,2000,1001,15.161,0.0
81799,1140800,1000,16948,1000,18948,2000,1001,16.948,0.0
81802,741085,1000,10916,1000,12916,2000,1001,10.916,0.0
81806,1427320,1000,20000,1000,22000,2000,1001,20.0,0.0
81807,1393537,1000,20892,1000,22892,2000,1001,20.892,0.0
81808,1333740,1000,19982,1000,21982,2000,1001,19.982,0.0
81809,1035432,975,14845,975,16795,1950,976,15.226,0.0
8181,4151,3,66,3,72,6,4,22.0,0.0
81810,4083,6,42,6,54,12,7,7.0,0.0
81812,525598,1000,6000,1000,8000,2000,1001,6.0,0.0
81813,4624,3,60,3,66,6,4,20.0,0.0
81816,151638,115,2300,115,2530,230,116,20.0,0.0
81818,45639,32,700,32,764,64,33,21.875,0.0
8182,236353,0,3096,0,3354,258,259,12.0,0.5
81822,1157729,1000,20000,1000,22000,2000,1001,20.0,0.0
81823,975545,1000,15973,1000,17973,2000,1001,15.973,0.0
81826,272144,448,3584,448,4480,896,449,8.0,0.0
81830,504494,378,7560,378,8316,756,379,20.0,0.0
81831,4863,10,40,10,60,20,11,4.0,0.0
81832,43684,99,598,99,796,198,100,6.04,0.0
81833,5098,3,66,3,72,6,4,22.0,0.0
81834,1036268,975,14845,975,16795,1950,976,15.226,0.0
81835,1327451,1000,20000,1000,22000,2000,1001,20.0,0.0
81836,1340452,1000,19995,1000,21995,2000,1001,19.995,0.0
81837,1329739,1000,19982,1000,21982,2000,1001,19.982,0.0
81838,20909,15,300,15,330,30,16,20.0,0.0
81840,257597,1000,1000,1000,3000,2000,1001,1.0,0.0
81842,1546201,1000,23000,1000,25000,2000,1001,23.0,0.0
81843,1971,4,12,4,20,8,5,3.0,0.0
81844,4938,11,31,11,53,22,12,2.818,0.0
81845,22551,34,306,34,374,68,35,9.0,0.0
81846,1060413,1000,15238,1000,17238,2000,1001,15.238,0.0
81849,527129,1000,7000,1000,9000,2000,1001,7.0,0.0
8185,658244,1000,14000,1000,16000,2000,1002,14.014,0.0
81850,26040,99,99,99,297,198,100,1.0,0.0
81851,173180,129,2580,129,2838,258,130,20.0,0.0
81852,1037628,976,14890,976,16842,1952,977,15.256,0.0
81853,133980,519,519,519,1557,1038,520,1.0,0.0
81854,1381236,1000,20999,1000,22999,2000,1001,20.999,0.0
81855,257597,1000,1000,1000,3000,2000,1001,1.0,0.0
81856,1154800,1000,15985,1000,18985,3000,1002,15.985,0.0
81857,257597,1000,1000,1000,3000,2000,1001,1.0,0.0
81858,1389699,1000,20973,1000,22973,2000,1001,20.973,0.0
81859,727366,1000,12000,1000,14000,2000,1001,12.0,0.0
8186,5024,16,48,16,80,32,18,3.0,0.0
81860,39973,75,450,75,600,150,76,6.0,0.0
81861,9592,35,35,35,105,70,36,1.0,0.0
81863,257597,1000,1000,1000,3000,2000,1001,1.0,0.0
81864,5037,10,20,10,40,20,11,2.0,0.0
81865,1393834,1000,20976,1000,22976,2000,1001,20.976,0.0
81867,23299,35,315,35,385,70,36,9.0,0.0
81869,978126,1000,13000,1000,15000,2000,1001,13.0,0.0
8187,8230,0,72,0,90,18,19,4.0,0.5
8188,11101,14,126,14,168,42,30,4.5,0.0
819,3052,0,21,0,28,7,8,3.0,0.0
8190,153248,0,2116,0,2208,92,93,23.0,0.0
81900,17160,0,135,0,180,45,46,3.0,0.0
8191,241014,364,4004,364,4732,728,365,11.0,0.0
8192,274509,0,3761,0,3835,74,75,50.824,0.0
8193,1685882,0,47265,0,47765,500,501,94.53,0.5
8194,13787,33,99,33,165,66,34,3.0,0.0
8195,364659,500,5999,500,6999,1000,501,11.998,0.0
8196,346613,0,5500,0,6000,500,501,11.0,0.0
8197,2789670,0,54994,0,55494,500,501,109.988,0.0
8198,1794901,0,22983,0,23483,500,501,45.966,0.0
8199,3450,3,45,3,51,6,4,15.0,0.0
82,609106,1088,3675,1088,5827,2152,1090,3.378,0.0
8200,18269,0,210,0,245,35,36,6.0,0.0
8201,959066,0,12458,0,12958,500,501,24.916,0.0
8202,276843,0,3500,0,4000,500,501,7.0,0.0
8203,291334,0,5000,0,5500,500,501,10.0,0.0
8204,362318,0,5000,0,5500,500,501,10.0,0.0
8205,1385504,0,33019,0,33519,500,501,66.038,0.0
8207,78447,0,1455,0,1548,93,94,15.645,0.0
8208,309388,500,4000,500,5000,1000,501,8.0,0.0
8209,261470,0,2910,0,3410,500,501,5.82,0.0
8210,174065,0,2485,0,2594,109,110,22.798,0.0
8211,225428,272,2739,272,3283,544,273,10.07,0.0
8212,1392461,0,19420,0,19920,500,501,38.84,0.0
8213,309773,0,3000,0,3500,500,501,6.0,0.0
8214,1787836,500,22491,500,23991,1500,1002,22.491,0.0
8215,3536,3,45,3,51,6,4,15.0,0.0
8216,83482,0,1008,0,1120,112,113,9.0,0.0
8217,323050,0,4500,0,5000,500,501,9.0,0.0
8218,398654,0,5464,0,5964,500,501,10.928,0.0
8219,24132,0,390,0,416,26,27,15.0,0.0
8220,511463,0,7000,0,7500,500,501,14.0,0.0
8221,3783,0,40,0,45,5,6,8.0,0.0
8222,57099,0,501,0,629,128,129,3.914,0.0
8223,175518,0,3136,0,3332,196,197,16.0,0.5
8225,284292,0,5000,0,5500,500,501,10.0,0.0
8226,881224,500,12424,500,13424,1000,501,24.848,0.5
8227,933692,500,20000,500,21000,1000,501,40.0,1.0
8228,761377,0,14358,0,14858,500,501,28.716,0.0
8229,333396,0,4000,0,4500,500,501,8.0,0.0
823,1104657,425,6197,425,7047,850,426,14.581,0.0
8231,505882,0,7720,0,8220,500,501,15.44,0.0
8233,392213,500,6518,500,7518,1000,501,13.036,0.0
8234,57648,0,870,0,933,63,64,13.81,0.0
8235,148872,0,1464,0,1708,244,245,6.0,0.8333333333333334
8236,123934,0,1554,0,1776,222,223,7.0,0.0
8237,557711,0,12480,0,12672,192,193,65.0,0.0
8238,92876,0,1170,0,1235,65,66,18.0,0.0
8239,247293,282,2646,282,3210,564,283,9.383,0.5
824,1799,0,12,0,15,3,4,4.0,0.0
8242,873615,0,13884,0,14384,500,501,27.768,0.0
8243,267481,0,3500,0,4000,500,501,7.0,0.0
8245,364063,0,6000,0,6500,500,501,12.0,0.0
8247,563092,0,10000,0,10500,500,501,20.0,0.0
8248,769264,0,6500,0,7000,500,501,13.0,0.0
8249,246255,278,2803,278,3359,556,279,10.083,0.0
8250,2068685,1303,23890,1303,26936,3046,1745,13.706,0.0
8251,182809,0,2248,0,2448,200,201,11.24,0.5
8253,195508,0,1915,0,2415,500,501,3.83,0.0
8254,625544,0,15000,0,15500,500,501,30.0,0.0
8255,250406,378,2646,378,3402,756,379,7.0,0.0
8256,320381,0,4537,0,5037,500,501,9.074,0.75
8257,159444,0,2902,0,3010,108,109,26.87,0.0
8258,147038,320,1600,320,2240,640,321,5.0,0.0
8259,688862,0,12502,0,13002,500,501,25.004,0.0
8260,159989,265,1590,265,2120,530,266,6.0,1.0
8261,1308243,0,11500,0,12000,500,501,23.0,0.0
8262,372467,0,5000,0,5500,500,501,10.0,0.0
8263,469050,500,7372,500,8372,1000,501,14.744,0.75
8264,3910,0,30,0,36,6,7,5.0,0.0
8265,376470,0,5280,0,5500,220,221,24.0,0.0
8266,145413,0,1661,0,1940,279,280,5.953,1.0
8267,383116,0,5000,0,5500,500,501,10.0,0.0
8268,889019,0,17049,0,17549,500,501,34.098,0.0
8269,2644347,1499,29308,1499,32806,3498,2001,14.661,0.0
8270,28212,0,252,0,327,75,76,3.36,0.0
8271,118142,164,1476,164,1804,328,165,9.0,1.0
8272,1859937,500,38500,500,39500,1000,501,77.0,0.0
8273,366660,0,7140,0,7560,420,421,17.0,0.0
8275,15107,0,140,0,175,35,36,4.0,0.0
8276,3769,0,33,0,39,6,7,5.5,0.0
8277,1586235,500,40844,500,41844,1000,501,81.688,0.0
8278,620594,0,14000,0,14500,500,501,28.0,0.0
8280,463045,0,8500,0,9000,500,501,17.0,0.0
8281,163182,200,2249,200,2649,400,201,11.245,0.5
8282,11958,0,127,0,148,21,22,6.048,1.0
8283,101708,0,1380,0,1518,138,139,10.0,0.0
8284,979633,0,20000,0,20500,500,501,40.0,0.75
8285,644637,0,15073,0,15573,500,501,30.146,0.0
8286,460177,0,6500,0,7000,500,501,13.0,0.0
8287,202179,0,4080,0,4128,48,49,85.0,0.0
8288,900918,500,3500,500,4500,1000,501,7.0,0.0
8289,457332,0,8500,0,9000,500,501,17.0,0.0
8290,3704983,1488,37936,1488,41412,3476,1990,19.082,0.0
8291,100177,0,810,0,931,121,122,6.694,0.5
8292,641615,0,11548,0,12048,500,501,23.096,0.0
8293,30697,0,560,0,588,28,29,20.0,0.0
8294,77935,0,1080,0,1215,135,136,8.0,0.0
8295,210469,0,2000,0,2500,500,501,4.0,0.0
8296,101666,0,1421,0,1624,203,204,7.0,0.5
8297,110383,0,1066,0,1236,170,171,6.271,0.0
8298,501940,0,7700,0,8200,500,501,15.4,0.0
8299,686997,0,9960,0,10460,500,501,19.92,0.0
83,11160250,9042,31458,9042,87621,56163,12762,10.794,0.0
8300,108221,0,1674,0,1860,186,187,9.0,0.0
8301,566851,0,10761,0,11261,500,501,21.522,0.0
8302,186927,0,1816,0,1842,26,27,69.846,0.0
8303,591123,500,7628,500,8628,1000,501,15.256,1.0
8304,444897,0,8420,0,8920,500,501,16.84,0.5
8305,64461,0,378,0,441,63,64,6.0,0.8333333333333334
8306,489393,0,6000,0,6500,500,501,12.0,0.0
8307,10544,26,104,26,156,52,27,4.0,0.0
8308,371576,0,7276,0,7776,500,501,14.552,0.0
8309,320134,0,4500,0,5000,500,501,9.0,0.0
8311,62939,33,792,33,858,66,34,24.0,0.0
8312,170997,0,4261,0,4361,100,101,42.61,0.0
8313,9835,0,189,0,194,5,6,37.8,0.0
8314,44274,108,540,108,756,216,109,5.0,0.0
8315,376780,0,5500,0,6000,500,501,11.0,0.0
8317,55908,0,540,0,675,135,136,4.0,0.0
8318,12638,0,144,0,162,18,19,8.0,0.0
8319,819459,0,11992,0,12492,500,501,23.984,0.0
8320,88233,0,1568,0,1666,98,99,16.0,0.0
8322,277065,0,3500,0,4000,500,501,7.0,0.0
8323,45032,74,704,74,852,148,75,9.514,0.0
8324,343677,0,5028,0,5528,500,501,10.056,0.0
8325,10943,0,87,0,116,29,30,3.0,0.0
8328,86628,0,1222,0,1248,26,27,47.0,0.0
8329,21844,0,255,0,306,51,52,5.0,0.0
833,265602,0,5000,0,5500,500,501,10.0,0.0
8330,149926,0,1446,0,1687,241,242,6.0,1.0
8332,307377,0,4000,0,4500,500,501,8.0,0.0
8333,678901,0,12146,0,12646,500,501,24.292,0.0
8334,466649,0,4000,0,4500,500,501,8.0,0.0
8335,50084,0,975,0,1000,25,26,39.0,0.75
8336,419986,0,5500,0,6000,500,501,11.0,0.0
8337,425700,500,6500,500,7500,1000,501,13.0,0.5
8339,589104,0,9836,0,10336,500,501,19.672,0.0
8340,175687,0,3136,0,3332,196,197,16.0,0.0
8341,75916,0,800,0,960,160,161,5.0,0.0
8342,774838,0,5500,0,6000,500,501,11.0,0.0
8343,3101747,0,36772,0,37207,435,436,84.533,0.6666666666666666
8344,446297,500,7000,500,8000,1000,501,14.0,1.0
8345,1650492,0,17921,0,18344,423,424,42.366,0.0
8346,72349,0,873,0,970,97,98,9.0,0.0
8347,455157,0,8330,0,8820,490,491,17.0,0.0
8348,5937,0,72,0,84,12,13,6.0,0.0
8349,535525,500,9500,500,10500,1000,501,19.0,0.0
8350,220467,0,2490,0,2990,500,501,4.98,0.0
8351,253656,0,2740,0,3240,500,501,5.48,0.0
8352,512090,0,7500,0,8000,500,501,15.0,0.0
8354,10538,16,128,16,160,32,17,8.0,0.5
8355,440440,0,7298,0,7798,500,501,14.596,0.0
8356,420918,0,7559,0,8059,500,501,15.118,0.0
8357,76235,0,912,0,1064,152,153,6.0,0.0
8358,1366151,0,20982,0,21482,500,501,41.964,0.0
8359,88908,0,936,0,960,24,25,39.0,0.0
8360,1137173,0,3000,0,3500,500,501,6.0,0.0
8361,296773,0,4212,0,4680,468,469,9.0,0.0
8362,300321,0,4000,0,4500,500,501,8.0,0.0
8364,524008,0,10128,0,10628,500,501,20.256,0.0
8365,357776,0,5407,0,5907,500,501,10.814,1.0
8366,5298,6,48,6,66,18,14,4.0,0.0
8367,515121,0,8000,0,8500,500,501,16.0,0.0
8368,51000,45,859,45,949,90,46,19.089,1.0
8370,971028,0,17866,0,18366,500,501,35.732,0.0
8371,124984,0,1386,0,1617,231,232,6.0,0.0
8372,54345,66,815,66,947,132,67,12.348,0.5
8373,5752,0,90,0,95,5,6,18.0,0.0
8375,1075262,0,9500,0,10000,500,501,19.0,0.0
8376,424667,500,8500,500,9500,1000,501,17.0,0.0
8377,120188,0,924,0,1232,308,309,3.0,0.0
8379,326996,500,4000,500,5000,1000,501,8.0,0.0
8380,688161,500,9864,500,10864,1000,501,19.728,0.0
8381,284003,0,4000,0,4500,500,501,8.0,0.0
8382,247598,0,4000,0,4500,500,501,8.0,0.0
8385,431326,500,5500,500,6500,1000,501,11.0,0.0
8386,618705,0,8500,0,9000,500,501,17.0,0.0
8387,180758,77,2456,77,2610,154,78,31.896,0.0
8388,1630719,500,22438,500,23438,1000,501,44.876,0.0
8391,687295,0,9948,0,10448,500,501,19.896,0.0
8392,247803,0,3000,0,3500,500,501,6.0,1.0
8393,508459,500,6933,500,7933,1000,501,13.866,1.0
8394,432894,0,8500,0,9000,500,501,17.0,0.0
8395,23206,0,507,0,519,12,13,42.25,0.0
8397,128670,0,1575,0,1800,225,226,7.0,0.0
8398,447916,0,8428,0,8928,500,501,16.856,0.5
8399,147625,0,996,0,1491,495,496,4.0,0.5
840,393243,0,6000,0,6500,500,501,12.0,0.0
8400,47068,0,560,0,616,56,57,10.0,0.0
8401,37812,47,638,47,732,94,48,13.574,0.0
8402,136922,378,1134,378,1890,756,379,3.0,0.0
8403,463200,339,7615,339,8293,678,340,22.463,0.5
8404,487265,500,7500,500,8500,1000,501,15.0,0.0
8405,490577,500,7485,500,8485,1000,501,14.97,0.0
8407,489644,0,7500,0,8000,500,501,15.0,0.0
8408,404038,500,7500,500,8500,1000,501,15.0,0.0
8409,497264,0,7471,0,7971,500,501,14.942,0.0
8410,492832,0,7500,0,8000,500,501,15.0,0.0
8413,3461,0,27,0,34,7,8,3.857,0.0
8414,420739,0,6000,0,6500,500,501,12.0,0.0
8415,236695,0,3496,0,3933,437,438,8.0,0.0
8417,246208,0,1967,0,2248,281,282,7.0,0.0
8418,27535,67,335,67,469,134,69,5.0,0.0
8419,834521,500,13352,500,14352,1000,502,26.704,0.0
8421,38634,0,359,0,480,121,122,2.967,0.0
8422,44435,0,688,0,764,76,77,9.053,0.0
8424,102109,0,820,0,878,58,59,14.138,0.0
8425,404734,0,2455,0,2762,307,308,7.997,0.0
8426,5999,11,73,11,95,22,13,6.636,0.0
8427,99714,0,1729,0,1818,89,90,19.427,0.0
8429,419042,500,6000,500,7000,1000,501,12.0,0.0
8430,237856,0,2500,0,3000,500,501,5.0,0.0
8432,70997,0,1344,0,1428,84,85,16.0,0.0
8433,64931,0,1133,0,1236,103,104,11.0,0.0
8434,44559,0,496,0,558,62,63,8.0,0.0
8435,13738,0,160,0,180,20,21,8.0,0.0
8436,446929,0,7000,0,7500,500,501,14.0,0.0
8437,227003,0,2500,0,2554,54,55,46.296,0.0
8438,34650,0,320,0,400,80,81,4.0,0.0
8441,646656,500,8439,500,9439,1000,501,16.878,0.0
8442,320094,0,4500,0,5000,500,501,9.0,0.0
8443,682796,500,12673,500,13673,1000,501,25.346,0.0
8444,122084,0,1476,0,1640,164,165,9.0,0.0
8445,1204958,0,12000,0,12500,500,501,24.0,0.0
8446,44343,0,485,0,582,97,98,5.0,0.0
8447,23882,0,342,0,377,35,36,9.771,0.0
8448,810570,0,12898,0,13398,500,501,25.796,0.0
8449,1716608,0,21499,0,21999,500,501,42.998,0.5
845,27652,0,270,0,324,54,55,5.0,0.0
8450,485798,0,7807,0,8253,446,447,17.504,1.0
8451,15995,0,66,0,88,22,23,3.0,0.0
8452,88341,0,1062,0,1180,118,119,9.0,0.0
8453,131247,0,630,0,756,126,127,5.0,1.0
8454,44790,0,462,0,527,65,66,7.108,1.0
8455,19797,0,156,0,182,26,27,6.0,0.0
8456,45659,0,1036,0,1078,42,43,24.667,0.0
8457,285040,0,3000,0,3500,500,501,6.0,0.0
8458,70868,0,1344,0,1428,84,85,16.0,0.0
8459,118557,0,1890,0,2025,135,136,14.0,0.0
8460,14355,0,132,0,165,33,34,4.0,0.0
8461,346199,0,2500,0,3000,500,501,5.0,0.0
8462,160071,59,2148,59,2266,118,60,36.407,0.0
8463,364328,500,5000,500,6000,1000,501,10.0,0.0
8464,1970357,0,56496,0,56996,500,501,112.992,0.0
8465,186261,0,2000,0,2500,500,501,4.0,0.0
8467,447098,0,8426,0,8926,500,501,16.852,0.0
8468,496037,0,6579,0,7079,500,501,13.158,0.0
8469,747945,0,14000,0,14500,500,501,28.0,0.0
8470,483162,0,7145,0,7645,500,501,14.29,0.0
8471,14179,0,174,0,204,30,31,5.8,0.0
8472,2665956,0,55082,0,55582,500,501,110.164,0.0
8473,404504,0,6000,0,6500,500,501,12.0,0.0
8474,547863,0,9987,0,10487,500,501,19.974,0.0
8475,869302,0,10464,0,10964,500,501,20.928,0.5
8477,412335,0,8264,0,8764,500,501,16.528,0.0
8479,121570,0,2038,0,2250,212,171,17.877,0.75
848,10507,26,78,26,130,52,27,3.0,0.0
8480,31342,0,495,0,519,24,25,20.625,0.0
8481,164631,0,2529,0,2810,281,282,9.0,1.0
8483,21616,48,288,48,384,96,49,6.0,0.0
8484,98134,0,1642,0,1721,79,80,20.785,0.0
8485,304670,0,4000,0,4500,500,501,8.0,0.0
8486,497488,0,7168,0,7605,437,438,16.403,0.0
8487,948601,0,14835,0,15335,500,501,29.67,0.0
8488,609605,0,11146,0,11646,500,501,22.292,0.0
8489,885687,0,14500,0,15000,500,501,29.0,0.0
8490,552502,500,8518,500,9518,1000,501,17.036,0.0
8491,192799,0,3696,0,3927,231,232,16.0,1.0
8493,22755,0,179,0,217,38,39,4.711,0.0
8494,7695,0,77,0,92,15,16,5.133,0.0
8496,81151,0,952,0,1071,119,120,8.0,0.0
8497,458116,0,8500,0,9000,500,501,17.0,0.5
8498,290136,500,3578,500,4578,1000,501,7.156,0.0
8499,206335,0,1758,0,1955,197,198,8.924,0.0
8500,25290,42,294,42,378,84,43,7.0,0.0
8501,207193,500,2500,500,3500,1000,501,5.0,0.0
8502,1498006,0,16408,0,16761,353,354,46.482,0.0
8503,91215,0,1200,0,1260,60,61,20.0,0.0
8504,332533,0,4000,0,4500,500,501,8.0,0.5
8505,349003,0,3400,0,3740,340,341,10.0,0.0
8506,438763,0,5500,0,6000,500,501,11.0,0.0
8507,2966151,0,36406,0,36846,440,441,82.741,0.5
8509,5054,0,44,0,55,11,12,4.0,0.0
8510,387788,0,7706,0,8206,500,501,15.412,0.0
8511,409623,500,8000,500,9000,1000,501,16.0,0.0
8512,1287028,0,9942,0,10402,460,461,21.613,0.0
8513,291467,0,5000,0,5500,500,501,10.0,0.0
8514,297506,0,4000,0,4500,500,501,8.0,0.0
8515,373113,0,5280,0,5500,220,221,24.0,0.0
8516,763832,0,12628,0,13128,500,501,25.256,1.0
8517,478091,500,8352,500,9352,1000,501,16.704,0.0
8518,834719,500,14000,500,15000,1000,501,28.0,0.0
8519,518030,500,9000,500,10000,1000,501,18.0,0.0
8520,321936,0,4500,0,5000,500,501,9.0,0.0
8521,248181,0,3000,0,3500,500,501,6.0,0.0
8523,301064,0,4000,0,4500,500,501,8.0,0.0
8524,13419477,0,115500,0,116000,500,501,231.0,0.0
8525,100975,240,1200,240,1680,480,241,5.0,0.0
8526,17096,0,260,0,280,20,21,13.0,0.0
8527,505562,0,6500,0,7000,500,501,13.0,0.0
8528,11729,0,114,0,133,19,20,6.0,0.0
8529,624657,0,7251,0,7751,500,501,14.502,1.0
8530,881177,0,6500,0,7000,500,501,13.0,0.0
8531,569834,0,10491,0,10991,500,501,20.982,0.0
8532,2633636,1476,28884,1476,32336,3452,1978,14.617,0.0
8533,146078,0,1324,0,1536,212,213,6.245,0.0
8534,26689,37,444,37,518,74,38,12.0,0.0
8535,200034,0,2112,0,2612,500,501,4.224,0.0
8536,318934,368,5686,368,6422,736,369,15.451,0.0
8537,168882,200,2241,200,2641,400,201,11.205,0.0
8538,37923,0,506,0,529,23,24,22.0,0.0
8539,59009,0,940,0,995,55,56,17.091,0.0
8540,589578,0,7500,0,8000,500,501,15.0,0.0
8542,635158,0,8527,0,9027,500,501,17.054,0.0
8543,17585,0,135,0,162,27,28,5.0,0.0
8544,675256,0,10874,0,11374,500,501,21.748,0.0
8545,3218031,0,37396,0,37823,427,428,87.578,0.5
8546,88234,0,1134,0,1296,162,163,7.0,0.0
8547,751161,0,12749,0,13249,500,501,25.498,0.0
8548,5743130,0,90905,0,91379,474,475,191.783,0.5
8549,987559,0,22909,0,23409,500,501,45.818,0.0
8550,840822,0,13627,0,14127,500,501,27.254,1.0
8551,229954,0,3930,0,4323,393,394,10.0,0.0
8552,287314,0,5036,0,5334,298,299,16.899,0.0
8554,32571,80,320,80,480,160,81,4.0,0.0
8555,154534,0,1542,0,1754,212,213,7.274,0.0
85572,36365,130,130,130,390,260,131,1.0,0.0
85573,13815,48,48,48,144,96,49,1.0,0.0
8558,695864,0,9988,0,10488,500,501,19.976,0.0
85595,1990,5,5,5,15,10,6,1.0,0.0
85596,3230,5,24,5,34,10,6,4.8,0.0
8560,307289,0,5500,0,6000,500,501,11.0,0.0
85602,4740,15,15,15,45,30,16,1.0,0.0
85603,2265,6,6,6,18,12,7,1.0,0.0
85606,21070,48,192,48,288,96,49,4.0,0.0
85609,1440,3,3,3,9,6,4,1.0,0.0
8561,289569,500,3000,500,4000,1000,501,6.0,0.0
85610,11404,12,132,12,156,24,13,11.0,0.0
85613,43024,152,152,152,456,304,153,1.0,0.0
85614,4190,13,13,13,39,26,14,1.0,0.0
85616,4318,7,49,7,63,14,8,7.0,0.0
85618,3365,10,10,10,30,20,11,1.0,0.0
8562,29874,0,474,0,497,23,24,20.609,0.0
85620,2006,3,15,3,21,6,4,5.0,0.0
85621,15190,53,53,53,159,106,54,1.0,0.0
85622,2265,6,6,6,18,12,7,1.0,0.0
85623,3127,9,9,9,27,18,10,1.0,0.0
85627,3205,7,21,7,35,14,8,3.0,0.0
8563,26100,0,240,0,294,54,55,4.444,0.0
85631,2636,4,28,4,36,8,5,7.0,0.0
85637,4522,14,14,14,42,28,15,1.0,0.0
85638,5823,7,56,7,70,14,8,8.0,0.0
8564,430829,0,8500,0,9000,500,501,17.0,0.0
85644,5369,10,50,10,70,20,11,5.0,0.0
85646,1440,3,3,3,9,6,4,1.0,0.0
85647,21262,74,74,74,222,148,75,1.0,0.0
8565,189521,0,2714,0,2773,59,60,46.0,0.0
85653,2011,5,5,5,15,10,6,1.0,0.0
85654,1732,4,4,4,12,8,5,1.0,0.0
85655,3640,11,11,11,33,22,12,1.0,0.0
85657,1990,5,5,5,15,10,6,1.0,0.0
8566,781263,500,13967,500,14967,1000,501,27.934,0.0
85660,3318,6,24,6,36,12,7,4.0,0.0
85661,3786,6,42,6,54,12,7,7.0,0.0
85664,3685,11,11,11,33,22,12,1.0,0.0
85665,3365,10,10,10,30,20,11,1.0,0.0
85666,1794,3,9,3,15,6,4,3.0,0.0
85667,1174,2,2,2,6,4,3,1.0,0.0
85672,2100,4,12,4,20,8,5,3.0,0.0
85678,3365,10,10,10,30,20,11,1.0,0.0
8570,309797,0,4500,0,5000,500,501,9.0,0.0
8572,306484,0,5500,0,6000,500,501,11.0,0.0
8574,280918,0,4500,0,5000,500,501,9.0,0.0
8575,369150,0,6344,0,6844,500,501,12.688,0.0
8577,404953,0,4241,0,4443,202,203,20.995,0.0
8578,4366,0,57,0,63,6,7,9.5,0.0
8579,49340,0,657,0,722,65,66,10.108,0.5
8580,26272,0,367,0,383,16,17,22.938,0.0
8581,1798953,0,22999,0,23499,500,501,45.998,0.0
8583,236289,0,2500,0,3000,500,501,5.0,0.0
8585,536635,0,8444,0,8944,500,501,16.888,0.0
8586,72634,0,1008,0,1152,144,145,7.0,0.0
8587,1102491,500,11518,500,12518,1000,501,23.036,0.0
8588,1006290,0,17651,0,18151,500,501,35.302,0.0
8589,582775,0,6976,0,7412,436,437,16.0,0.0
8590,229224,0,1835,0,2202,367,368,5.0,0.0
8591,29613,0,259,0,296,37,38,7.0,0.0
8592,275397,0,3500,0,4000,500,501,7.0,0.0
8593,252104,500,4000,500,5000,1000,501,8.0,0.0
8594,432477,0,8500,0,9000,500,501,17.0,0.0
8595,38925,0,531,0,590,59,60,9.0,0.0
8598,427994,0,5500,0,6000,500,501,11.0,0.0
8599,427994,0,5500,0,6000,500,501,11.0,0.0
8600,545255,0,8996,0,9496,500,501,17.992,0.5
8601,276810,0,3500,0,4000,500,501,7.0,0.0
8602,602579,500,9768,500,10768,1000,501,19.536,0.0
8604,288473,0,3000,0,3500,500,501,6.0,0.0
8605,468476,0,8500,0,9000,500,501,17.0,0.0
8606,47033,50,750,50,850,100,51,15.0,0.0
8608,9368,0,138,0,144,6,7,23.0,0.0
8610,210543,500,2000,500,3000,1000,501,4.0,0.0
8611,257183,266,3190,266,3722,532,267,11.992,0.6666666666666666
8612,252508,0,4000,0,4500,500,501,8.0,1.0
8614,20233,0,179,0,226,47,48,3.809,0.0
8615,13681857,0,119000,0,119500,500,501,238.0,0.0
86157,1178520,0,18000,0,19000,1000,1001,18.0,0.0
86159,80983,117,794,117,1028,234,118,6.786,0.0
8616,358057,0,4491,0,4990,499,500,9.0,0.0
86160,869316,1000,14000,1000,17000,3000,2002,7.0,0.0
86162,869316,1000,14000,1000,17000,3000,2002,7.0,0.0
86165,704903,633,9547,633,11446,1899,1268,7.541,0.0
86166,24927,39,312,39,390,78,40,8.0,0.5
8617,205942,0,2000,0,2500,500,501,4.0,0.0
86170,708702,1266,9547,1266,12079,2532,1268,7.541,0.0
86172,221126,0,3168,0,3432,264,265,12.0,0.0
86176,301996,361,4720,361,5816,1096,737,6.422,0.0
86180,139486,154,2001,154,2463,462,310,6.497,0.0
86183,14064,0,112,0,150,38,39,2.947,0.0
86188,2112,3,18,3,24,6,4,6.0,0.0
86190,5204,9,54,9,72,18,10,6.0,0.0
86191,946544,1000,16299,1000,18299,2000,1001,16.299,0.0
86193,5238,9,54,9,72,18,10,6.0,0.0
86195,4492,8,48,8,64,16,9,6.0,0.0
86197,19978,60,180,60,300,120,61,3.0,0.0
86198,5184,9,54,9,72,18,10,6.0,0.0
8620,6157,0,60,0,75,15,16,4.0,0.0
86200,3654,6,36,6,48,12,7,6.0,0.0
86201,5268,9,54,9,72,18,10,6.0,0.0
86202,18861,36,216,36,288,72,37,6.0,0.0
86204,979817,1000,16652,1000,18652,2000,1001,16.652,0.0
86208,243580,1000,1000,1000,3000,2000,1001,1.0,0.0
86209,243580,1000,1000,1000,3000,2000,1001,1.0,0.0
8621,11431,23,138,23,184,46,24,6.0,0.0
86210,28542,117,117,117,351,234,118,1.0,0.0
86213,239579,1000,1000,1000,3000,2000,1001,1.0,0.0
86217,239579,1000,1000,1000,3000,2000,1001,1.0,0.0
86218,947179,1000,16436,1000,18436,2000,1001,16.436,0.0
8622,84759,40,1177,40,1257,80,41,29.425,0.0
86220,239579,1000,1000,1000,3000,2000,1001,1.0,0.0
86221,243580,1000,1000,1000,3000,2000,1001,1.0,0.0
86226,3925,14,14,14,42,28,15,1.0,0.0
86228,239579,1000,1000,1000,3000,2000,1001,1.0,0.0
86229,239579,1000,1000,1000,3000,2000,1001,1.0,0.0
86231,16831,68,68,68,204,136,69,1.0,0.0
86232,60416,1,4,1,6,2,2,4.0,0.0
86236,14082,1,4,1,6,2,2,4.0,0.0
86237,1234637,1000,19000,1000,21000,2000,1001,19.0,0.0
8624,405466,0,8035,0,8535,500,501,16.07,0.0
86248,7753,12,109,12,133,24,13,9.083,0.0
8625,429050,0,8500,0,9000,500,501,17.0,0.0
86253,20841,30,240,30,300,60,31,8.0,0.5
8626,363481,0,7140,0,7560,420,421,17.0,0.0
86265,4470,0,36,0,48,12,13,3.0,1.0
8627,492250,0,7490,0,7990,500,501,14.98,0.0
86278,877509,0,13000,0,14000,1000,1001,13.0,0.6666666666666666
8628,486850,0,7500,0,8000,500,501,15.0,0.0
86287,919384,0,14000,0,15000,1000,1001,14.0,0.0
86288,1024639,0,16000,0,17000,1000,1001,16.0,0.5
8629,319668,0,5048,0,5548,500,501,10.096,0.0
86293,1054465,0,15994,0,16994,1000,1001,15.994,0.0
86295,403143,1000,5000,1000,7000,2000,1001,5.0,0.0
86297,903579,0,12986,0,13986,1000,1001,12.986,1.0
86299,357556,1000,4000,1000,6000,2000,1001,4.0,0.0
86305,48063,0,505,0,606,101,102,5.0,0.0
8631,488055,500,7500,500,8500,1000,501,15.0,0.0
86314,881590,0,13994,0,14994,1000,1001,13.994,0.5
86318,1061751,0,16000,0,17000,1000,1001,16.0,0.0
86319,115286,0,1782,0,1944,162,163,11.0,0.0
8632,488265,500,7500,500,8500,1000,501,15.0,0.0
86321,799111,1000,12000,1000,14000,2000,1001,12.0,0.0
86324,843686,0,12991,0,13991,1000,1001,12.991,0.5
86327,932055,0,13924,0,14924,1000,1001,13.924,0.0
86328,46762,98,490,98,686,196,99,5.0,0.0
86329,416526,0,5000,0,6000,1000,1001,5.0,0.0
8633,489560,500,7471,500,8471,1000,501,14.942,0.0
8634,481664,480,8073,480,9533,1460,982,8.238,0.0
86342,871349,1000,13033,1000,15033,2000,1001,13.033,0.5
86356,893496,0,13000,0,14000,1000,1001,13.0,0.0
8636,1236455,500,20766,500,21766,1000,502,41.532,0.0
86371,85282,103,1236,103,1442,206,104,12.0,0.0
86374,87340,103,1339,103,1545,206,104,13.0,0.0
86378,1200215,2000,20000,2000,24000,4000,2002,10.0,0.0
8638,2157013,221,663,221,1105,442,223,3.0,0.0
86382,937037,1000,15000,1000,17000,2000,1001,15.0,0.5
86383,1070327,1000,16000,1000,18000,2000,1001,16.0,0.0
86389,13921,40,80,40,160,80,41,2.0,0.0
8640,355897,0,4500,0,5000,500,501,9.0,0.0
8641,446121,0,2992,0,3366,374,375,8.0,0.0
86413,917057,1000,15000,1000,17000,2000,1001,15.0,0.0
86417,987677,1000,15000,1000,17000,2000,1001,15.0,0.0
86418,88553,206,1339,206,1751,412,208,6.5,0.0
86419,94604,103,1339,103,1648,309,208,6.5,1.0
8642,5963,7,105,7,119,14,9,15.0,0.0
86421,88968,206,1339,206,1751,412,208,6.5,0.0
86427,201890,206,3078,206,3490,412,207,14.942,0.0
86429,938831,2000,14000,2000,18000,4000,2002,7.0,0.0
86431,930917,1000,15000,1000,17000,2000,1001,15.0,0.0
86433,847629,1000,13000,1000,15000,2000,1001,13.0,0.0
86434,578289,721,9373,721,10815,1442,722,13.0,0.0
86435,791139,824,12360,824,14008,1648,825,15.0,0.0
86438,2482,6,12,6,24,12,7,2.0,0.0
86440,863406,1000,13000,1000,15000,2000,1001,13.0,0.0
86447,257594,1000,1000,1000,3000,2000,1001,1.0,0.0
86448,931907,1000,15000,1000,17000,2000,1001,15.0,0.0
86449,974223,1000,15000,1000,17000,2000,1001,15.0,0.0
8645,19022,46,230,46,322,92,48,5.0,0.0
86450,962126,1000,15000,1000,17000,2000,1001,15.0,0.0
86451,1041973,1000,16000,1000,18000,2000,1001,16.0,0.0
86452,855974,1000,13000,1000,15000,2000,1001,13.0,0.0
86453,991243,1000,15000,1000,17000,2000,1001,15.0,0.0
86458,813397,1000,12000,1000,14000,2000,1001,12.0,0.0
86459,815011,1000,12000,1000,14000,2000,1001,12.0,0.0
8646,5083,6,53,6,65,12,8,8.833,0.0
86460,934776,1000,15000,1000,17000,2000,1001,15.0,0.0
86461,785560,1000,12000,1000,14000,2000,1001,12.0,0.0
86462,863725,927,12978,927,14832,1854,928,14.0,0.0
86463,883755,927,12977,927,14831,1854,928,13.999,0.0
86464,982270,1000,14799,1000,16799,2000,1001,14.799,0.0
86467,990358,1000,14900,1000,16900,2000,1001,14.9,0.0
86469,809931,1000,12000,1000,14000,2000,1001,12.0,0.0
8647,649027,500,10007,500,11007,1000,502,20.014,0.0
86470,669203,0,8109,0,9109,1000,1001,8.109,0.0
86472,671827,0,10000,0,11000,1000,1001,10.0,0.0
86473,612098,0,9000,0,10000,1000,1001,9.0,0.0
86475,873206,0,13000,0,14000,1000,1001,13.0,0.0
8648,510995,500,8710,500,9710,1000,502,17.42,0.0
86480,872905,0,12989,0,13989,1000,1001,12.989,0.0
86483,979463,0,14028,0,15028,1000,1001,14.028,0.0
86489,437507,1000,5159,1000,7159,2000,1001,5.159,0.0
86490,247587,1000,1000,1000,3000,2000,1001,1.0,0.0
86493,251588,1000,1000,1000,3000,2000,1001,1.0,0.0
86495,57029,19,190,19,228,38,20,10.0,0.0
86500,251588,1000,1000,1000,3000,2000,1001,1.0,0.0
86502,824719,1000,12000,1000,14000,2000,1001,12.0,0.0
86503,251588,1000,1000,1000,3000,2000,1001,1.0,0.0
86504,616673,1000,8000,1000,10000,2000,1001,8.0,0.0
86506,251588,1000,1000,1000,3000,2000,1001,1.0,0.0
86508,247587,1000,1000,1000,3000,2000,1001,1.0,0.0
86509,74382,294,294,294,882,588,295,1.0,0.0
86510,247587,1000,1000,1000,3000,2000,1001,1.0,0.0
86511,46542,138,414,138,690,276,139,3.0,0.0
86513,73952,220,659,220,1099,440,221,2.995,0.0
86515,247587,1000,1000,1000,3000,2000,1001,1.0,0.0
86516,570470,1000,7000,1000,9000,2000,1001,7.0,0.0
86518,73205,294,294,294,882,588,295,1.0,0.0
8652,5037,9,59,9,77,18,11,6.556,0.0
86520,251588,1000,1000,1000,3000,2000,1001,1.0,0.0
86529,1718,1,7,1,12,5,5,7.0,0.0
8653,162270,301,2095,301,2697,602,303,6.96,0.0
86533,1096,1,4,1,7,3,3,4.0,0.0
8654,148779,0,2975,0,3150,175,176,17.0,0.0
86543,663604,1000,10000,1000,12000,2000,1001,10.0,0.0
8656,688161,500,9864,500,10864,1000,501,19.728,0.0
8658,31074,0,304,0,380,76,77,4.0,0.0
86582,237426,217,3472,217,3906,434,218,16.0,0.0
8659,394680,0,9315,0,9468,153,154,60.882,0.0
866,39053,57,512,57,626,114,58,8.982,0.0
8660,168425,0,2251,0,2451,200,201,11.255,0.5
8661,586568,445,9790,445,10680,890,446,22.0,0.0
8662,194086,0,2572,0,2971,399,400,6.446,0.0
8663,1847127,0,29615,0,30115,500,501,59.23,0.0
8664,1475710,494,20025,494,21013,988,495,40.536,1.0
8666,566981,0,12897,0,13397,500,501,25.794,0.0
86664,1191539,1000,16790,1000,18790,2000,1001,16.79,0.0
8668,315513,0,4500,0,5000,500,501,9.0,0.0
86688,657155,1000,10000,1000,12000,2000,1001,10.0,0.0
8669,81754,0,744,0,852,108,109,6.889,0.0
867,6873,16,64,16,96,32,17,4.0,0.0
8670,173184,59,2329,59,2447,118,60,39.475,0.0
86702,974271,1000,16000,1000,18000,2000,1001,16.0,0.0
86710,455508,192,11904,192,12288,384,193,62.0,0.0
8672,2572364,1474,27284,1474,30732,3448,1976,13.822,0.0
8673,502878,0,10178,0,10370,192,193,53.01,0.0
8674,56007,0,504,0,567,63,64,8.0,1.0
8675,87978,0,1568,0,1666,98,99,16.0,0.0
8676,306533,500,3500,500,4500,1000,501,7.0,0.0
86770,297797,398,4776,398,5572,796,399,12.0,0.0
86776,960581,1000,16000,1000,18000,2000,1001,16.0,0.0
8678,339938,0,4500,0,5000,500,501,9.0,0.0
86787,448832,192,11904,192,12288,384,193,62.0,0.0
8679,255567,0,2740,0,3240,500,501,5.48,0.0
8681,434817,500,7613,500,8613,1000,501,15.226,0.0
8682,23964,0,300,0,351,51,52,5.882,0.0
86820,299451,398,4776,398,5572,796,399,12.0,0.0
86828,652255,1000,10000,1000,12000,2000,1001,10.0,0.0
8683,4244,0,32,0,40,8,9,4.0,0.0
8684,440333,0,5406,0,5906,500,501,10.812,0.0
86844,299919,398,4776,398,5572,796,399,12.0,0.0
8685,54178,0,583,0,700,117,118,4.983,0.0
86858,956906,1000,16000,1000,18000,2000,1001,16.0,0.0
86861,299272,398,4776,398,5572,796,399,12.0,0.0
86865,313057,398,4776,398,5572,796,399,12.0,0.0
8687,306277,0,5049,0,5258,209,210,24.158,0.0
86880,297032,398,4776,398,5572,796,399,12.0,0.0
86882,666701,1000,10000,1000,12000,2000,1001,10.0,0.0
8689,965480,500,17474,500,18474,1000,501,34.948,0.0
869,34341,0,448,0,504,56,57,8.0,0.0
8690,705835,0,11213,0,11713,500,501,22.426,0.0
8691,427369,0,8489,0,8989,500,501,16.978,0.0
86916,1197641,1000,16692,1000,18692,2000,1001,16.692,0.0
8692,25608,0,342,0,360,18,19,19.0,0.0
86925,308886,398,4776,398,5572,796,399,12.0,0.0
8693,33489,80,320,80,480,160,81,4.0,0.0
86930,1192365,1000,16830,1000,18830,2000,1001,16.83,0.0
86938,1191130,1000,16807,1000,18807,2000,1001,16.807,0.0
8694,247428,0,4000,0,4500,500,501,8.0,0.0
86947,301522,398,4776,398,5572,796,399,12.0,0.0
8695,65006,0,923,0,964,41,42,22.512,0.0
8697,503862,0,7740,0,8240,500,501,15.48,0.0
8698,49245,0,414,0,552,138,139,3.0,1.0
870,16072,21,138,21,180,42,22,6.571,1.0
87001,22950,29,348,29,406,58,30,12.0,0.0
87007,243583,1000,1000,1000,3000,2000,1001,1.0,0.0
8701,3119999,0,1068,0,1246,178,179,6.0,0.0
8702,492444,0,6000,0,6500,500,501,12.0,0.0
87020,243583,1000,1000,1000,3000,2000,1001,1.0,0.0
87023,783565,1000,11000,1000,13000,2000,1001,11.0,0.0
87024,23889,40,208,40,288,80,41,5.2,0.0
87025,1075835,1000,17000,1000,19000,2000,1001,17.0,0.0
87026,11035,20,100,20,140,40,21,5.0,0.0
87027,1353841,1000,22486,1000,24486,2000,1001,22.486,0.0
8704,388846,0,5500,0,6000,500,501,11.0,0.0
87040,170926,701,701,701,2103,1402,702,1.0,0.0
8705,370405,0,5515,0,6015,500,501,11.03,0.0
87050,243583,1000,1000,1000,3000,2000,1001,1.0,0.0
87057,243583,1000,1000,1000,3000,2000,1001,1.0,0.0
8706,5505,0,64,0,72,8,9,8.0,0.0
8707,302457,0,4500,0,5000,500,501,9.0,0.0
87076,28886,36,486,36,576,90,56,9.0,0.0
8708,27446,29,394,29,452,58,30,13.586,0.0
87081,243583,1000,1000,1000,3000,2000,1001,1.0,0.0
87090,145183,0,600,0,1200,600,601,1.0,0.0
87092,243583,1000,1000,1000,3000,2000,1001,1.0,0.0
8710,268338,0,3000,0,3500,500,501,6.0,0.0
87102,219610,0,3288,0,3560,272,273,12.088,0.0
87107,243583,1000,1000,1000,3000,2000,1001,1.0,0.0
87109,91046,0,1099,0,1256,157,158,7.0,0.0
87112,243583,1000,1000,1000,3000,2000,1001,1.0,0.0
87113,77154,310,310,310,930,620,311,1.0,0.0
87125,243583,1000,1000,1000,3000,2000,1001,1.0,0.0
8713,148827,0,2975,0,3150,175,176,17.0,0.0
87130,847226,1000,14129,1000,16129,2000,1001,14.129,0.0
87132,1041568,1000,4000,1000,6000,2000,1001,4.0,0.0
87134,60852,0,445,0,623,178,179,5.0,0.0
87138,243583,1000,1000,1000,3000,2000,1001,1.0,0.0
8714,178296,59,2388,59,2506,118,60,40.475,0.0
87145,243583,1000,1000,1000,3000,2000,1001,1.0,0.0
87146,243583,1000,1000,1000,3000,2000,1001,1.0,0.0
87148,25760,32,296,32,360,64,33,9.25,0.0
8715,644732,0,9200,0,9700,500,501,18.4,0.0
87152,21186,0,215,0,258,43,44,5.0,0.0
8716,448897,500,9000,500,10000,1000,501,18.0,0.0
87161,13661,0,77,0,129,52,53,2.962,0.0
87162,107535,433,433,433,1299,866,434,1.0,0.0
87166,481420,0,5000,0,6000,1000,1001,5.0,0.0
87168,243583,1000,1000,1000,3000,2000,1001,1.0,0.0
8717,27121,65,260,65,390,130,66,4.0,0.0
8718,123510,0,993,0,1192,199,200,4.99,0.0
87183,173113,710,710,710,2130,1420,711,1.0,0.0
87188,243583,1000,1000,1000,3000,2000,1001,1.0,0.0
8719,459391,0,8500,0,9000,500,501,17.0,0.0
87193,189394,777,777,777,2331,1554,778,1.0,0.0
8720,121272,0,1336,0,1414,78,79,17.128,0.0
87205,243583,1000,1000,1000,3000,2000,1001,1.0,0.0
87208,15219,25,196,25,246,50,26,7.84,0.0
8721,38489,22,550,22,594,44,23,25.0,0.0
87216,211993,870,870,870,2610,1740,871,1.0,0.0
87226,742466,1000,11722,1000,13722,2000,1001,11.722,0.0
87230,243583,1000,1000,1000,3000,2000,1001,1.0,0.0
87231,4117210,298,39086,298,39682,596,299,131.161,0.0
87234,782640,0,12000,0,13000,1000,1001,12.0,0.0
87239,761612,1000,11258,1000,13258,2000,1001,11.258,0.0
8724,176174,0,1423,0,1643,220,221,6.468,0.0
87241,243583,1000,1000,1000,3000,2000,1001,1.0,0.0
87244,38734,157,157,157,471,314,158,1.0,0.0
87253,35259,86,344,86,516,172,87,4.0,0.0
8726,4622,7,49,7,63,14,8,7.0,0.0
87262,1838940,1000,7066,1000,9066,2000,1001,7.066,0.0
87263,1280177,1000,19703,1000,21703,2000,1001,19.703,0.0
87265,1798,5,5,5,15,10,6,1.0,0.0
87266,1332091,1000,4000,1000,6000,2000,1001,4.0,0.0
87268,4536,16,16,16,48,32,17,1.0,0.0
87269,243583,1000,1000,1000,3000,2000,1001,1.0,0.0
8727,1598016,864,18642,864,20766,2124,1262,14.795,0.0
87270,8241,31,31,31,93,62,32,1.0,0.0
87272,1001359,1000,14733,1000,16733,2000,1001,14.733,0.0
87273,247584,1000,1000,1000,3000,2000,1001,1.0,0.0
87274,243583,1000,1000,1000,3000,2000,1001,1.0,0.0
87275,624786,0,9000,0,10000,1000,1001,9.0,0.0
87276,18549,0,247,0,270,23,24,10.739,0.0
87278,243583,1000,1000,1000,3000,2000,1001,1.0,0.0
87279,243583,1000,1000,1000,3000,2000,1001,1.0,0.0
8728,77080,0,1058,0,1104,46,47,23.0,0.0
87280,73778,0,960,0,1056,96,97,10.0,0.0
87281,5198,13,52,13,78,26,14,4.0,0.0
87282,247584,1000,1000,1000,3000,2000,1001,1.0,0.0
87283,1092168,1000,15452,1000,17452,2000,1001,15.452,0.0
87285,73483,300,300,300,900,600,301,1.0,0.0
87286,9088,35,35,35,105,70,36,1.0,0.0
87287,448685,1000,5999,1000,7999,2000,1001,5.999,0.0
87288,243583,1000,1000,1000,3000,2000,1001,1.0,0.0
87289,579205,1000,7657,1000,9657,2000,1001,7.657,0.0
87290,745370,1000,10310,1000,12310,2000,1001,10.31,0.0
87294,9003,0,100,0,120,20,21,5.0,0.0
87296,4957,18,18,18,54,36,19,1.0,0.0
87299,8250,14,110,14,138,28,15,7.857,0.0
8730,26689,0,460,0,483,23,24,20.0,1.0
87301,481593,0,5000,0,6000,1000,1001,5.0,0.0
87305,243583,1000,1000,1000,3000,2000,1001,1.0,0.0
87307,880642,1000,11000,1000,13000,2000,1001,11.0,0.0
87308,247584,1000,1000,1000,3000,2000,1001,1.0,0.0
8731,283403,500,4654,500,5654,1000,501,9.308,1.0
87310,661331,1000,8000,1000,10000,2000,1001,8.0,0.0
87311,23425,94,94,94,282,188,95,1.0,0.0
87313,3985,14,14,14,42,28,15,1.0,0.0
87317,243583,1000,1000,1000,3000,2000,1001,1.0,0.0
87319,6343,0,64,0,80,16,17,4.0,0.0
8732,215009,0,2000,0,2500,500,501,4.0,0.0
87320,243583,1000,1000,1000,3000,2000,1001,1.0,0.0
87321,1233095,14,1918,14,1946,28,15,137.0,0.0
87322,243583,1000,1000,1000,3000,2000,1001,1.0,0.0
87323,558284,1000,8000,1000,10000,2000,1001,8.0,1.0
87325,247584,1000,1000,1000,3000,2000,1001,1.0,0.0
87326,70304,65,632,65,762,130,66,9.723,0.0
87327,840168,1000,12000,1000,14000,2000,1001,12.0,0.0
8733,329858,0,5304,0,5712,408,409,13.0,0.0
87330,995476,1000,13501,1000,15501,2000,1001,13.501,0.0
87331,12004,47,47,47,141,94,48,1.0,0.0
87332,241583,0,1000,0,2000,1000,1001,1.0,0.0
87333,1518306,1000,12076,1000,14076,2000,1001,12.076,0.0
87336,2511,0,8,0,16,8,9,1.0,0.0
87337,553024,1000,8000,1000,10000,2000,1001,8.0,0.5
87339,247584,1000,1000,1000,3000,2000,1001,1.0,0.0
8734,208182,0,2000,0,2500,500,501,4.0,0.0
87341,717178,1000,6900,1000,8900,2000,1001,6.9,0.0
87342,809680,587,5827,587,7001,1174,588,9.927,0.0
87343,243583,1000,1000,1000,3000,2000,1001,1.0,0.0
87344,4042,14,14,14,42,28,15,1.0,0.5
87346,708171,978,8757,978,10713,1956,979,8.954,0.0
87351,46616,38,454,38,530,76,39,11.947,0.0
87352,247584,1000,1000,1000,3000,2000,1001,1.0,0.0
87353,4389,9,45,9,63,18,10,5.0,0.0
87354,241583,0,1000,0,2000,1000,1001,1.0,0.0
87355,243583,1000,1000,1000,3000,2000,1001,1.0,0.0
87356,243584,0,1000,0,2000,1000,1001,1.0,0.0
87357,7412,12,84,12,108,24,13,7.0,0.0
87358,83127,87,783,87,957,174,88,9.0,0.0
87361,243583,1000,1000,1000,3000,2000,1001,1.0,0.0
87364,3985,14,14,14,42,28,15,1.0,0.0
87365,31953,127,127,127,381,254,128,1.0,0.0
87367,3985,14,14,14,42,28,15,1.0,0.0
87369,5707,0,60,0,70,10,11,6.0,0.0
8737,348790,0,4500,0,5000,500,501,9.0,0.0
87370,243583,1000,1000,1000,3000,2000,1001,1.0,0.0
87373,508282,0,8000,0,9000,1000,1001,8.0,0.0
87374,1123770,1000,20000,1000,22000,2000,1001,20.0,0.0
87375,6375,16,64,16,96,32,17,4.0,0.0
87376,13556059,1000,4000,1000,6000,2000,1001,4.0,0.0
87377,16378,65,65,65,195,130,66,1.0,0.0
87378,241583,0,1000,0,2000,1000,1001,1.0,0.0
8738,15310083,500,6494,500,7494,1000,501,12.988,0.0
87381,243583,1000,1000,1000,3000,2000,1001,1.0,0.0
87383,247584,1000,1000,1000,3000,2000,1001,1.0,0.0
87389,79568,0,854,0,976,122,123,7.0,0.5
8739,235059,284,2869,284,3437,568,285,10.102,0.0
87390,483047,1000,5000,1000,7000,2000,1001,5.0,0.0
87392,85274206,1000,4000,1000,6000,2000,1001,4.0,0.0
87394,247584,1000,1000,1000,3000,2000,1001,1.0,0.0
87395,5297,13,52,13,78,26,14,4.0,0.0
87397,67365,160,960,160,1280,320,161,6.0,0.0
87398,5644,0,78,0,84,6,7,13.0,0.0
8740,381685,0,5000,0,5500,500,501,10.0,0.0
87400,243583,1000,1000,1000,3000,2000,1001,1.0,0.0
87403,3985,14,14,14,42,28,15,1.0,0.0
87404,243583,1000,1000,1000,3000,2000,1001,1.0,0.0
87406,5686,21,21,21,63,42,22,1.0,0.0
87407,243583,1000,1000,1000,3000,2000,1001,1.0,0.0
87408,243583,1000,1000,1000,3000,2000,1001,1.0,0.0
87409,56970,87,609,87,783,174,88,7.0,0.0
8741,418643,0,8500,0,9000,500,501,17.0,0.0
87410,243583,1000,1000,1000,3000,2000,1001,1.0,0.0
87411,2672203,0,747,0,934,187,188,3.995,0.0
87413,17326,0,252,0,284,32,33,7.875,0.0
87414,448537,1000,6000,1000,8000,2000,1001,6.0,0.0
87417,1776,0,15,0,18,3,4,5.0,0.0
87418,247584,1000,1000,1000,3000,2000,1001,1.0,0.0
87419,3985,14,14,14,42,28,15,1.0,0.0
8742,591918,0,13547,0,14047,500,501,27.094,0.0
87420,399043,1000,6000,1000,8000,2000,1001,6.0,0.0
87423,16774,42,210,42,294,84,43,5.0,0.0
87425,2284,7,7,7,21,14,8,1.0,0.0
87427,8116,31,31,31,93,62,32,1.0,0.0
87428,28201,50,350,50,450,100,51,7.0,0.0
87429,3985,14,14,14,42,28,15,1.0,0.0
87431,141138,250,1749,250,2249,500,251,6.996,0.0
87432,243583,1000,1000,1000,3000,2000,1001,1.0,0.0
87433,243583,1000,1000,1000,3000,2000,1001,1.0,0.0
87434,3985,14,14,14,42,28,15,1.0,0.0
87436,3985,14,14,14,42,28,15,1.0,0.0
87437,243583,1000,1000,1000,3000,2000,1001,1.0,0.0
87438,243583,1000,1000,1000,3000,2000,1001,1.0,0.0
87439,975676,1000,7000,1000,9000,2000,1001,7.0,0.0
8744,6103,0,48,0,64,16,17,6.0,0.0
87440,243583,1000,1000,1000,3000,2000,1001,1.0,0.0
87443,56312,100,700,100,900,200,101,7.0,0.0
87445,480815,0,5000,0,6000,1000,1001,5.0,0.0
87448,5297,13,52,13,78,26,14,4.0,0.0
87449,243583,1000,1000,1000,3000,2000,1001,1.0,0.0
8745,63120,65,1040,65,1170,130,66,16.0,0.0
87450,1513289,1000,24678,1000,26678,2000,1001,24.678,0.0
87451,4663,0,44,0,55,11,12,4.0,0.0
87456,243583,1000,1000,1000,3000,2000,1001,1.0,0.0
87457,2586468,292,2628,292,3212,584,293,9.0,0.0
8746,194672,0,2730,0,3120,390,391,7.0,1.0
87460,3499,12,12,12,36,24,13,1.0,0.5
87465,241583,0,1000,0,2000,1000,1001,1.0,0.0
8747,4502,0,40,0,45,5,6,8.0,0.0
87475,7567,1,4,1,6,2,2,4.0,0.0
8748,8868,0,119,0,131,12,13,9.917,0.0
87480,243583,1000,1000,1000,3000,2000,1001,1.0,0.0
87482,1729194,1000,42000,1000,44000,2000,1001,42.0,0.0
87484,4042,14,14,14,42,28,15,1.0,0.0
8749,7233,0,57,0,76,19,20,3.0,0.0
87493,1606677,154,1661,154,1969,308,155,10.786,0.0
87494,8554301,1000,3114,1000,5114,2000,1001,3.114,0.0
8752,146943,148,2960,148,3256,296,149,20.0,0.0
8753,456250,0,8500,0,9000,500,501,17.0,0.0
8754,4218,0,36,0,45,9,10,4.0,1.0
87544,247584,1000,1000,1000,3000,2000,1001,1.0,0.0
87546,87810,176,1056,176,1408,352,177,6.0,0.0
87547,18176,0,73,0,146,73,74,1.0,0.0
87548,1181993,1000,15777,1000,17777,2000,1001,15.777,0.0
8755,44398,57,758,57,872,114,58,13.298,0.0
87550,486419,0,7000,0,8000,1000,1001,7.0,0.0
87551,51466,206,206,206,618,412,207,1.0,0.0
87553,2067031,0,4975,0,5174,199,200,25.0,0.0
87554,86931,5,15,5,25,10,6,3.0,0.0
87555,247584,1000,1000,1000,3000,2000,1001,1.0,0.0
87556,17324950,1000,5000,1000,7000,2000,1001,5.0,0.5
8756,111057,0,1304,0,1467,163,164,8.0,0.0
87563,3985,14,14,14,42,28,15,1.0,0.0
87564,8476,15,109,15,139,30,16,7.267,0.0
87566,243583,1000,1000,1000,3000,2000,1001,1.0,0.0
87567,247584,1000,1000,1000,3000,2000,1001,1.0,0.0
87568,243583,1000,1000,1000,3000,2000,1001,1.0,0.0
87569,2066,6,6,6,18,12,7,1.0,0.0
8757,444554,0,8420,0,8920,500,501,16.84,0.0
87571,643253,14,112,14,140,28,15,8.0,0.0
87572,243583,1000,1000,1000,3000,2000,1001,1.0,0.0
87575,24640,99,99,99,297,198,100,1.0,0.0
8758,364028,0,5123,0,5623,500,501,10.246,0.0
87580,9574,37,37,37,111,74,38,1.0,0.0
87583,243583,1000,1000,1000,3000,2000,1001,1.0,0.0
8759,8441,0,80,0,90,10,11,8.0,0.0
876,114939,230,1602,230,2062,460,231,6.965,0.0
87619,243583,1000,1000,1000,3000,2000,1001,1.0,0.0
8762,525825,0,10496,0,10996,500,501,20.992,0.0
87632,831,1,1,1,3,2,2,1.0,0.0
8764,502322,500,5000,500,6000,1000,501,10.0,0.0
87643,1483493,1000,13624,1000,15624,2000,1001,13.624,0.0
87644,247584,1000,1000,1000,3000,2000,1001,1.0,0.0
87646,7873,30,30,30,90,60,31,1.0,0.0
87649,243583,1000,1000,1000,3000,2000,1001,1.0,0.0
87660,48008,192,192,192,576,384,193,1.0,0.0
8767,175531,0,2065,0,2360,295,296,7.0,0.0
8768,486034,500,9000,500,10000,1000,501,18.0,0.0
8769,1562061,0,21601,0,22101,500,501,43.202,0.0
8772,4797452,500,149234,500,150234,1000,501,298.468,0.0
87726,74088,0,305,0,610,305,306,1.0,0.0
87729,74088,0,305,0,610,305,306,1.0,0.0
87735,1111594,1000,6000,1000,8000,2000,1001,6.0,0.0
87738,74699,0,305,0,610,305,306,1.0,0.0
87739,111302,79,253,79,411,158,80,3.203,0.0
87741,1559151,1000,9778,1000,11778,2000,1001,9.778,0.0
87744,74088,0,305,0,610,305,306,1.0,0.0
87745,243583,1000,1000,1000,3000,2000,1001,1.0,0.0
8775,1579523,0,36000,0,36500,500,501,72.0,0.0
87754,1104868,0,6000,0,7000,1000,1001,6.0,0.0
87757,550728,60,360,60,480,120,61,6.0,0.0
8776,1749300,0,23802,0,24302,500,501,47.604,0.0
87762,373273,18,72,18,108,36,19,4.0,0.0
87763,5362652,777,2331,777,3885,1554,778,3.0,0.0
87774,1105945,14,1778,14,1806,28,15,127.0,0.5
87779,962508,14,1778,14,1806,28,15,127.0,0.5
87782,929564,14,1778,14,1806,28,15,127.0,0.5
87786,839711,14,1778,14,1806,28,15,127.0,0.5
87788,820086,14,1330,14,1358,28,15,95.0,0.0
8779,47740,0,975,0,1000,25,26,39.0,0.0
8781,594704,0,13440,0,13632,192,193,70.0,0.0
8783,33093,0,344,0,396,52,53,6.615,0.0
8785,383736,318,4768,318,5404,636,319,14.994,0.0
8786,534100,0,7720,0,8220,500,501,15.44,0.0
8787,458131,0,8500,0,9000,500,501,17.0,0.0
87871,789146,1000,11000,1000,13000,2000,1001,11.0,0.0
87874,249589,1000,1000,1000,3000,2000,1001,1.0,0.0
87876,23762,26,312,26,364,52,27,12.0,0.0
8788,143026,0,2021,0,2064,43,44,47.0,0.5
87881,253590,1000,1000,1000,3000,2000,1001,1.0,0.0
87884,807677,1000,13000,1000,15000,2000,1001,13.0,0.0
87886,588224,1000,7000,1000,9000,2000,1001,7.0,0.0
87890,7231591,910,143616,910,145436,1820,911,157.82,0.0
87894,253590,1000,1000,1000,3000,2000,1001,1.0,0.0
87900,17620,26,234,26,286,52,27,9.0,0.0
87902,10843832,1000,10696,1000,12696,2000,1001,10.696,0.0
87903,253590,1000,1000,1000,3000,2000,1001,1.0,0.0
87904,249589,1000,1000,1000,3000,2000,1001,1.0,0.0
87906,11975,45,45,45,135,90,46,1.0,0.0
8791,393756,0,5500,0,6000,500,501,11.0,0.0
87910,69562,277,277,277,831,554,278,1.0,0.0
87914,249589,1000,1000,1000,3000,2000,1001,1.0,0.0
87915,7063,26,26,26,78,52,27,1.0,0.0
87917,249589,1000,1000,1000,3000,2000,1001,1.0,0.0
87918,32511,44,440,44,528,88,45,10.0,0.0
87919,249589,1000,1000,1000,3000,2000,1001,1.0,0.0
8792,545789,0,9642,0,10142,500,501,19.284,0.0
87921,11173,24,120,24,168,48,25,5.0,1.0
87924,249589,1000,1000,1000,3000,2000,1001,1.0,0.0
87925,247589,0,1000,0,2000,1000,1001,1.0,0.0
87929,249589,1000,1000,1000,3000,2000,1001,1.0,0.0
87931,249589,1000,1000,1000,3000,2000,1001,1.0,0.0
87937,16027,62,62,62,186,124,63,1.0,0.0
8794,302361,0,4000,0,4500,500,501,8.0,0.0
87940,20509,80,80,80,240,160,81,1.0,0.0
87941,247589,0,1000,0,2000,1000,1001,1.0,0.0
87944,249589,1000,1000,1000,3000,2000,1001,1.0,0.0
87946,249589,1000,1000,1000,3000,2000,1001,1.0,0.5
87947,6565,24,24,24,72,48,25,1.0,0.0
87949,249589,1000,1000,1000,3000,2000,1001,1.0,0.0
87953,249589,1000,1000,1000,3000,2000,1001,1.0,0.0
87956,249589,1000,1000,1000,3000,2000,1001,1.0,0.0
87957,239131,958,958,958,2874,1916,959,1.0,0.0
8796,47754,0,570,0,627,57,58,10.0,0.0
87963,7063,26,26,26,78,52,27,1.0,0.5
87965,7168,26,26,26,78,52,27,1.0,0.0
87969,7063,26,26,26,78,52,27,1.0,0.0
8797,731446,0,11435,0,11935,500,501,22.87,0.0
87973,21505,84,84,84,252,168,85,1.0,0.0
87978,249589,1000,1000,1000,3000,2000,1001,1.0,0.0
87979,2108,6,6,6,18,12,7,1.0,0.0
8798,454416,0,8330,0,8820,490,491,17.0,0.0
87980,159617,6,54,6,66,12,7,9.0,0.0
87982,249589,1000,1000,1000,3000,2000,1001,1.0,0.0
87984,22750,89,89,89,267,178,90,1.0,0.0
87986,1000841,1000,6849,1000,8849,2000,1001,6.849,0.0
87989,3826,13,13,13,39,26,14,1.0,0.0
8799,864019,0,11000,0,11500,500,501,22.0,0.0
87991,154720,619,619,619,1857,1238,620,1.0,0.0
87993,91343,84,771,84,939,168,85,9.179,0.0
87994,1336,3,3,3,9,6,4,1.0,0.0
87999,1087,2,2,2,6,4,3,1.0,0.0
8800,725338,0,16739,0,17239,500,501,33.478,0.0
88002,223421,89,1333,89,1511,178,90,14.978,0.0
88005,843,1,1,1,3,2,2,1.0,0.0
88006,838,1,1,1,3,2,2,1.0,0.0
88007,1191152,1,7,1,9,2,2,7.0,0.0
8801,348183,0,5500,0,6000,500,501,11.0,0.0
88017,87732,19,152,19,190,38,20,8.0,0.0
88018,39580,28,442,28,498,56,29,15.786,0.0
8802,3324,0,40,0,45,5,6,8.0,0.0
8803,362553,0,7140,0,7560,420,421,17.0,0.0
88033,617487,1000,8000,1000,10000,2000,1001,8.0,0.0
88039,405160,1000,4000,1000,6000,2000,1001,4.0,0.0
8804,457896,0,8500,0,9000,500,501,17.0,0.0
88043,805463,0,11000,0,12000,1000,1001,11.0,0.0
88046,26731,0,227,0,253,26,27,8.731,0.0
8805,3127,0,24,0,30,6,7,4.0,0.0
88052,26678,0,227,0,253,26,27,8.731,0.0
88055,26678,0,227,0,253,26,27,8.731,0.0
88057,26678,0,227,0,253,26,27,8.731,0.0
88059,26678,0,227,0,253,26,27,8.731,0.0
8806,610678,0,5919,0,6419,500,501,11.838,0.0
88066,245585,1000,1000,1000,3000,2000,1001,1.0,0.0
88067,26730,26,227,26,279,52,27,8.731,0.0
8807,26167,0,369,0,378,9,10,41.0,0.0
88074,160377,0,1276,0,1466,190,191,6.716,0.0
88076,308996,196,5048,196,5440,392,197,25.755,0.0
88078,2148084,1000,34525,1000,36525,2000,1001,34.525,0.0
8808,632590,500,11047,500,12047,1000,501,22.094,0.0
88082,247587,1000,1000,1000,3000,2000,1001,1.0,0.0
88085,679168,1000,9000,1000,11000,2000,1001,9.0,0.0
88086,534255,1000,5000,1000,7000,2000,1001,5.0,0.0
88089,1284281,324,50466,324,51114,648,325,155.759,0.0
8809,327717,0,4494,0,4994,500,501,8.988,0.0
88092,1642955,0,24683,0,25683,1000,1001,24.683,0.0
88094,1388838,0,19998,0,20998,1000,1001,19.998,0.0
88097,789998,1000,10177,1000,13176,2999,2000,10.177,0.0
8810,122641,0,2139,0,2335,196,197,10.913,0.0
8812,350904,0,5000,0,5500,500,501,10.0,0.0
88120,1106838,1000,15998,1000,17998,2000,1001,15.998,0.0
88122,702357,0,11772,0,12772,1000,1001,11.772,0.0
88124,1328179,1000,25743,1000,27743,2000,1001,25.743,0.0
88127,636187,1000,10000,1000,12000,2000,1001,10.0,0.0
8813,357138,0,5000,0,5500,500,501,10.0,0.0
88130,598931,1000,8000,1000,10000,2000,1001,8.0,0.5
88134,616807,919,9679,919,11517,1838,920,10.532,0.0
88138,913248,0,12000,0,13000,1000,1001,12.0,0.0
88146,1316245,1000,17088,1000,19088,2000,1001,17.088,0.0
88154,527247,0,6994,0,7994,1000,1001,6.994,0.0
88156,426234,1000,5000,1000,7000,2000,1001,5.0,0.0
8816,5455,0,84,0,89,5,6,16.8,0.0
8817,285043,0,3000,0,3500,500,501,6.0,0.0
88175,478099,1000,7000,1000,9000,2000,1001,7.0,0.0
8818,1779462,0,37407,0,37907,500,501,74.814,0.0
8819,240183,290,2916,290,3496,580,291,10.055,0.0
8820,574659,0,8000,0,8500,500,501,16.0,0.0
8822,452584,0,8430,0,8930,500,501,16.86,0.5
8823,248534,500,4000,500,5000,1000,501,8.0,0.0
88244,1067063,1000,13094,1000,16116,3022,2023,13.094,0.0
8825,359742,500,5531,500,6531,1000,501,11.062,0.0
8826,443720,0,10240,0,10432,192,193,53.333,0.0
8827,742921,0,10560,0,11000,440,441,24.0,0.0
8828,210211,0,2000,0,2500,500,501,4.0,0.0
88280,2078807,1000,32847,1000,34847,2000,1001,32.847,0.5
8830,229524,0,3500,0,4000,500,501,7.0,0.0
8831,377966,0,4951,0,5451,500,501,9.902,0.0
8832,107692,240,1200,240,1680,480,241,5.0,0.0
8833,189507,0,2415,0,2760,345,346,7.0,0.0
8834,313091,0,4326,0,4635,309,310,14.0,0.0
8835,285853,0,5000,0,5500,500,501,10.0,0.0
8836,160389,0,1701,0,1944,243,244,7.0,0.875
8837,136758,0,1735,0,2026,291,292,5.962,0.0
8838,6677536,0,67991,0,68491,500,501,135.982,0.0
88381,95597,236,944,236,1416,472,237,4.0,0.0
88382,245582,1000,1000,1000,3000,2000,1001,1.0,0.0
88386,656294,0,9941,0,10349,408,409,24.365,0.0
88387,3189,4,39,4,47,8,5,9.75,0.0
88388,956,0,4,0,5,1,2,4.0,1.0
88389,579138,1000,8000,1000,10000,2000,1001,8.0,0.0
8839,322695,500,4000,500,5000,1000,501,8.0,0.0
88390,241581,1000,1000,1000,3000,2000,1001,1.0,0.0
88394,558409,1000,6000,1000,8000,2000,1001,6.0,0.0
88395,438838,1000,5000,1000,7000,2000,1001,5.0,1.0
88397,598887,1000,8000,1000,10000,2000,1001,8.0,0.0
88398,499698,1000,7000,1000,9000,2000,1001,7.0,0.0
88399,360835,0,4000,0,5000,1000,1001,4.0,0.0
8840,129325,228,1596,228,2052,456,229,7.0,0.0
88400,563875,1000,6000,1000,8000,2000,1001,6.0,0.0
88401,1684397,1000,36000,1000,38000,2000,1001,36.0,0.0
88403,245582,1000,1000,1000,3000,2000,1001,1.0,0.0
8841,307357,0,5500,0,6000,500,501,11.0,0.0
88411,442828,1000,6000,1000,8000,2000,1001,6.0,1.0
88418,543756,1000,6977,1000,8977,2000,1001,6.977,0.0
88419,108116,237,1185,237,1659,474,238,5.0,1.0
8842,43355,0,768,0,816,48,49,16.0,0.0
88420,363509,667,4002,667,5336,1334,668,6.0,0.0
88427,441878,1000,5000,1000,7000,2000,1001,5.0,0.5
8843,283164,0,3000,0,3500,500,501,6.0,0.0
88430,247244,254,2794,254,3302,508,255,11.0,0.0
88432,897788,0,12981,0,13981,1000,1001,12.981,0.0
88433,676597,1000,8000,1000,10000,2000,1001,8.0,0.0
88434,1058796,1000,13182,1000,16109,2927,1928,13.182,0.0
8844,1891,0,12,0,16,4,5,3.0,0.0
88443,547534,1000,7000,1000,9000,2000,1001,7.0,0.0
88445,1009497,1000,11667,1000,14772,3105,2106,11.667,0.0
88447,1067124,701,17524,701,18926,1402,702,24.999,0.0
8845,69741,0,695,0,834,139,140,5.0,0.0
88455,498219,0,7000,0,8000,1000,1001,7.0,0.0
8846,445261,0,8420,0,8920,500,501,16.84,0.0
88467,485592,1000,5000,1000,7000,2000,1001,5.0,0.0
8847,240949,0,1904,0,2404,500,501,3.808,0.0
88471,564626,1000,6000,1000,8000,2000,1001,6.0,0.0
88472,313950,410,4100,410,4920,820,411,10.0,0.0
88473,241581,1000,1000,1000,3000,2000,1001,1.0,0.0
88474,1059950,738,17712,738,19188,1476,739,24.0,0.0
88476,411221,1000,5000,1000,7000,2000,1001,5.0,0.0
8848,349716,500,4500,500,5500,1000,501,9.0,0.0
88480,66403,90,810,90,990,180,91,9.0,0.5
88485,1523211,1000,28412,1000,30412,2000,1001,28.412,0.0
88489,1489,0,13,0,14,1,2,13.0,0.0
88492,1249507,793,19103,793,20689,1586,794,24.09,0.0
88494,2357659,1000,38749,1000,40749,2000,1001,38.749,0.0
88498,619567,1000,8000,1000,10000,2000,1001,8.0,1.0
88499,34884,0,291,0,388,97,98,3.0,0.0
885,212476,0,3555,0,3972,417,418,8.525,0.0
8850,23545,0,126,0,189,63,64,2.0,0.0
88503,241581,1000,1000,1000,3000,2000,1001,1.0,0.0
88505,241581,1000,1000,1000,3000,2000,1001,1.0,0.0
88508,619455,1000,7990,1000,9990,2000,1001,7.99,0.0
8851,70153,0,1344,0,1428,84,85,16.0,0.5
88511,2322995,1000,44869,1000,46869,2000,1001,44.869,0.0
88512,39523,16,557,16,589,32,17,34.812,0.0
88513,560380,1000,8000,1000,10000,2000,1001,8.0,0.5
88515,685605,1000,9000,1000,11000,2000,1001,9.0,0.5
88516,888625,0,12878,0,13878,1000,1001,12.878,0.0
88519,483395,1000,5000,1000,7000,2000,1001,5.0,0.0
8852,2639749,1498,29244,1498,32740,3496,2000,14.637,0.0
88523,507334,1000,5000,1000,7000,2000,1001,5.0,0.0
88528,414118,779,4594,779,6152,1558,780,5.897,0.5
8853,11099,0,164,0,177,13,14,12.615,0.0
88530,3269563,0,49623,0,50596,973,974,51.0,0.5
88531,942748,1000,13000,1000,15000,2000,1001,13.0,0.0
88534,10016,28,84,28,140,56,29,3.0,0.0
88535,1611393,1000,24364,1000,26364,2000,1001,24.364,0.0
8854,393847,0,5500,0,6000,500,501,11.0,0.5
88543,549784,1000,7000,1000,9000,2000,1001,7.0,0.75
88549,1438373,1000,30000,1000,32000,2000,1001,30.0,0.0
88554,1982691,1000,38059,1000,40059,2000,1001,38.059,0.0
88555,1391008,1000,19997,1000,21997,2000,1001,19.997,0.0
88556,999911,678,16272,678,17628,1356,679,24.0,0.0
88557,241581,1000,1000,1000,3000,2000,1001,1.0,0.0
88558,1385839,1000,19994,1000,21994,2000,1001,19.994,0.0
8856,9894,5,190,5,200,10,6,38.0,0.75
88560,2373702,1000,47000,1000,49000,2000,1001,47.0,0.0
88561,39523,16,557,16,589,32,17,34.812,0.0
88563,1132441,1000,14900,1000,16900,2000,1001,14.9,0.0
88564,542543,1000,6916,1000,8916,2000,1001,6.916,0.0
88569,1307221,0,22000,0,23000,1000,1001,22.0,0.0
88571,112397,0,1599,0,1722,123,124,13.0,0.0
88576,515929,0,6000,0,7000,1000,1001,6.0,0.0
88579,241581,1000,1000,1000,3000,2000,1001,1.0,0.0
8858,2365048,987,25814,987,28117,2303,1318,19.616,0.0
88580,805336,1000,11000,1000,13000,2000,1001,11.0,0.0
88581,1068694,1000,13435,1000,16485,3050,2051,13.435,0.0
88588,513531,1000,5000,1000,7000,2000,1001,5.0,0.0
8859,419428,0,8348,0,8848,500,501,16.696,0.0
88590,160057,297,2673,297,3267,594,298,9.0,0.0
88595,525544,1000,5000,1000,7000,2000,1001,5.0,0.0
8860,122533,0,1380,0,1580,200,201,6.9,0.0
8861,358861,0,4500,0,5000,500,501,9.0,0.0
88613,241581,1000,1000,1000,3000,2000,1001,1.0,0.0
8862,424674,0,4000,0,4500,500,501,8.0,0.0
88623,1827884,1000,40125,1000,42125,2000,1001,40.125,0.0
88625,424625,1000,6000,1000,8000,2000,1001,6.0,0.0
88626,158491,355,2130,355,2840,710,356,6.0,0.0
88627,241581,1000,1000,1000,3000,2000,1001,1.0,0.0
88628,490333,1000,7000,1000,9000,2000,1001,7.0,0.0
8863,488981,0,7478,0,7978,500,501,14.956,0.0
8864,246347,460,2924,460,3844,920,461,6.357,0.0
88645,307956,193,4632,193,5018,386,194,24.0,0.0
88646,245582,1000,1000,1000,3000,2000,1001,1.0,0.0
88649,77158,55,1100,55,1210,110,56,20.0,0.0
8865,1640005,500,29572,500,30572,1000,501,59.144,0.0
88650,763919,1000,10000,1000,12000,2000,1001,10.0,0.0
88652,11345,0,156,0,168,12,13,13.0,0.0
88655,504689,1000,6000,1000,8000,2000,1001,6.0,0.0
88656,241581,1000,1000,1000,3000,2000,1001,1.0,0.0
88659,1622103,985,26595,985,28565,1970,986,27.0,0.0
8866,131934,260,1820,260,2340,520,261,7.0,0.0
88660,1586001,1000,24052,1000,26052,2000,1001,24.052,0.0
88661,577744,1000,8000,1000,10000,2000,1001,8.0,0.0
88664,696087,1000,9000,1000,11000,2000,1001,9.0,0.0
88665,1543555,1000,28573,1000,30573,2000,1001,28.573,0.0
88666,11473,0,156,0,169,13,14,12.0,0.0
88667,65968,47,940,47,1034,94,48,20.0,0.0
8867,492620,0,7493,0,7993,500,501,14.986,0.0
8868,498726,500,7471,500,8471,1000,501,14.942,0.0
8869,460790,0,7072,0,7572,500,501,14.144,0.0
8870,200753,500,2489,500,3489,1000,501,4.978,0.0
8871,502519,500,7458,500,8458,1000,501,14.916,0.0
88711,26417,0,340,0,374,34,35,10.0,0.0
8872,382414,363,2733,363,3459,726,365,7.529,0.0
88728,241581,1000,1000,1000,3000,2000,1001,1.0,0.0
8873,9460,18,122,18,158,36,20,6.778,0.0
88731,245582,1000,1000,1000,3000,2000,1001,1.0,0.0
88732,1468188,1000,28024,1000,30024,2000,1001,28.024,0.0
88738,550870,1000,7000,1000,9000,2000,1001,7.0,0.0
8874,17425,51,153,51,255,102,53,3.0,0.0
88740,101692,0,1353,0,1476,123,124,11.0,0.0
88741,135613,310,1860,310,2480,620,311,6.0,0.0
88744,245582,1000,1000,1000,3000,2000,1001,1.0,0.0
88745,2389404,1000,46158,1000,48158,2000,1001,46.158,0.0
88747,825286,0,11000,0,12000,1000,1001,11.0,0.0
8875,225329,500,2500,500,3500,1000,502,5.0,0.0
88752,245582,1000,1000,1000,3000,2000,1001,1.0,0.0
88757,1227035,0,16316,0,17316,1000,1001,16.316,0.0
8876,15649,0,136,0,182,46,47,2.957,0.0
88761,245582,1000,1000,1000,3000,2000,1001,1.0,0.0
88762,4721,5,55,5,65,10,6,11.0,0.0
88768,492031,1000,5995,1000,7995,2000,1001,5.995,0.0
88769,241581,1000,1000,1000,3000,2000,1001,1.0,0.0
8877,631936,500,9635,500,10635,1000,502,19.27,0.0
88772,1521198,1000,28193,1000,30193,2000,1001,28.193,0.0
88773,2441795,1000,47217,1000,49217,2000,1001,47.217,0.0
88776,1609517,1000,24221,1000,26221,2000,1001,24.221,0.0
88779,573315,1000,8000,1000,10000,2000,1001,8.0,0.0
8878,255942,0,1939,0,2216,277,278,7.0,0.0
88782,641400,326,12273,326,12925,652,327,37.647,1.0
8879,27435,24,380,24,428,48,26,15.833,0.0
88795,2289039,1000,44317,1000,46317,2000,1001,44.317,0.0
8880,7537,11,57,11,92,35,26,5.182,0.5
88802,2288055,1000,44298,1000,46298,2000,1001,44.298,0.0
88803,1162909,788,18912,788,20488,1576,789,24.0,0.0
88805,1549311,1000,28790,1000,30790,2000,1001,28.79,0.0
88806,1111578,1000,15998,1000,17998,2000,1001,15.998,0.0
8881,324942,500,4000,500,5000,1000,502,8.0,0.0
88814,53493,38,760,38,836,76,39,20.0,0.0
88815,1644397,1000,24663,1000,26663,2000,1001,24.663,0.0
88817,1960795,1000,37192,1000,39192,2000,1001,37.192,0.0
88819,284868,407,3663,407,4477,814,408,9.0,0.0
8882,48232,0,529,0,608,79,80,6.696,0.0
88820,768086,1000,9000,1000,11000,2000,1001,9.0,0.0
88827,1582312,0,24000,0,25000,1000,1001,24.0,0.0
8883,22584,61,244,61,366,122,63,4.0,0.0
88834,1209075,0,17440,0,18312,872,873,20.0,0.0
88838,229969,410,2460,410,3280,820,411,6.0,0.0
88839,241581,1000,1000,1000,3000,2000,1001,1.0,0.0
8884,26319,64,320,64,448,128,66,5.0,0.0
88840,760950,1000,10000,1000,12000,2000,1001,10.0,0.0
88841,700156,1000,9000,1000,11000,2000,1001,9.0,0.0
88842,629487,322,12034,322,12678,644,323,37.373,1.0
88843,600533,1000,8000,1000,10000,2000,1001,8.0,0.0
8885,234845,100,1881,100,2081,200,102,18.81,0.5
8886,195368,348,2549,348,3245,696,350,7.325,0.0
8887,636816,490,4900,490,5880,980,492,10.0,0.0
88874,247221,408,2856,408,3672,816,409,7.0,0.0
8889,14175,0,135,0,180,45,46,3.0,0.0
88890,203357,0,2706,0,2952,246,247,11.0,0.0
88895,85734,53,1280,53,1386,106,54,24.151,0.0
8890,16764,49,147,49,245,98,51,3.0,0.0
88902,7538,8,130,8,146,16,10,16.25,0.0
88903,306996,195,4722,195,5112,390,196,24.215,0.0
88909,2294295,1000,44813,1000,46813,2000,1001,44.813,0.0
8891,389836,500,5500,500,7000,1500,1002,5.5,0.0
88920,503983,1000,7000,1000,9000,2000,1001,7.0,0.0
88921,245582,1000,1000,1000,3000,2000,1001,1.0,0.0
88954,602195,1000,7000,1000,9000,2000,1001,7.0,0.0
88955,241581,1000,1000,1000,3000,2000,1001,1.0,0.0
88960,899136,1000,14000,1000,16000,2000,1001,14.0,0.0
88966,1807,0,16,0,17,1,2,16.0,0.0
88969,241581,1000,1000,1000,3000,2000,1001,1.0,0.0
88970,241581,1000,1000,1000,3000,2000,1001,1.0,0.0
88973,241581,1000,1000,1000,3000,2000,1001,1.0,0.0
88974,1606801,1000,24364,1000,26364,2000,1001,24.364,0.0
88975,1603761,0,24346,0,25346,1000,1001,24.346,0.0
88977,119960,237,1185,237,1659,474,238,5.0,0.0
88978,241581,1000,1000,1000,3000,2000,1001,1.0,0.0
88979,505300,1000,8000,1000,10000,2000,1001,8.0,0.0
88980,361379,874,4370,874,6118,1748,875,5.0,0.0
88982,1637895,0,24585,0,25585,1000,1001,24.585,0.0
88983,14591,10,200,10,220,20,11,20.0,0.0
88984,241581,1000,1000,1000,3000,2000,1001,1.0,0.0
88985,1096870,1000,15999,1000,17999,2000,1001,15.999,0.0
88986,750109,1000,10000,1000,12000,2000,1001,10.0,0.0
88987,120477,0,1848,0,1925,77,78,24.0,0.0
88988,249986,200,3600,200,4000,400,201,18.0,0.0
88989,94295,123,1230,123,1476,246,124,10.0,0.0
88990,241581,1000,1000,1000,3000,2000,1001,1.0,0.0
88991,829826,1000,11000,1000,13000,2000,1001,11.0,0.0
88992,453340,1000,6000,1000,8000,2000,1001,6.0,0.0
88993,241581,1000,1000,1000,3000,2000,1001,1.0,0.0
88994,241581,1000,1000,1000,3000,2000,1001,1.0,0.0
88996,241581,1000,1000,1000,3000,2000,1001,1.0,0.0
88997,241581,1000,1000,1000,3000,2000,1001,1.0,0.0
88998,1639805,0,24681,0,25681,1000,1001,24.681,0.0
88999,245582,1000,1000,1000,3000,2000,1001,1.0,0.0
89000,758505,1000,8000,1000,10000,2000,1001,8.0,0.0
89002,19196,17,272,17,306,34,18,16.0,0.0
89003,409089,1000,5000,1000,7000,2000,1001,5.0,0.0
89004,459340,1000,6000,1000,8000,2000,1001,6.0,0.0
89005,633216,0,9333,0,9721,388,389,24.054,0.0
89006,241581,1000,1000,1000,3000,2000,1001,1.0,0.0
89007,37879,53,477,53,583,106,54,9.0,0.0
89009,475446,1000,6000,1000,8000,2000,1001,6.0,0.0
89012,245582,1000,1000,1000,3000,2000,1001,1.0,0.0
89013,241581,1000,1000,1000,3000,2000,1001,1.0,0.0
89016,403596,1000,5000,1000,7000,2000,1001,5.0,0.0
89020,58978,91,728,91,910,182,92,8.0,0.0
89022,245582,1000,1000,1000,3000,2000,1001,1.0,0.0
89023,55729,0,825,0,858,33,34,25.0,0.0
89024,241581,1000,1000,1000,3000,2000,1001,1.0,0.0
89025,1984,1,20,1,22,2,2,20.0,0.0
89026,362308,1000,3000,1000,5000,2000,1001,3.0,0.0
89028,241581,1000,1000,1000,3000,2000,1001,1.0,0.0
89029,7538,8,130,8,146,16,10,16.25,0.0
89030,110847,158,1228,158,1544,316,159,7.772,0.0
89031,114736,91,1638,91,1820,182,92,18.0,0.0
89032,651640,1000,8000,1000,10000,2000,1001,8.0,0.0
89034,123353,78,1872,78,2028,156,79,24.0,0.0
89036,245582,1000,1000,1000,3000,2000,1001,1.0,0.0
89037,241581,1000,1000,1000,3000,2000,1001,1.0,0.0
89038,51321,80,640,80,800,160,81,8.0,0.0
89039,241581,1000,1000,1000,3000,2000,1001,1.0,0.0
89040,245582,1000,1000,1000,3000,2000,1001,1.0,0.0
89042,241581,1000,1000,1000,3000,2000,1001,1.0,0.0
89043,111608,258,1290,258,1806,516,259,5.0,0.0
89044,505083,1000,8000,1000,10000,2000,1001,8.0,0.0
89045,241581,1000,1000,1000,3000,2000,1001,1.0,0.0
89047,241581,1000,1000,1000,3000,2000,1001,1.0,0.0
89049,245582,1000,1000,1000,3000,2000,1001,1.0,0.0
89050,241581,1000,1000,1000,3000,2000,1001,1.0,0.0
89053,636652,1000,8000,1000,10000,2000,1001,8.0,0.0
89055,1599978,0,24101,0,25101,1000,1001,24.101,0.0
89056,241581,1000,1000,1000,3000,2000,1001,1.0,0.0
89060,241581,1000,1000,1000,3000,2000,1001,1.0,0.0
89061,649441,252,12522,252,13026,504,253,49.69,0.0
89062,148003,118,2124,118,2360,236,119,18.0,0.0
89063,1639011,0,24578,0,25578,1000,1001,24.578,0.0
89066,124463,195,1560,195,1950,390,196,8.0,0.0
89069,245582,1000,1000,1000,3000,2000,1001,1.0,0.0
89071,124926,194,1552,194,1940,388,195,8.0,0.0
89074,208940,183,2928,183,3294,366,184,16.0,0.0
89075,241581,1000,1000,1000,3000,2000,1001,1.0,0.0
89082,123682,195,1560,195,1950,390,196,8.0,0.0
89083,1586260,1000,24102,1000,26102,2000,1001,24.102,0.0
89086,118430,489,489,489,1467,978,490,1.0,0.0
89097,391481,1000,5000,1000,7000,2000,1001,5.0,0.0
89098,241581,1000,1000,1000,3000,2000,1001,1.0,0.0
89104,512003,0,5000,0,6000,1000,1001,5.0,0.0
89106,241581,1000,1000,1000,3000,2000,1001,1.0,0.0
89107,241581,1000,1000,1000,3000,2000,1001,1.0,0.0
89108,128198,105,1785,105,1995,210,106,17.0,0.0
89109,610487,1000,8000,1000,10000,2000,1001,8.0,0.0
89110,241581,1000,1000,1000,3000,2000,1001,1.0,0.0
89111,118235,154,1540,154,1848,308,155,10.0,0.0
89114,152743,0,2352,0,2450,98,99,24.0,0.0
89116,249458,409,2863,409,3681,818,410,7.0,0.0
89119,241581,1000,1000,1000,3000,2000,1001,1.0,0.0
89121,147530,118,2124,118,2360,236,119,18.0,0.0
89125,245582,1000,1000,1000,3000,2000,1001,1.0,0.0
89127,241581,1000,1000,1000,3000,2000,1001,1.0,0.0
89130,1612314,0,24000,0,25000,1000,1001,24.0,0.0
89131,241581,1000,1000,1000,3000,2000,1001,1.0,0.0
89132,244783,195,3542,195,3932,390,196,18.164,0.0
89133,417477,1000,5000,1000,7000,2000,1001,5.0,0.0
89134,241581,1000,1000,1000,3000,2000,1001,1.0,0.0
89135,241581,1000,1000,1000,3000,2000,1001,1.0,0.0
89136,241581,1000,1000,1000,3000,2000,1001,1.0,0.0
89137,241581,1000,1000,1000,3000,2000,1001,1.0,0.0
89138,241581,1000,1000,1000,3000,2000,1001,1.0,0.0
89139,241581,1000,1000,1000,3000,2000,1001,1.0,0.0
89140,241581,1000,1000,1000,3000,2000,1001,1.0,0.0
89141,241581,1000,1000,1000,3000,2000,1001,1.0,0.0
89144,245582,1000,1000,1000,3000,2000,1001,1.0,0.0
89146,158125,127,2286,127,2540,254,128,18.0,0.0
89147,245582,1000,1000,1000,3000,2000,1001,1.0,0.0
89149,245582,1000,1000,1000,3000,2000,1001,1.0,0.0
89154,1343101,1000,25028,1000,27028,2000,1001,25.028,0.0
89161,241581,1000,1000,1000,3000,2000,1001,1.0,0.0
89162,245582,1000,1000,1000,3000,2000,1001,1.0,0.0
89163,241581,1000,1000,1000,3000,2000,1001,1.0,0.0
89164,245582,1000,1000,1000,3000,2000,1001,1.0,0.0
89165,241581,1000,1000,1000,3000,2000,1001,1.0,0.0
89166,245582,1000,1000,1000,3000,2000,1001,1.0,0.0
89167,241581,1000,1000,1000,3000,2000,1001,1.0,0.0
89168,245582,1000,1000,1000,3000,2000,1001,1.0,0.0
89169,241581,1000,1000,1000,3000,2000,1001,1.0,0.0
89176,245582,1000,1000,1000,3000,2000,1001,1.0,0.0
89178,241581,1000,1000,1000,3000,2000,1001,1.0,0.0
89182,241581,1000,1000,1000,3000,2000,1001,1.0,0.0
89183,245582,1000,1000,1000,3000,2000,1001,1.0,0.0
89184,241581,1000,1000,1000,3000,2000,1001,1.0,0.0
89185,241581,1000,1000,1000,3000,2000,1001,1.0,0.0
89186,241581,1000,1000,1000,3000,2000,1001,1.0,0.0
89192,241581,1000,1000,1000,3000,2000,1001,1.0,0.0
89193,241581,1000,1000,1000,3000,2000,1001,1.0,0.0
89194,241581,1000,1000,1000,3000,2000,1001,1.0,0.0
89197,241581,1000,1000,1000,3000,2000,1001,1.0,0.0
89198,1387896,0,19978,0,20978,1000,1001,19.978,0.0
892,26805,0,494,0,509,15,16,32.933,0.0
8920,30294,81,222,81,384,162,83,2.741,0.0
89201,241581,1000,1000,1000,3000,2000,1001,1.0,0.0
89202,241581,1000,1000,1000,3000,2000,1001,1.0,0.0
89203,241581,1000,1000,1000,3000,2000,1001,1.0,0.0
89208,1974839,1000,37884,1000,39884,2000,1001,37.884,0.0
89209,314045,138,6099,138,6375,276,139,44.196,0.0
89210,241581,1000,1000,1000,3000,2000,1001,1.0,0.0
89211,1642957,0,24683,0,25683,1000,1001,24.683,0.0
89212,245582,1000,1000,1000,3000,2000,1001,1.0,0.0
89213,245582,1000,1000,1000,3000,2000,1001,1.0,0.0
89214,241581,1000,1000,1000,3000,2000,1001,1.0,0.0
89215,241581,1000,1000,1000,3000,2000,1001,1.0,0.0
89216,245582,1000,1000,1000,3000,2000,1001,1.0,0.0
89217,245582,1000,1000,1000,3000,2000,1001,1.0,0.0
89218,241581,1000,1000,1000,3000,2000,1001,1.0,0.0
8923,2392,5,20,5,30,10,7,4.0,0.0
8924,32191,70,438,70,578,140,72,6.257,0.0
8925,226783,310,3100,310,3720,620,312,10.0,0.0
8928,110539,171,1272,171,1614,342,173,7.439,0.0
8929,16989,34,130,34,198,68,36,3.824,0.0
8930,6026,11,55,11,77,22,13,5.0,0.0
8933,9948,18,126,18,162,36,20,7.0,0.0
8935,5740,12,60,12,84,24,14,5.0,0.5
8936,282173,500,4000,500,5000,1000,502,8.0,1.0
8937,6135,13,39,13,65,26,15,3.0,0.0
8938,7153,14,70,14,98,28,16,5.0,0.0
8939,2150,4,12,4,20,8,6,3.0,0.0
8940,164165,0,747,0,950,203,204,3.68,0.5
8941,6603,15,60,15,90,30,17,4.0,0.0
8943,6876,17,51,17,85,34,19,3.0,0.0
8945,1595,0,9,0,12,3,4,3.0,0.0
8946,3310,5,28,5,38,10,7,5.6,0.0
8947,3232,6,33,6,45,12,8,5.5,0.0
8948,18865,15,135,15,165,30,17,9.0,0.0
8949,2319,3,24,3,30,6,5,8.0,0.0
8950,5738,12,47,12,71,24,14,3.917,0.0
8952,594605,500,3639,500,5139,1500,1002,7.278,0.0
8953,1906,3,15,3,21,6,5,5.0,0.0
8954,18832,0,269,0,286,17,18,15.824,0.5
8956,4763,9,45,9,63,18,11,5.0,0.0
8959,12726,18,216,18,252,36,20,12.0,1.0
8960,272198,500,3485,500,4485,1000,502,6.97,0.0
8962,8581,22,56,22,100,44,24,2.545,0.5
8963,4625,5,30,5,40,10,7,6.0,0.0
8964,103975,0,1155,0,1386,231,232,5.0,0.0
8965,490315,500,7008,500,8008,1000,502,14.016,0.0
8966,1250,2,6,2,10,4,4,3.0,0.0
8967,12881,30,120,30,180,60,32,4.0,0.0
8969,680067,500,10226,500,11226,1000,502,20.452,0.0
897,2752,0,20,0,25,5,6,4.0,0.0
8972,18443,37,184,37,258,74,39,4.973,0.0
8975,1251895,500,20365,500,21365,1000,502,40.73,0.0
8976,108352,157,1570,157,1884,314,159,10.0,0.0
8977,1564,0,9,0,12,3,4,3.0,0.0
8979,42598,76,532,76,684,152,78,7.0,0.0
8980,19569,9,108,9,126,18,11,12.0,0.5
8981,3106,4,28,4,36,8,6,7.0,0.0
8982,13122,14,114,14,142,28,16,8.143,0.0
8984,177913,210,1617,210,2037,420,212,7.7,0.8333333333333334
8985,108159,89,1954,89,2132,178,91,21.955,0.0
8986,7241,14,79,14,107,28,16,5.643,0.0
8989,1768,3,12,3,18,6,4,4.0,0.0
899,37018,52,479,52,583,104,53,9.212,0.0
8990,7238,12,72,12,96,24,14,6.0,0.5
8991,4765,3,60,3,66,6,5,20.0,0.0
8994,3893,6,36,6,48,12,8,6.0,0.0
8995,241711,294,4061,294,4649,588,296,13.813,0.0
8996,34030,79,395,79,553,158,81,5.0,0.0
9000,508909,500,7704,500,8704,1000,502,15.408,0.0
9001,1923,4,12,4,20,8,5,3.0,0.0
9002,17249,0,198,0,220,22,23,9.0,0.0
9003,81600,73,711,73,1042,331,254,9.74,0.0
9004,112214,93,2232,93,2418,186,95,24.0,0.5
9006,4421,9,36,9,54,18,11,4.0,0.0
9007,7685,14,56,14,84,28,16,4.0,0.0
9009,475275,500,7437,500,8437,1000,502,14.874,0.0
9010,8288,0,70,0,84,14,15,5.0,0.0
9011,1241,2,6,2,10,4,3,3.0,0.0
9013,28594,54,269,54,377,108,56,4.981,0.5
9014,1582,3,9,3,15,6,5,3.0,0.0
9016,47099,110,440,110,660,220,112,4.0,0.0
9018,541493,500,6923,500,7923,1000,502,13.846,0.0
9019,6611,17,68,17,102,34,19,4.0,0.0
9020,1665,0,9,0,12,3,4,3.0,0.0
9021,3933,3,45,3,51,6,5,15.0,0.0
9023,154484,361,1805,361,2527,722,363,5.0,0.0
9024,280234,460,2569,460,3494,925,467,5.585,0.0
9026,961,0,4,0,5,1,2,4.0,0.0
9027,427717,500,6605,500,7605,1000,502,13.21,0.0
9029,391113,500,5546,500,6546,1000,502,11.092,0.0
9031,45303,100,500,100,700,200,102,5.0,0.0
9034,65911,150,600,150,900,300,152,4.0,0.0
9035,11623,0,122,0,147,25,26,4.88,0.5
9036,4104,7,35,7,49,14,9,5.0,0.0
9037,3955,10,30,10,50,20,12,3.0,0.0
9038,9421,20,100,20,140,40,22,5.0,0.0
9039,29280,55,364,55,474,110,57,6.618,1.0
9040,281709,500,3000,500,4000,1000,502,6.0,0.0
9042,36513,81,388,81,550,162,83,4.79,0.0
9044,911750,500,11899,500,12899,1000,502,23.798,0.0
9048,385196,500,5521,500,6521,1000,502,11.042,0.0
9049,1259,2,6,2,10,4,4,3.0,0.0
9050,7097,13,91,13,117,26,15,7.0,0.0
9054,4705,6,30,6,42,12,8,5.0,0.0
9055,12623,22,132,22,176,44,24,6.0,0.0
9056,13857,30,150,30,210,60,32,5.0,0.5
9057,510498,500,7725,500,8725,1000,502,15.45,0.0
9059,6534,17,51,17,85,34,19,3.0,0.0
906,1248,1,5,1,8,3,3,5.0,0.0
9065,806676,500,7369,500,8369,1000,502,14.738,0.8333333333333334
9066,15145,41,109,41,191,82,43,2.659,0.5
9067,9374,16,111,16,143,32,18,6.938,0.0
9068,497000,500,7995,500,8995,1000,502,15.99,0.0
9069,1743,2,16,2,20,4,4,8.0,0.0
9072,7082,6,69,6,81,12,8,11.5,0.0
9073,111217,86,2056,86,2228,172,88,23.907,0.0
9074,30553,55,330,55,440,110,57,6.0,0.0
9075,33595,80,320,80,480,160,82,4.0,0.0
9077,364928,500,4624,500,5624,1000,502,9.248,0.0
9078,859321,500,13572,500,14572,1000,502,27.144,0.0
9079,32489,81,222,81,384,162,83,2.741,0.0
9080,466519,500,7485,500,8985,1500,1002,7.485,1.0
9081,4839237,500,150000,500,151000,1000,502,300.0,0.0
9082,5721,10,50,10,70,20,12,5.0,1.0
9084,4172457,500,105871,500,106871,1000,502,211.742,0.0
9085,864933,500,12557,500,13557,1000,502,25.114,0.0
9086,467564,1000,7493,1000,9493,2000,1003,7.493,1.0
9087,2640,5,25,5,35,10,7,5.0,0.0
9088,1912,3,15,3,21,6,5,5.0,0.0
9089,10344,24,73,24,121,48,26,3.042,0.0
9090,4914,4,48,4,56,8,6,12.0,0.0
9091,439670,500,3999,500,4999,1000,502,7.998,0.8
9094,220231,500,2957,500,3957,1000,502,5.914,0.5
9095,554528,500,8755,500,9755,1000,502,17.51,0.5
9096,15734,20,200,20,240,40,22,10.0,0.0
9097,419294,500,5693,500,6693,1000,502,11.386,0.75
9098,3105,5,25,5,35,10,7,5.0,0.0
9099,6219,13,65,13,91,26,15,5.0,0.0
910,149965,283,849,283,1415,566,285,3.0,0.5
9100,348894,500,5018,500,6018,1000,502,10.036,0.0
9101,21588,29,290,29,348,58,31,10.0,0.6
9102,243201,500,3500,500,4500,1000,502,7.0,0.0
9103,14166,0,81,0,90,9,10,9.0,0.5
9105,5682,10,60,10,80,20,12,6.0,0.0
9106,48868,29,334,29,392,58,31,11.517,0.0
9107,829370,500,12379,500,13379,1000,502,24.758,0.0
9108,8283,11,88,11,110,22,13,8.0,0.0
9109,101080,157,1099,157,1413,314,159,7.0,0.0
911,49380,0,624,0,728,104,105,6.0,0.0
9112,35045,56,392,56,504,112,58,7.0,0.0
9113,15473,16,272,16,304,32,18,17.0,0.0
9114,126872,73,1387,73,1533,146,75,19.0,0.0
9117,155665,129,1077,129,1335,258,131,8.349,0.0
9118,18909,0,240,0,280,40,41,6.0,0.0
9119,47524,0,974,0,1053,79,80,12.329,0.0
9121,454477,500,6500,500,7500,1000,502,13.0,0.0
9122,6296,10,88,10,108,20,12,8.8,0.0
9123,478321,500,7458,500,8458,1000,502,14.916,0.0
9124,476600,500,4716,500,5716,1000,502,9.432,0.5
9126,7440,0,110,0,115,5,6,22.0,0.0
9128,19018,27,367,27,421,54,29,13.593,0.0
9129,469930,1000,7500,1000,9500,2000,1003,7.5,1.0
9130,402369,500,5775,500,6775,1000,502,11.55,0.0
9132,540611,500,6927,500,7927,1000,502,13.854,0.0
9135,2458,4,16,4,24,8,6,4.0,0.0
9137,18675,40,240,40,320,80,42,6.0,0.0
9138,4786,3,51,3,57,6,5,17.0,0.0
9139,97001,168,1173,168,1509,336,170,6.982,0.0
9140,649972,500,4951,500,5951,1000,502,9.902,0.0
9142,38786,101,404,101,606,202,103,4.0,0.0
9143,2827,7,21,7,35,14,8,3.0,0.0
9144,17360,43,172,43,258,86,45,4.0,0.0
9145,96612,72,1249,72,1393,144,74,17.347,0.0
9147,55746,144,576,144,864,288,146,4.0,0.0
9149,453171,500,6954,500,7954,1000,502,13.908,0.0
9150,19559,36,324,36,396,72,38,9.0,0.0
9152,6342,13,39,13,65,26,15,3.0,0.0
9153,457629,500,6498,500,7498,1000,502,12.996,0.0
9156,5250,13,39,13,65,26,15,3.0,0.0
9157,73078,127,889,127,1143,254,129,7.0,0.0
9158,2180,3,18,3,24,6,5,6.0,0.0
9160,250446,500,3500,500,4500,1000,502,7.0,0.0
9161,234804,276,2208,276,2760,552,278,8.0,0.0
9162,2117,3,12,3,18,6,5,4.0,0.0
9163,9911,14,98,14,126,28,16,7.0,0.0
9164,6240,14,50,14,78,28,16,3.571,0.0
9165,6774,0,60,0,70,10,11,6.0,0.0
9166,17954,0,359,0,383,24,25,14.958,0.5
9168,1724,3,12,3,18,6,5,4.0,0.0
9170,2591,0,15,0,20,5,6,3.0,0.0
9171,1390,2,6,2,10,4,4,3.0,0.0
9172,835432,500,12405,500,13405,1000,502,24.81,0.0
9173,24347,12,240,12,264,24,14,20.0,0.0
9174,369810,500,5000,500,6000,1000,502,10.0,0.0
9175,6196,9,72,9,90,18,11,8.0,0.0
9177,18580,29,174,29,232,58,31,6.0,0.7
9178,76344,51,1331,51,1433,102,53,26.098,0.0
9179,179320,243,913,243,1399,486,245,3.757,0.5
9182,200470,54,378,54,486,108,56,7.0,0.0
9183,446951,500,6500,500,7500,1000,502,13.0,0.0
9185,56339,65,931,65,1061,130,67,14.323,1.0
9186,1313677,500,8378,500,9378,1000,502,16.756,0.0
9187,155471,39,733,39,811,78,41,18.795,0.0
9194,7068,11,77,11,99,22,13,7.0,0.0
9195,20739,28,411,28,467,56,30,14.679,0.0
9199,8521,13,91,13,117,26,15,7.0,0.0
9207,467683,500,7495,500,8995,1500,1002,7.495,1.0
9209,541531,0,10131,0,10631,500,501,20.262,0.0
9210,11221,13,119,13,145,26,15,9.154,0.0
9212,60976,35,232,35,302,70,37,6.629,0.5
9213,22330,30,270,30,330,60,32,9.0,0.0
9214,351805,500,5035,500,6035,1000,502,10.07,0.0
9216,69533,167,672,167,1006,334,169,4.024,0.0
9218,4140,9,27,9,45,18,11,3.0,0.0
9222,97533,73,1816,73,1962,146,75,24.877,0.0
9223,48001,105,630,105,840,210,107,6.0,0.0
9228,1314,2,8,2,12,4,4,4.0,0.0
9233,81856,43,646,43,732,86,45,15.023,0.5
9234,87397,143,572,143,1001,429,284,4.0,0.0
9237,835942,500,12441,500,13441,1000,502,24.882,0.0
9240,2520,4,20,4,28,8,6,5.0,1.0
9241,7996,20,59,20,99,40,22,2.95,0.0
9244,22251,27,405,27,459,54,29,15.0,0.0
9245,43507,78,623,78,779,156,80,7.987,0.0
9246,5976,11,55,11,77,22,13,5.0,0.0
9247,17518,45,123,45,213,90,47,2.733,0.0
9248,294516,500,3956,500,4956,1000,502,7.912,1.0
9254,5941,12,72,12,96,24,14,6.0,0.0
9257,73306,59,1415,59,1533,118,61,23.983,0.0
9258,178063,32,160,32,224,64,34,5.0,0.0
9259,6829,15,60,15,90,30,17,4.0,0.0
926,105773,0,570,0,665,95,96,6.0,0.5
9261,301031,500,2000,500,3000,1000,502,4.0,0.6666666666666666
9263,7019,13,65,13,91,26,15,5.0,0.0
9267,92230,71,1703,71,1845,142,73,23.986,0.0
9270,6739,8,110,8,126,16,10,13.75,0.75
9274,482570,500,5534,500,7034,1500,1002,11.068,0.0
9275,2654,3,24,3,30,6,5,8.0,0.0
9277,33794,93,261,93,447,186,95,2.806,0.0
928,315965,0,4500,0,5000,500,501,9.0,0.0
9283,883,1,2,1,4,2,3,2.0,0.0
9284,178778,392,2352,392,3136,784,394,6.0,0.0
9286,475254,500,6917,500,7917,1000,502,13.834,0.0
9287,105278,94,1594,94,1782,188,96,16.957,0.0
9288,20506,28,411,28,467,56,30,14.679,0.0
9290,935188,266,8492,266,9024,532,268,31.925,0.0
9291,5689514,500,75415,500,76415,1000,502,150.83,0.5
9292,394714,500,4133,500,5133,1000,502,8.266,0.0
9294,290001,500,3599,500,4599,1000,502,7.198,0.0
9295,11079,12,120,12,144,24,14,10.0,0.0
930,270042,0,3559,0,4002,443,444,8.034,0.0
9300,1872,3,15,3,21,6,5,5.0,0.0
9304,892175,500,13879,500,14879,1000,502,27.758,0.0
9305,1589,3,9,3,15,6,5,3.0,0.0
9307,4661,3,53,3,59,6,5,17.667,0.0
9308,3001,4,32,4,40,8,6,8.0,0.0
931,1299578,336,6074,336,6746,672,337,18.077,1.0
9311,1727,3,9,3,15,6,5,3.0,0.0
9313,348741,500,5020,500,6020,1000,502,10.04,0.5
9315,841781,500,12501,500,13501,1000,502,25.002,0.0
9317,837939,500,12460,500,13460,1000,502,24.92,0.0
9319,10525,17,102,17,136,34,19,6.0,0.0
9320,544549,401,9624,401,10426,802,403,24.0,0.0
9321,7727,0,57,0,76,19,20,3.0,0.0
9324,14497,7,133,7,147,14,9,19.0,0.5
9325,9346,0,84,0,105,21,22,4.0,0.0
9326,421469,384,5585,384,6353,768,386,14.544,0.0
9327,93530,77,1848,77,2002,154,79,24.0,0.0
9328,6184,13,43,13,69,26,15,3.308,0.0
9329,48008,86,430,86,602,172,88,5.0,0.0
9331,84615,72,1598,72,1742,144,74,22.194,0.0
9332,3776,0,36,0,41,5,6,7.2,0.0
9333,3920,5,35,5,45,10,7,7.0,0.0
9335,73635,45,629,45,719,90,47,13.978,0.0
9336,580481,500,9230,500,10230,1000,502,18.46,0.0
9337,1205953,500,16861,500,17861,1000,502,33.722,0.0
9338,255678,500,3500,500,4500,1000,502,7.0,0.0
9339,1425,1,8,1,11,3,4,8.0,0.0
9340,5312,12,48,12,72,24,14,4.0,0.0
9341,230760,141,3713,141,3995,282,143,26.333,0.0
9342,262536,500,3064,500,4064,1000,502,6.128,0.0
9345,131202,251,1004,251,1757,753,504,4.0,1.0
9346,1283293,500,19517,500,20517,1000,502,39.034,0.0
9347,1298,2,8,2,12,4,4,4.0,0.0
9349,6131,11,66,11,88,22,13,6.0,0.0
935,414033,0,8500,0,9000,500,501,17.0,0.0
9350,235925,329,2269,329,2927,658,331,6.897,0.5
9351,285930,500,4747,500,5747,1000,502,9.494,0.0
9352,50629,81,648,81,810,162,83,8.0,0.0
9353,2575,6,18,6,30,12,8,3.0,0.0
9355,348093,500,5002,500,6002,1000,502,10.004,0.0
9357,2863,6,23,6,35,12,8,3.833,0.0
9358,2199,3,18,3,24,6,4,6.0,0.0
9359,8755,12,108,12,132,24,14,9.0,0.0
936,253554,0,3385,0,3885,500,501,6.77,0.0
9360,329339,500,3165,500,4165,1000,502,6.33,0.0
9361,6449,13,52,13,78,26,15,4.0,0.0
9362,53881,47,799,47,893,94,49,17.0,0.0
9363,3051,0,25,0,30,5,6,5.0,0.0
9364,171315,500,2000,500,3000,1000,502,4.0,0.0
9366,9182,21,84,21,126,42,23,4.0,0.0
9367,346668,500,5000,500,6000,1000,502,10.0,0.0
9368,2671,6,18,6,30,12,8,3.0,0.0
9369,22857,40,280,40,360,80,42,7.0,0.0
937,963,0,3,0,4,1,2,3.0,0.0
9370,3289,8,24,8,40,16,10,3.0,0.0
9371,1197910,500,16740,500,17740,1000,502,33.48,0.0
9374,3956,10,23,10,43,20,12,2.3,0.0
9375,192368,0,2006,0,2205,199,200,10.08,0.0
9378,35551,37,840,37,914,74,39,22.703,0.0
9379,540798,500,6943,500,7943,1000,502,13.886,0.0
9383,7465,0,65,0,78,13,14,5.0,0.5
9386,293360,500,3500,500,4500,1000,502,7.0,0.0
9387,240651,283,2264,283,2830,566,285,8.0,0.0
9389,229406,0,2284,0,2784,500,501,4.568,0.0
9390,287430,0,1843,0,2047,204,205,9.034,0.0
9392,17795,0,154,0,220,66,67,7.0,0.0
9393,829253,500,12427,500,13427,1000,502,24.854,0.0
9394,6649,13,78,13,104,26,15,6.0,0.0
9395,478479,500,7503,500,8503,1000,502,15.006,0.0
9396,3954,7,35,7,49,14,9,5.0,0.0
9398,39647,111,312,111,534,222,113,2.811,0.0
940,3115,3,20,3,26,6,4,6.667,0.0
9400,286486,500,3500,500,4500,1000,502,7.0,0.0
9402,9276,13,117,13,143,26,15,9.0,0.0
9404,1197777,500,18089,500,19589,1500,1002,36.178,0.0
9405,482773,500,7558,500,8558,1000,502,15.116,0.0
9407,552864,500,8938,500,9938,1000,502,17.876,0.0
9408,5026,14,42,14,70,28,16,3.0,0.0
9409,894000,985,8726,985,10696,1970,987,8.859,0.0
9410,960732,970,10668,970,12608,1940,972,10.998,0.0
9411,1375154,970,8650,970,10590,1940,972,8.918,0.0
9413,546337,500,8850,500,9850,1000,501,17.7,0.0
9414,203945,147,2531,147,2825,294,148,17.218,0.0
9415,295953,500,2646,500,3646,1000,501,5.292,0.0
9416,520142,500,6014,500,7014,1000,501,12.028,0.0
9417,187410,0,295,0,354,59,60,5.0,0.0
9418,45313,0,460,0,552,92,93,5.0,0.0
9419,125026,137,685,137,1096,411,187,5.0,0.0
942,2479,0,36,0,40,4,5,9.0,0.0
9420,89706,94,539,94,764,225,132,5.734,0.0
9421,19488,38,114,38,228,114,77,3.0,0.0
9422,47879,93,372,93,651,279,187,4.0,0.0
9423,653126,0,7312,0,7812,500,501,14.624,0.0
9425,31082,56,224,56,392,168,113,4.0,0.0
9426,8645,15,60,15,105,45,31,4.0,0.0
9427,76228,0,930,0,1072,142,143,6.549,0.0
9428,108923,0,642,0,856,214,215,3.0,0.0
9429,462229,0,7500,0,8000,500,501,15.0,0.0
9430,280745,500,3500,500,4500,1000,502,7.0,0.0
9431,50175,45,285,45,375,90,46,6.333,0.5
9434,400258,0,92,0,115,23,24,4.0,0.0
9435,80085,0,780,0,975,195,196,4.0,0.0
9436,8957,21,105,21,147,42,22,5.0,0.0
9437,57052,48,705,48,801,96,49,14.688,0.0
9438,13120,0,198,0,202,4,5,49.5,1.0
9439,241918,500,3472,500,4472,1000,501,6.944,0.0
9440,263943,500,3934,500,4934,1000,501,7.868,0.0
9441,305321,500,5076,500,6076,1000,501,10.152,0.0
9442,255579,500,3940,500,4940,1000,501,7.88,0.0
9443,780106,0,13000,0,13500,500,501,26.0,0.0
9445,1110228,912,11972,912,13796,1824,914,13.127,0.0
9446,232584,500,2500,500,3500,1000,501,5.0,0.0
9449,22929,0,80,0,112,32,25,5.0,0.0
9450,221083,500,2500,500,3500,1000,501,5.0,0.0
9451,246592,500,3000,500,4000,1000,501,6.0,0.0
9452,306602,500,3986,500,4986,1000,501,7.972,0.0
9453,443268,500,6518,500,7518,1000,501,13.036,0.0
9454,295083,0,4000,0,4500,500,501,8.0,0.0
9455,289550,500,3459,500,4459,1000,501,6.918,0.0
9456,392786,500,5761,500,6761,1000,501,11.522,0.0
9458,445206,500,6507,500,7507,1000,501,13.014,0.0
9462,220155,500,2500,500,3500,1000,501,5.0,0.0
9463,220000,500,2500,500,3500,1000,501,5.0,0.0
9465,395720,500,5794,500,6794,1000,501,11.588,0.0
9466,448292,500,6525,500,7525,1000,501,13.05,0.0
9469,334673,0,3989,0,4489,500,501,7.978,0.0
9471,220940,500,2500,500,3500,1000,501,5.0,0.0
9472,220583,500,2500,500,3500,1000,501,5.0,0.0
9473,365584,0,3500,0,4000,500,501,7.0,0.0
9475,2642,4,28,4,36,8,6,7.0,0.0
9476,36284,59,466,59,584,118,61,7.898,0.0
9477,701231,500,12468,500,13468,1000,502,24.936,0.0
9478,3474,5,35,5,45,10,7,7.0,0.0
9480,389888,500,4500,500,5500,1000,502,9.0,0.5
9481,288475,437,3059,437,3933,874,439,7.0,0.5
9482,10513,25,100,25,150,50,27,4.0,0.0
9483,4516,8,48,8,64,16,10,6.0,0.0
9484,342479,250,6250,250,6750,500,252,25.0,0.0
9485,225463,500,3500,500,4500,1000,501,7.0,0.0
9486,412971,0,4670,0,5170,500,501,9.34,0.0
9487,696114,0,9377,0,9877,500,501,18.754,0.0
9488,343833,0,4110,0,4610,500,501,8.22,0.0
9489,355508,0,4136,0,4636,500,501,8.272,0.0
9496,675360,0,8587,0,9087,500,501,17.174,0.0
9497,2050802,0,26760,0,27260,500,501,53.52,0.0
9498,562879,0,8850,0,9350,500,501,17.7,0.0
9499,261542,500,3504,500,4504,1000,501,7.008,0.0
9500,564963,0,9031,0,9531,500,501,18.062,0.0
9501,536981,0,7600,0,8100,500,501,15.2,0.0
9502,299351,0,3255,0,3755,500,501,6.51,0.0
9503,301595,0,3298,0,3798,500,501,6.596,0.0
9504,19495,12,336,12,360,24,13,28.0,0.0
9505,551482,0,7247,0,7747,500,501,14.494,0.0
9506,533982,0,6979,0,7479,500,501,13.958,0.5
9507,601859,0,7508,0,8008,500,501,15.016,0.0
9511,407551,0,5008,0,5508,500,501,10.016,0.0
9512,558327,0,8896,0,9396,500,501,17.792,0.0
9513,189878,463,2313,463,3239,926,464,4.996,0.0
9514,536123,0,9241,0,9741,500,501,18.482,0.5
9515,2530955,0,33500,0,34000,500,501,67.0,0.0
9516,531672,0,8229,0,8729,500,501,16.458,0.0
9517,1885223,0,24187,0,24548,361,362,67.0,0.5
9518,318674,108,5292,108,5508,216,109,49.0,0.0
9519,19422,12,336,12,360,24,13,28.0,0.0
952,305515,0,5500,0,6000,500,501,11.0,0.0
9520,2540003,0,33500,0,34000,500,501,67.0,0.0
9521,324058,463,3364,463,4290,926,464,7.266,0.6666666666666666
9522,1461845,500,20500,500,21500,1000,501,41.0,0.0
9523,411777,500,5493,500,6493,1000,501,10.986,0.0
9524,414292,0,4731,0,5231,500,501,9.462,0.0
9525,560380,0,7067,0,7567,500,501,14.134,0.0
9526,52553,79,553,79,711,158,80,7.0,0.5
9527,19184,12,336,12,360,24,13,28.0,0.0
9528,515718,0,6442,0,6942,500,501,12.884,0.0
9529,2563541,0,33437,0,33937,500,501,66.874,0.0
9530,485478,500,5982,500,6982,1000,501,11.964,0.5
9531,531607,500,8509,500,9509,1000,501,17.018,1.0
9533,30547,11,266,11,288,22,13,24.182,0.0
9534,91608,157,1105,157,1419,314,158,7.038,0.0
9535,1465599,500,33000,500,34000,1000,501,66.0,0.0
9537,2653389,500,34191,500,35191,1000,501,68.382,0.0
9538,292409,301,3607,301,4209,602,302,11.983,0.6666666666666666
9539,5963,7,105,7,119,14,9,15.0,0.0
954,347873,500,4500,500,6000,1500,1002,4.5,0.0
9540,5790,7,105,7,119,14,9,15.0,1.0
9541,1985,2,30,2,34,4,4,15.0,0.0
9542,275758,500,3500,500,4500,1000,502,7.0,0.0
9543,72866,42,335,42,670,335,130,7.976,0.0
9544,1041008,0,14972,0,15472,500,501,29.944,0.0
9545,11521,18,126,18,162,36,19,7.0,0.0
9547,484689,500,3924,500,4924,1000,502,7.848,0.5
9548,780106,0,13000,0,13500,500,501,26.0,0.0
9550,590648,324,8772,324,9469,697,367,27.074,0.75
9553,522262,500,8482,500,9482,1000,501,16.964,0.0
9554,1750,3,12,3,18,6,5,4.0,0.0
9555,5399,8,48,8,64,16,10,6.0,0.0
9556,5891,8,80,8,96,16,10,10.0,0.0
9557,26736,53,265,53,371,106,55,5.0,0.0
9558,354928,500,4444,500,5444,1000,502,8.888,0.0
9559,509827,500,5500,500,6500,1000,502,11.0,0.0
9560,3272,6,36,6,48,12,8,6.0,0.0
9561,8809,20,80,20,120,40,22,4.0,0.0
9563,1114,1,5,1,7,2,3,5.0,0.0
9564,7139,11,88,11,110,22,13,8.0,0.0
9565,1029,1,4,1,6,2,3,4.0,0.0
9566,2455,5,20,5,30,10,7,4.0,0.0
9567,483691,500,5000,500,6000,1000,502,10.0,0.0
9568,3916,7,49,7,63,14,9,7.0,0.0
9569,157238,232,2242,232,2706,464,234,9.664,0.0
9570,1485,2,12,2,16,4,4,6.0,0.0
9571,12394,14,224,14,252,28,16,16.0,0.0
9597,34540,48,335,48,431,96,49,6.979,0.0
963,479346,500,8493,500,9493,1000,501,16.986,0.0
9630,1181650,422,11188,422,12532,1344,924,12.134,0.0
964,408666,500,6685,500,7685,1000,501,13.37,0.0
965,415245,0,8500,0,9000,500,501,17.0,0.0
9650,200883,500,2000,500,3000,1000,501,4.0,0.0
9651,1084627,500,14366,500,15366,1000,501,28.732,0.5
9653,862664,500,9500,500,10500,1000,501,19.0,0.0
9654,344963,0,3998,0,4498,500,501,7.996,0.0
9655,1142040,500,21406,500,22406,1000,501,42.812,0.0
9656,181752,500,1690,500,2690,1000,501,3.38,0.0
9657,636937,500,13334,500,14334,1000,501,26.668,0.0
9658,333268,500,3868,500,4868,1000,501,7.736,0.0
9659,313669,500,3616,500,5018,1402,871,7.232,0.0
966,331865,500,3439,500,4439,1000,501,6.878,0.0
9662,542133,500,7691,500,8691,1000,501,15.382,0.0
9664,1579631,489,21192,489,22170,978,490,43.337,0.5
9665,4554,6,49,6,61,12,7,8.167,0.0
9666,474786,500,8500,500,9500,1000,501,17.0,0.5
9668,290077,0,3999,0,4499,500,501,7.998,0.0
9669,45326,15,555,15,585,30,17,37.0,0.0
9670,49193,0,456,0,570,114,115,4.0,0.0
9671,293723,0,5593,0,6093,500,501,11.186,0.0
9672,233636,0,3000,0,3500,500,501,6.0,0.0
9673,1291980,500,21389,500,22389,1000,502,42.778,0.0
9674,24016,23,383,23,429,46,25,16.652,0.0
9675,511969,170,1360,170,1700,340,172,8.0,0.0
9677,1181665,500,16868,500,17868,1000,501,33.736,0.0
9678,239568,0,3000,0,3500,500,501,6.0,0.0
9679,351934,0,5372,0,5771,399,400,13.464,0.5
9681,77604,0,855,0,1026,171,172,5.0,0.0
9682,142545,0,1863,0,2115,252,253,7.393,0.0
9686,52843,23,725,23,771,46,24,31.522,0.0
9687,697993,0,11952,0,12452,500,501,23.904,0.0
9688,737530,500,11216,500,12216,1000,501,22.432,0.0
9689,524578,500,6500,500,7500,1000,501,13.0,0.0
9690,6868,10,80,10,100,20,11,8.0,1.0
9693,431899,500,6427,500,7427,1000,502,12.854,0.0
9697,31775,66,264,66,446,182,118,4.0,0.0
9698,447853,500,6967,500,7967,1000,502,13.934,0.0
9699,875578,500,13740,500,14740,1000,502,27.48,0.0
9701,274455,0,4000,0,4500,500,501,8.0,0.0
9702,288193,500,4000,500,5000,1000,501,8.0,0.0
9705,562220,549,8456,549,9554,1098,551,15.403,0.0
9706,4611384,500,114500,500,115500,1000,501,229.0,0.0
9707,277097,500,4000,500,5000,1000,501,8.0,0.0
9709,1063956,0,18850,0,19350,500,501,37.7,0.0
971,3043676,500,74000,500,75000,1000,501,148.0,0.5
9710,358635,500,4000,500,5000,1000,501,8.0,0.5
9711,248694,500,2899,500,3899,1000,501,5.798,0.0
9714,1052693,1025,10994,1025,13044,2050,1027,10.726,0.0
9715,230384,500,3500,500,4500,1000,501,7.0,0.0
9716,140326,209,1326,209,1744,418,211,6.344,0.0
9717,314834,500,4761,500,5761,1000,502,9.522,0.0
9718,460577,500,7466,500,8466,1000,502,14.932,0.0
9719,157963,500,1381,500,2381,1000,502,2.762,0.0
9720,66334,175,579,175,929,350,177,3.309,0.0
9721,504967,500,7544,500,8544,1000,502,15.088,0.0
9722,56607,38,617,38,769,152,115,16.237,0.0
9723,278844,0,4492,0,4992,500,501,8.984,0.0
9724,346257,500,5000,500,6000,1000,501,10.0,0.0
9725,7803073,500,112000,500,113000,1000,501,224.0,0.0
9726,220744,0,3000,0,3500,500,501,6.0,0.0
9729,475798,500,6500,500,7500,1000,501,13.0,0.5
9730,359859,0,5000,0,5500,500,501,10.0,0.5
9731,346257,500,5000,500,6000,1000,501,10.0,0.0
9732,365702,0,5000,0,5500,500,501,10.0,0.0
9733,73844,0,1250,0,1314,64,65,19.531,0.0
9734,2029,1,15,1,20,5,5,15.0,0.0
9736,181066,331,1647,331,2309,662,332,4.976,0.0
9737,461624,500,6498,500,7498,1000,501,12.996,0.5
9739,137018,0,1890,0,2205,315,316,6.0,0.0
9740,367864,0,5000,0,5500,500,501,10.0,0.0
9741,272425,0,3932,0,4432,500,501,7.864,0.0
9742,768465,0,10507,0,11007,500,501,21.014,0.0
9743,368921,0,5000,0,5500,500,501,10.0,0.5
9744,72251,0,980,0,1078,98,99,10.0,0.0
9745,348258,500,5000,500,6000,1000,501,10.0,0.0
9746,261432,0,3600,0,3960,360,361,10.0,0.0
9747,360565,0,5000,0,5500,500,501,10.0,0.0
9748,573848,0,7496,0,7996,500,501,14.992,1.0
9749,27206,0,360,0,396,36,37,10.0,0.0
9751,417777,249,4684,249,5680,996,748,18.811,0.0
9754,43758,0,600,0,660,60,61,10.0,0.5
9755,367228,0,5000,0,5500,500,501,10.0,0.5
9756,145687,0,1960,0,2156,196,197,10.0,0.0
9757,525156,500,7392,500,8392,1000,501,14.784,0.5
9758,284963,500,3000,500,4000,1000,501,6.0,0.0
9759,369700,0,5000,0,5500,500,501,10.0,0.0
9760,375520,0,5000,0,5500,500,501,10.0,0.0
9761,346257,500,5000,500,6000,1000,501,10.0,0.0
9762,605797,500,11999,500,12999,1000,501,23.998,0.0
9763,661909,0,7356,0,7856,500,501,14.712,0.0
9764,207326,0,2760,0,3036,276,277,10.0,0.0
9765,266022,0,3600,0,3960,360,361,10.0,1.0
9766,1073186,500,17000,500,18000,1000,501,34.0,0.0
9767,40431,78,390,78,546,156,79,5.0,0.0
9768,27337,0,360,0,396,36,37,10.0,1.0
9769,372258,0,5000,0,5500,500,501,10.0,0.0
977,439993,0,6500,0,7000,500,501,13.0,0.0
9770,364329,0,5000,0,5500,500,501,10.0,0.0
9771,364453,0,5000,0,5500,500,501,10.0,0.0
9772,27208,50,148,50,298,150,101,2.96,0.0
9773,236669,500,3089,500,4089,1000,501,6.178,0.0
9775,245948,500,3110,500,4110,1000,501,6.22,0.0
9777,287582,500,4351,500,5351,1000,501,8.702,0.0
9778,35075,57,510,57,624,114,58,8.947,0.0
9780,232681,0,3001,0,3501,500,501,6.002,0.0
9781,123388,239,1193,239,1671,478,240,4.992,0.0
9782,917161,500,16000,500,17000,1000,501,32.0,0.0
9783,476191,500,13000,500,14000,1000,501,26.0,0.0
9785,974635,906,11936,906,13748,1812,908,13.174,0.0
9786,775174,0,13489,0,13989,500,501,26.978,0.0
9788,269234,500,3370,500,4370,1000,501,6.74,0.0
9789,126034,323,1578,323,2224,646,325,4.885,0.0
9798,522972,500,8498,500,9498,1000,501,16.996,0.0
9799,4512,7,21,7,49,28,23,3.0,0.0
980,14831,21,84,21,177,93,73,4.0,0.0
9800,86194,206,824,206,1236,412,208,4.0,0.0
9801,227747,500,2500,500,3500,1000,502,5.0,0.0
9802,496417,500,7122,500,8122,1000,502,14.244,0.0
9803,440391,500,6229,500,7229,1000,502,12.458,0.0
9804,522295,500,8483,500,9483,1000,501,16.966,0.0
9805,541365,500,8844,500,9844,1000,501,17.688,0.0
9806,468195,500,6936,500,7936,1000,502,13.872,0.0
9808,228396,498,2988,498,3984,996,500,6.0,0.5
9809,230384,500,3500,500,4500,1000,501,7.0,0.0
9814,524963,500,8550,500,9550,1000,501,17.1,0.0
9816,201422,500,2000,500,3000,1000,502,4.0,0.0
9817,491534,500,7108,500,8108,1000,502,14.216,0.0
9818,160528,384,1536,384,2304,768,386,4.0,0.0
9819,253594,500,2500,500,3500,1000,502,5.0,1.0
9820,97225,216,1296,216,1728,432,218,6.0,0.5
9830,69625,48,744,48,840,96,50,15.5,0.0
9831,4521,6,54,6,66,12,8,9.0,0.0
9832,225806,500,2500,500,3500,1000,502,5.0,0.0
9833,22709,16,240,16,272,32,18,15.0,0.0
9838,82797,93,1215,93,1401,186,94,13.065,0.0
9839,287582,500,4351,500,5351,1000,501,8.702,0.0
9840,35075,57,510,57,624,114,58,8.947,0.0
9844,518866,500,8455,500,9455,1000,501,16.91,0.0
9845,26178,46,368,46,460,92,48,8.0,0.5
9846,4193,9,30,9,48,18,11,3.333,0.0
9847,24168,12,300,12,324,24,13,25.0,0.0
9848,36453,43,731,43,817,86,44,17.0,0.0
9849,310104,0,4500,0,5000,500,501,9.0,0.0
985,818188,0,6500,0,7000,500,501,13.0,0.0
9851,338154,0,4563,0,4914,351,352,13.0,0.0
9853,414437,500,6144,500,7144,1000,501,12.288,0.0
9854,81604,160,1120,160,1440,320,161,7.0,0.0
9855,93522,32,713,32,777,64,33,22.281,0.0
9856,242812,0,3000,0,3500,500,501,6.0,0.0
9857,191709,500,2500,500,3500,1000,501,5.0,0.0
9858,243719,389,1824,389,2991,1167,709,4.689,0.0
9859,196844,120,2880,120,3120,240,121,24.0,0.0
9860,24685,10,330,10,350,20,12,33.0,0.0
9861,22184,15,285,15,315,30,17,19.0,0.0
9862,400998,500,5500,500,6500,1000,501,11.0,0.0
9864,69845,113,819,113,1045,226,115,7.248,0.0
9865,346257,500,5000,500,6000,1000,501,10.0,0.0
9866,293595,500,4864,500,5864,1000,501,9.728,1.0
9867,551369,500,6083,500,7083,1000,501,12.166,0.0
9868,888085,0,10338,0,10838,500,501,20.676,1.0
9869,946111,925,11976,925,13826,1850,927,12.947,0.0
9870,6534660,3362,71660,3362,78384,6724,3364,21.315,0.0
9871,109325,159,954,159,1431,477,319,6.0,0.0
9872,354882,500,5168,500,6168,1000,501,10.336,0.0
9873,1275,2,6,2,10,4,3,3.0,0.0
9874,35224,35,490,35,560,70,36,14.0,0.0
9875,471111,500,7000,500,8000,1000,501,14.0,0.0
9876,1456158,500,29000,500,30000,1000,501,58.0,0.0
9877,145131,350,1400,350,2100,700,351,4.0,0.0
9878,102197,0,1185,0,1430,245,246,4.837,0.0
9879,493481,0,5994,0,6494,500,501,11.988,0.0
9880,20866,36,252,36,324,72,37,7.0,0.0
9881,477414,500,7863,500,8863,1000,501,15.726,0.5
9883,648741,500,9000,500,10000,1000,501,18.0,0.0
9884,822366,927,9486,927,11340,1854,929,10.233,0.0
9885,656810,910,9460,910,11280,1820,912,10.396,0.0
9886,197286,120,2880,120,3120,240,121,24.0,0.0
9887,27273,39,351,39,429,78,40,9.0,0.0
9888,26236,0,352,0,363,11,12,32.0,0.0
989,457652,0,9280,0,9472,192,193,48.333,0.0
9890,674718,500,9610,500,10610,1000,501,19.22,0.0
9892,353295,500,4496,500,5496,1000,501,8.992,0.0
9894,113863,0,1390,0,1668,278,279,5.0,0.5
9895,624980,500,9151,500,10151,1000,501,18.302,0.5
9896,402641,500,5500,500,6500,1000,501,11.0,0.0
9897,400998,500,5500,500,6500,1000,501,11.0,0.0
9898,379374,500,5000,500,6000,1000,501,10.0,0.0
9899,223672,226,3841,226,4293,452,227,16.996,0.0
9900,8215,12,132,12,156,24,13,11.0,0.0
9901,6025,12,72,12,96,24,13,6.0,0.0
9902,473148,500,7480,500,8480,1000,501,14.96,0.5
9903,327801,500,3710,500,4710,1000,501,7.42,0.0
9904,196844,120,2880,120,3120,240,121,24.0,0.0
9905,356874,500,4943,500,5943,1000,501,9.886,0.0
9906,61418,100,894,100,1094,200,101,8.94,0.0
9907,394268,500,5804,500,6804,1000,501,11.608,0.0
9908,16585,13,338,13,364,26,14,26.0,0.0
9909,37122,22,638,22,682,44,23,29.0,0.0
9910,708158,500,11000,500,12000,1000,501,22.0,0.0
9911,648741,500,9000,500,10000,1000,501,18.0,0.0
9912,7731,12,118,12,142,24,13,9.833,0.0
9913,6942,12,96,12,120,24,13,8.0,0.0
9914,274028,0,3494,0,3994,500,501,6.988,0.0
9915,7223,12,102,12,126,24,13,8.5,0.0
9916,186850,282,2967,282,3531,564,283,10.521,0.0
9917,121599,252,1764,252,2268,504,253,7.0,0.0
9918,228663,500,2500,500,3500,1000,501,5.0,0.5
9919,1401266,997,12476,997,14470,1994,999,12.514,0.0
992,1436,2,12,2,16,4,3,6.0,0.0
9920,738777,500,10623,500,11623,1000,501,21.246,0.0
9921,441084,500,8000,500,9000,1000,501,16.0,0.0
9922,277836,500,5500,500,6500,1000,501,11.0,0.0
9923,374448,500,10000,500,11000,1000,501,20.0,0.0
9924,197286,120,2880,120,3120,240,121,24.0,0.0
9925,521711,270,7112,270,8152,1040,772,9.236,0.0
9926,80992,129,1161,129,1419,258,130,9.0,0.0
9927,573409,0,11895,0,12395,500,501,23.79,0.0
9928,187494,200,2000,200,2400,400,201,10.0,0.0
9929,3986,0,44,0,48,4,5,11.0,0.0
9930,872127,500,11500,500,12500,1000,501,23.0,0.0
9931,353492,500,4000,500,5000,1000,501,8.0,0.0
9932,540512,0,9000,0,9500,500,501,18.0,0.0
9933,439127,500,4435,500,5935,1500,522,8.87,0.0
9934,735127,500,9500,500,10500,1000,501,19.0,0.0
9935,6037,0,72,0,80,8,9,9.0,0.0
9936,343574,500,4000,500,5000,1000,501,8.0,0.0
9937,103738,39,761,39,878,117,79,19.513,0.0
994,307022,0,4645,0,5145,500,501,9.29,0.0
9940,260085,500,3636,500,4636,1000,501,7.272,0.0
9941,1989,0,18,0,20,2,3,9.0,0.0
9942,4759,0,55,0,60,5,6,11.0,0.0
9943,3238,0,36,0,40,4,5,9.0,0.5
9944,341488,500,4000,500,5000,1000,501,8.0,0.0
9945,886406,920,11936,920,13776,1840,922,12.974,1.0
9946,404918,500,6000,500,7000,1000,501,12.0,0.0
9947,641994,500,10500,500,11500,1000,501,21.0,0.0
9948,339911,500,4500,500,5500,1000,501,9.0,0.0
9949,329489,500,4000,500,5000,1000,501,8.0,0.0
9950,297220,500,5000,500,6000,1000,501,10.0,0.0
9951,991373,0,17839,0,18339,500,501,35.678,0.0
9952,7301,0,88,0,96,8,9,11.0,0.0
9953,256088,500,3500,500,4500,1000,502,7.0,0.0
9954,342624,500,4000,500,5000,1000,501,8.0,0.0
9955,740027,500,9500,500,10500,1000,501,19.0,0.0
9957,1479827,500,29095,500,30095,1000,501,58.19,0.0
9958,2785069,500,31366,500,32866,1500,1001,62.732,0.0
9959,11654,0,144,0,160,16,17,9.0,0.0
996,130033,0,2172,0,2321,149,150,14.577,0.0
9960,420367,0,5500,0,6000,500,501,11.0,0.0
9961,135916,266,1572,266,2104,532,267,5.91,0.5
9962,32165,0,407,0,444,37,38,11.0,0.0
9963,210544,217,2231,217,2665,434,218,10.281,0.8
9964,1082,1,6,1,8,2,2,6.0,0.0
9965,186525,500,1640,500,2640,1000,501,3.28,0.0
9967,7346,0,90,0,100,10,11,9.0,0.0
9968,410547,500,7009,500,8009,1000,501,14.018,0.0
9969,16650,0,207,0,230,23,24,9.0,0.0
9970,11528,0,144,0,160,16,17,9.0,0.0
9971,6519,0,77,0,84,7,8,11.0,1.0
9972,5603,0,66,0,72,6,7,11.0,0.0
9973,1115148,0,16000,0,16500,500,501,32.0,0.0
9974,518404,500,6500,500,7500,1000,501,13.0,0.0
9975,345581,500,4000,500,5000,1000,501,8.0,0.0
9977,564531,0,8835,0,9335,500,501,17.67,0.0
9978,352491,500,4000,500,5000,1000,501,8.0,0.0
998,536938,0,8500,0,9000,500,501,17.0,0.0
9982,21051,0,264,0,288,24,25,11.0,0.0
9983,4729,0,55,0,60,5,6,11.0,0.5
9984,2677,0,27,0,30,3,4,9.0,1.0
9985,17497,40,200,40,280,80,41,5.0,0.0
9986,2276,0,22,0,24,2,3,11.0,0.0
9988,12372,12,158,12,182,24,14,13.167,1.0
9989,19413,7,226,7,240,14,9,32.286,0.0
9990,227309,500,2642,500,3642,1000,501,5.284,0.0
9991,17691,17,221,17,255,34,19,13.0,1.0
9992,10198,12,108,12,132,24,14,9.0,0.0
9993,253063,500,2463,500,3463,1000,502,4.926,0.0
9994,19273,19,247,19,285,38,21,13.0,0.5
9995,342262,272,2452,272,3268,816,347,9.015,0.5
